County,Total,White,% White ,Black,% Black,NA,% NA,A/PI,%  A/PI,Other,%  Other,MR,% MR,AP Black,AP    NA,AP NA NB,AP B NNA,AP B NA,MR Black,% MR   Black,Total Black,% Total Black,Hisp,%  Hisp ,Non  Hisp,% Non   Hisp,White Non Hisp,% White Non Hisp,excelVTDId,excelCountyName,GEOID10
Alamance,4869,4420,0.907783939207,309,0.0634627233518,11,0.00225919079893,21,0.00431300061614,52,0.0106798110495,56,0.0115013349764,338,24,20,334,358,29,0.00595604846991,338,0.0694187718217,138,0.0283425754775,4731,0.971657424522,4332,0.889710412816,01,Alamance,3700101
Alamance,4491,4291,0.955466488533,104,0.023157425963,20,0.00445335114674,12,0.00267201068804,22,0.00489868626141,42,0.00935203740815,117,41,41,117,158,13,0.00289467824538,117,0.0260521042084,66,0.0146960587842,4425,0.985303941216,4250,0.946337118682,02,Alamance,3700102
Alamance,6446,5643,0.87542662116,514,0.0797393732547,27,0.00418864412038,67,0.0103940428173,101,0.0156686317096,94,0.0145826869376,554,46,42,550,596,40,0.00620539869687,554,0.0859447719516,233,0.0361464474092,6213,0.963853552591,5522,0.856655290102,035,Alamance,37001035
Alamance,2814,2442,0.867803837953,207,0.0735607675906,1,0.000355366027008,90,0.0319829424307,30,0.0106609808102,44,0.0156361051883,230,9,5,226,235,23,0.00817341862118,230,0.0817341862118,74,0.0262970859986,2740,0.973702914001,2399,0.852523098792,03C,Alamance,3700103C
Alamance,5712,5060,0.885854341737,426,0.0745798319328,3,0.000525210084034,105,0.0183823529412,47,0.00822829131653,71,0.0124299719888,457,17,7,447,464,31,0.00542717086835,457,0.0800070028011,128,0.0224089635854,5584,0.977591036415,4983,0.87237394958,03N,Alamance,3700103N
Alamance,7024,5315,0.756691343964,937,0.13339977221,13,0.00185079726651,351,0.0499715261959,237,0.0337414578588,171,0.0243451025057,1050,54,25,1021,1075,113,0.0160876993166,1050,0.149487471526,402,0.0572323462415,6622,0.942767653759,5173,0.736474943052,03S,Alamance,3700103S
Alamance,3231,2821,0.873104302074,264,0.0817084493965,9,0.00278551532033,38,0.0117610646859,54,0.016713091922,45,0.0139275766017,285,22,20,283,305,21,0.00649953574745,285,0.0882079851439,130,0.0402352212937,3101,0.959764778706,2755,0.852677189725,03W,Alamance,3700103W
Alamance,5414,4769,0.880864425563,499,0.0921684521611,14,0.00258588843738,20,0.00369412633912,59,0.0108976727004,53,0.00978943479867,522,33,30,519,552,23,0.00424824528999,522,0.0964166974511,142,0.0262282970078,5272,0.973771702992,4702,0.868489102327,04,Alamance,3700104
Alamance,3339,3079,0.922132374963,188,0.0563042827194,7,0.0020964360587,10,0.00299490865529,33,0.00988319856244,22,0.00658879904163,199,14,13,198,212,11,0.00329439952081,199,0.0595986822402,74,0.0221623240491,3265,0.977837675951,3039,0.910152740341,05,Alamance,3700105
Alamance,4940,2178,0.440890688259,1533,0.31032388664,47,0.00951417004049,48,0.00971659919028,999,0.202226720648,135,0.0273279352227,1590,86,72,1576,1662,57,0.0115384615385,1590,0.321862348178,1629,0.32975708502,3311,0.67024291498,1695,0.343117408907,063,Alamance,37001063
Alamance,5874,4174,0.710589036432,673,0.114572693224,151,0.0257065032346,119,0.0202587674498,668,0.113721484508,89,0.0151515151515,711,178,168,701,879,38,0.00646918624447,711,0.121041879469,1098,0.186925434116,4776,0.813074565884,3921,0.667517875383,064,Alamance,37001064
Alamance,3113,1989,0.638933504658,820,0.263411500161,30,0.00963700610344,19,0.00610343719884,161,0.0517185994218,94,0.0301959524574,879,58,41,862,920,59,0.0189527786701,879,0.282364278831,348,0.1117892708,2765,0.8882107292,1842,0.591712174751,06E,Alamance,3700106E
Alamance,4468,2077,0.464861235452,1464,0.327663384064,51,0.0114145031334,46,0.0102954341987,720,0.161145926589,110,0.0246195165622,1531,80,70,1521,1601,67,0.0149955237243,1531,0.342658907789,1116,0.249776186213,3352,0.750223813787,1758,0.393464637422,06N,Alamance,3700106N
Alamance,3937,3035,0.770891541783,613,0.155702311405,34,0.00863601727203,80,0.0203200406401,95,0.0241300482601,80,0.0203200406401,657,59,47,645,704,44,0.011176022352,657,0.166878333757,270,0.0685801371603,3667,0.93141986284,2905,0.737871475743,06S,Alamance,3700106S
Alamance,1973,1128,0.571718195641,491,0.248859604663,22,0.0111505321845,41,0.0207805372529,233,0.118094272681,58,0.0293968575773,526,32,30,524,556,35,0.0177394830208,526,0.266599087684,365,0.184997465788,1608,0.815002534212,1031,0.522554485555,06W,Alamance,3700106W
Alamance,4383,4033,0.920146018709,186,0.0424366872005,22,0.00501939310974,16,0.00365046771618,69,0.015742642026,57,0.0130047912389,214,39,33,208,247,28,0.00638831850331,214,0.0488250057039,159,0.0362765229295,4224,0.96372347707,3960,0.903490759754,07,Alamance,3700107
Alamance,4140,3452,0.833816425121,349,0.0842995169082,24,0.00579710144928,14,0.00338164251208,230,0.0555555555556,71,0.0171497584541,390,44,43,389,433,41,0.00990338164251,390,0.0942028985507,391,0.0944444444444,3749,0.905555555556,3330,0.804347826087,08N,Alamance,3700108N
Alamance,2209,2007,0.908555907651,101,0.0457220461747,14,0.00633770937076,4,0.00181077410593,28,0.0126754187415,55,0.0248981439565,132,36,32,128,164,31,0.014033499321,132,0.0597555454957,89,0.0402897238569,2120,0.959710276143,1957,0.885921231326,08S,Alamance,3700108S
Alamance,2315,1833,0.791792656587,393,0.169762419006,8,0.00345572354212,8,0.00345572354212,26,0.0112311015119,47,0.0203023758099,420,29,23,414,443,27,0.0116630669546,420,0.181425485961,93,0.0401727861771,2222,0.959827213823,1772,0.765442764579,09N,Alamance,3700109N
Alamance,6217,4986,0.801994531124,694,0.111629403249,50,0.00804246421103,25,0.00402123210552,319,0.0513109216664,143,0.0230014476436,755,88,74,741,829,61,0.00981180633746,755,0.121441209587,708,0.113881293228,5509,0.886118706772,4684,0.75341804729,09S,Alamance,3700109S
Alamance,4209,3309,0.786172487527,389,0.0924210026134,10,0.0023758612497,39,0.00926585887384,365,0.0867189356142,97,0.0230458541221,442,35,25,432,467,53,0.0125920646234,442,0.105013067237,586,0.139225469233,3623,0.860774530767,3128,0.743169398907,103,Alamance,37001103
Alamance,4386,3430,0.78203374373,671,0.152986776106,35,0.00797993616051,24,0.00547195622435,110,0.0250797993616,116,0.0264477884177,732,69,52,715,784,61,0.0139078887369,732,0.166894664843,243,0.0554035567715,4143,0.944596443228,3343,0.762197902417,10N,Alamance,3700110N
Alamance,8086,5778,0.71456838981,1818,0.224833044769,39,0.0048231511254,102,0.0126143952511,136,0.0168191936681,213,0.0263418253772,1944,95,67,1916,2011,126,0.0155824882513,1944,0.24041553302,446,0.0551570615879,7640,0.944842938412,5545,0.685753153599,10S,Alamance,3700110S
Alamance,4575,2531,0.553224043716,1653,0.36131147541,58,0.0126775956284,4,0.000874316939891,223,0.0487431693989,106,0.0231693989071,1715,91,74,1698,1789,62,0.0135519125683,1715,0.374863387978,407,0.0889617486339,4168,0.911038251366,2397,0.52393442623,11,Alamance,3700111
Alamance,2802,1791,0.639186295503,704,0.25124910778,10,0.00356887937188,79,0.0281941470378,143,0.0510349750178,75,0.0267665952891,755,17,14,752,769,51,0.0182012847966,755,0.269450392577,246,0.0877944325482,2556,0.912205567452,1715,0.612062812277,1210,Alamance,370011210
Alamance,2455,1873,0.762932790224,329,0.134012219959,13,0.00529531568228,19,0.00773930753564,164,0.0668024439919,57,0.0232179226069,357,32,32,357,389,28,0.0114052953157,357,0.145417515275,250,0.10183299389,2205,0.89816700611,1797,0.731975560081,124,Alamance,37001124
Alamance,2662,2192,0.823441021788,297,0.111570247934,12,0.00450788880541,52,0.0195341848234,76,0.0285499624343,33,0.0123966942149,317,23,20,314,337,20,0.00751314800902,317,0.119083395943,194,0.0728775356875,2468,0.927122464313,2092,0.785875281743,125,Alamance,37001125
Alamance,2038,1905,0.934739941119,69,0.0338567222767,4,0.00196270853778,18,0.00883218842002,26,0.0127576054956,16,0.00785083415113,76,8,5,73,81,7,0.00343473994112,76,0.0372914622179,46,0.0225711481845,1992,0.977428851816,1887,0.925907752699,126,Alamance,37001126
Alamance,6951,2824,0.40627247878,3191,0.459070637318,40,0.0057545676881,75,0.0107898144152,594,0.0854553301683,227,0.03265717163,3314,101,73,3286,3387,123,0.0176952956409,3314,0.476765932959,1347,0.193785066897,5604,0.806214933103,2222,0.319666235074,127,Alamance,37001127
Alamance,3682,1599,0.434274850625,1306,0.354698533406,32,0.00869092884302,79,0.0214557305812,528,0.14340032591,138,0.0374796306355,1390,67,48,1371,1438,84,0.0228136882129,1390,0.377512221619,780,0.211841390549,2902,0.788158609451,1407,0.382129277567,128,Alamance,37001128
Alamance,2042,1704,0.834476003918,186,0.0910871694417,10,0.0048971596474,68,0.0333006856024,57,0.0279138099902,17,0.00832517140059,196,15,11,192,207,10,0.0048971596474,196,0.0959843290891,110,0.0538687561214,1932,0.946131243879,1660,0.812928501469,129,Alamance,37001129
Alamance,3391,1596,0.47065762312,956,0.281922736656,51,0.0150398112651,53,0.0156296077853,622,0.183426717782,113,0.0333235033913,1004,72,64,996,1068,48,0.0141551164848,1004,0.296077853141,1048,0.309053376585,2343,0.690946623415,1265,0.373046299027,12E,Alamance,3700112E
Alamance,6086,1723,0.283108774236,3214,0.528097272429,38,0.00624383831745,49,0.00805126519882,907,0.149030561945,155,0.0254682878738,3286,79,59,3266,3345,72,0.0118304304962,3286,0.539927702925,1446,0.237594479132,4640,0.762405520868,1325,0.217712783437,12N,Alamance,3700112N
Alamance,2684,1136,0.423248882265,947,0.352831594635,43,0.0160208643815,39,0.0145305514158,436,0.162444113264,83,0.0309239940387,993,81,60,972,1053,46,0.0171385991058,993,0.369970193741,706,0.26304023845,1978,0.73695976155,927,0.345380029806,12S,Alamance,3700112S
Alamance,2744,2184,0.795918367347,355,0.129373177843,12,0.00437317784257,33,0.0120262390671,104,0.0379008746356,56,0.0204081632653,381,28,19,372,400,26,0.00947521865889,381,0.138848396501,197,0.0717930029155,2547,0.928206997085,2107,0.767857142857,12W,Alamance,3700112W
Alamance,5429,3113,0.573402099834,1519,0.279793700497,55,0.010130779149,28,0.00515748756677,617,0.113648922453,97,0.0178670104992,1568,79,77,1566,1645,49,0.00902560324185,1568,0.288819303739,934,0.172039049549,4495,0.827960950451,2891,0.532510591269,13,Alamance,3700113
Alexander,3625,3499,0.96524137931,20,0.00551724137931,11,0.00303448275862,40,0.0110344827586,16,0.00441379310345,39,0.0107586206897,36,23,23,36,59,16,0.00441379310345,36,0.00993103448276,51,0.0140689655172,3574,0.985931034483,3468,0.956689655172,B1,Alexander,37003B1
Alexander,4524,4325,0.956012378426,37,0.00817860300619,7,0.00154730327144,73,0.0161361626879,26,0.00574712643678,56,0.0123784261715,61,16,16,61,77,24,0.0053050397878,61,0.013483642794,94,0.0207780725022,4430,0.979221927498,4265,0.942749778957,B2,Alexander,37003B2
Alexander,3319,3100,0.934016269961,158,0.0476047002109,4,0.00120518228382,10,0.00301295570955,19,0.00572461584815,28,0.00843627598674,174,13,13,174,187,16,0.00482072913528,174,0.0524254293462,48,0.0144621874058,3271,0.985537812594,3073,0.925881289545,E,Alexander,37003E
Alexander,1006,983,0.977137176938,5,0.00497017892644,1,0.000994035785288,0,0.0,4,0.00397614314115,13,0.0129224652087,11,9,8,10,19,6,0.00596421471173,11,0.0109343936382,11,0.0109343936382,995,0.989065606362,977,0.971172962227,G1,Alexander,37003G1
Alexander,1228,1117,0.909609120521,55,0.0447882736156,4,0.00325732899023,4,0.00325732899023,38,0.0309446254072,10,0.00814332247557,59,9,9,59,68,4,0.00325732899023,59,0.0480456026059,48,0.0390879478827,1180,0.960912052117,1111,0.904723127036,G2,Alexander,37003G2
Alexander,1447,1378,0.952315134762,36,0.0248790601244,4,0.00276434001382,9,0.0062197650311,8,0.00552868002764,12,0.00829302004147,46,6,6,46,52,10,0.00691085003455,46,0.0317899101589,29,0.0200414651002,1418,0.9799585349,1360,0.939875604699,L,Alexander,37003L
Alexander,2736,2332,0.852339181287,186,0.0679824561404,7,0.00255847953216,55,0.0201023391813,103,0.0376461988304,53,0.0193713450292,211,18,15,208,226,25,0.00913742690058,211,0.0771198830409,192,0.0701754385965,2544,0.929824561404,2256,0.824561403509,M,Alexander,37003M
Alexander,3213,2873,0.89417989418,90,0.0280112044818,7,0.00217864923747,5,0.00155617802677,190,0.0591347650171,48,0.014939309057,109,29,27,107,136,19,0.00591347650171,109,0.0339246809835,304,0.0946156240274,2909,0.905384375973,2776,0.863990040461,S1,Alexander,37003S1
Alexander,1376,1200,0.872093023256,84,0.0610465116279,3,0.00218023255814,4,0.00290697674419,52,0.0377906976744,33,0.0239825581395,104,12,12,104,116,20,0.0145348837209,104,0.0755813953488,77,0.0559593023256,1299,0.944040697674,1180,0.857558139535,S2,Alexander,37003S2
Alexander,1215,1182,0.972839506173,2,0.00164609053498,3,0.00246913580247,6,0.00493827160494,17,0.0139917695473,5,0.00411522633745,4,6,6,4,10,2,0.00164609053498,4,0.00329218106996,29,0.0238683127572,1186,0.976131687243,1172,0.964609053498,SL,Alexander,37003SL
Alexander,3377,2573,0.761918862896,581,0.172046194847,25,0.00740302043234,59,0.0174711282203,105,0.0310926858158,34,0.010068107788,597,33,33,597,630,16,0.0047379330767,597,0.176784127924,186,0.0550784720166,3191,0.944921527983,2499,0.740005922416,T1,Alexander,37003T1
Alexander,2382,1828,0.767422334173,309,0.129722921914,12,0.00503778337531,15,0.00629722921914,135,0.0566750629723,83,0.0348446683459,341,46,42,337,383,32,0.0134340890008,341,0.143157010915,246,0.103274559194,2136,0.896725440806,1739,0.730058774139,T2,Alexander,37003T2
Alexander,1776,1654,0.931306306306,76,0.0427927927928,2,0.00112612612613,12,0.00675675675676,6,0.00337837837838,26,0.0146396396396,87,11,11,87,98,11,0.00619369369369,87,0.0489864864865,44,0.0247747747748,1732,0.975225225225,1619,0.911599099099,T3,Alexander,37003T3
Alexander,2213,1794,0.810664256665,291,0.131495707185,0,0.0,32,0.0144600090375,49,0.0221418888387,47,0.0212381382738,324,12,7,319,331,33,0.0149118843199,324,0.146407591505,99,0.0447356529598,2114,0.95526434704,1752,0.791685494803,T4,Alexander,37003T4
Alexander,1430,1259,0.88041958042,99,0.0692307692308,2,0.0013986013986,18,0.0125874125874,44,0.0307692307692,8,0.00559440559441,100,3,3,100,103,1,0.000699300699301,100,0.0699300699301,82,0.0573426573427,1348,0.942657342657,1226,0.857342657343,T5,Alexander,37003T5
Alexander,2331,2227,0.955383955384,14,0.00600600600601,6,0.002574002574,30,0.01287001287,26,0.011154011154,28,0.012012012012,30,10,10,30,40,16,0.00686400686401,30,0.01287001287,61,0.026169026169,2270,0.973830973831,2198,0.942942942943,W,Alexander,37003W
Alleghany,1528,1460,0.955497382199,4,0.00261780104712,1,0.00065445026178,12,0.00785340314136,32,0.020942408377,19,0.0124345549738,5,10,10,5,15,1,0.00065445026178,5,0.0032722513089,58,0.0379581151832,1470,0.962041884817,1439,0.941753926702,01,Alleghany,3700501
Alleghany,375,341,0.909333333333,4,0.0106666666667,0,0.0,0,0.0,28,0.0746666666667,2,0.00533333333333,6,0,0,6,6,2,0.00533333333333,6,0.016,37,0.0986666666667,338,0.901333333333,334,0.890666666667,02,Alleghany,3700502
Alleghany,4474,3964,0.886008046491,106,0.0236924452392,20,0.00447027268663,28,0.00625838176129,290,0.0648189539562,66,0.0147518998659,123,42,40,121,163,17,0.00379973178364,123,0.0274921770228,544,0.121591417076,3930,0.878408582924,3754,0.839070183281,03,Alleghany,3700503
Alleghany,1991,1823,0.915620291311,12,0.00602712204922,0,0.0,2,0.00100452034154,130,0.0652938221999,24,0.0120542440984,21,13,9,17,30,9,0.00452034153692,21,0.0105474635861,219,0.109994977398,1772,0.890005022602,1745,0.876443997991,04,Alleghany,3700504
Alleghany,858,824,0.960372960373,9,0.0104895104895,5,0.00582750582751,8,0.00932400932401,10,0.011655011655,2,0.002331002331,9,7,7,9,16,0,0.0,9,0.0104895104895,76,0.0885780885781,782,0.911421911422,759,0.884615384615,05,Alleghany,3700505
Alleghany,869,847,0.974683544304,0,0.0,1,0.00115074798619,4,0.00460299194476,14,0.0161104718067,3,0.00345224395857,1,2,2,1,3,1,0.00115074798619,1,0.00115074798619,40,0.0460299194476,829,0.953970080552,821,0.944764096663,06,Alleghany,3700506
Alleghany,1060,1029,0.970754716981,5,0.00471698113208,0,0.0,3,0.00283018867925,11,0.0103773584906,12,0.011320754717,5,12,12,5,17,0,0.0,5,0.00471698113208,30,0.0283018867925,1030,0.971698113208,1010,0.952830188679,07,Alleghany,3700507
Anson,1665,945,0.567567567568,652,0.391591591592,4,0.0024024024024,32,0.0192192192192,23,0.0138138138138,9,0.00540540540541,658,6,6,658,664,6,0.0036036036036,658,0.395195195195,36,0.0216216216216,1629,0.978378378378,942,0.565765765766,ANS,Anson,37007ANS
Anson,1942,1555,0.800720906282,312,0.160659114315,9,0.00463439752832,27,0.013903192585,21,0.0108135942327,18,0.00926879505664,319,20,17,316,336,7,0.00360453141092,319,0.164263645726,34,0.0175077239959,1908,0.982492276004,1546,0.796086508754,BURN,Anson,37007BURN
Anson,1613,650,0.402975821451,923,0.57222566646,3,0.0018598884067,2,0.00123992560446,16,0.00991940483571,19,0.0117792932424,935,12,9,932,944,12,0.00743955362678,935,0.579665220087,34,0.0210787352759,1579,0.978921264724,640,0.396776193428,GULL,Anson,37007GULL
Anson,3510,1570,0.447293447293,1821,0.518803418803,29,0.00826210826211,11,0.0031339031339,16,0.0045584045584,63,0.0179487179487,1851,60,55,1846,1906,30,0.00854700854701,1851,0.52735042735,40,0.011396011396,3470,0.988603988604,1558,0.443874643875,LILE,Anson,37007LILE
Anson,1954,500,0.255885363357,1319,0.675025588536,21,0.010747185261,9,0.00460593654043,65,0.0332650972364,40,0.0204708290686,1350,35,29,1344,1379,31,0.0158648925281,1350,0.690890481064,102,0.0522006141249,1852,0.947799385875,482,0.246673490276,MM,Anson,37007MM
Anson,2077,1656,0.797303803563,316,0.15214251324,5,0.00240731824747,39,0.0187770823303,43,0.0207029369283,18,0.0086663456909,327,13,11,325,338,11,0.00529610014444,327,0.157438613385,79,0.0380356283101,1998,0.96196437169,1614,0.777082330284,PEAC,Anson,37007PEAC
Anson,1735,895,0.515850144092,767,0.442074927954,16,0.00922190201729,21,0.0121037463977,3,0.00172910662824,33,0.0190201729107,780,32,32,780,812,13,0.00749279538905,780,0.449567723343,16,0.00922190201729,1719,0.990778097983,891,0.513544668588,POLK,Anson,37007POLK
Anson,3536,993,0.280825791855,2418,0.683823529412,18,0.00509049773756,28,0.0079185520362,42,0.0118778280543,37,0.010463800905,2451,26,21,2446,2472,33,0.00933257918552,2451,0.693156108597,63,0.0178167420814,3473,0.982183257919,981,0.277432126697,W1,Anson,37007W1
Anson,4676,1691,0.361633875107,2786,0.595808383234,51,0.0109067579127,46,0.0098374679213,76,0.01625320787,26,0.00556030795552,2802,66,60,2796,2862,16,0.00342172797263,2802,0.599230111206,289,0.0618049615056,4387,0.938195038494,1481,0.316723695466,W2,Anson,37007W2
Anson,3734,1947,0.521424745581,1618,0.433315479379,9,0.00241028387788,68,0.018211033744,26,0.00696304231387,66,0.0176754151044,1665,25,20,1660,1685,47,0.0125870380289,1665,0.445902517408,52,0.0139260846277,3682,0.986073915372,1942,0.520085698982,W3,Anson,37007W3
Anson,506,305,0.602766798419,158,0.312252964427,0,0.0,9,0.0177865612648,26,0.0513833992095,8,0.0158102766798,163,4,3,162,166,5,0.0098814229249,163,0.322134387352,67,0.132411067194,439,0.867588932806,267,0.52766798419,WS,Anson,37007WS
Ashe,1819,1755,0.964815832875,6,0.00329851566795,4,0.0021990104453,4,0.0021990104453,28,0.0153930731171,22,0.0120945574491,8,17,16,7,24,2,0.00109950522265,8,0.0043980208906,61,0.0335349092908,1758,0.966465090709,1733,0.952721275426,02,Ashe,3700902
Ashe,612,583,0.952614379085,1,0.0016339869281,3,0.00490196078431,11,0.0179738562092,12,0.0196078431373,2,0.00326797385621,1,5,5,1,6,0,0.0,1,0.0016339869281,15,0.0245098039216,597,0.975490196078,581,0.949346405229,03,Ashe,3700903
Ashe,613,606,0.988580750408,1,0.00163132137031,1,0.00163132137031,0,0.0,4,0.00652528548124,1,0.00163132137031,1,2,2,1,3,0,0.0,1,0.00163132137031,7,0.0114192495922,606,0.988580750408,603,0.983686786297,04,Ashe,3700904
Ashe,718,702,0.977715877437,6,0.008356545961,3,0.0041782729805,1,0.00139275766017,2,0.00278551532033,4,0.00557103064067,6,7,7,6,13,0,0.0,6,0.008356545961,12,0.016713091922,706,0.983286908078,694,0.966573816156,06,Ashe,3700906
Ashe,680,665,0.977941176471,0,0.0,0,0.0,0,0.0,5,0.00735294117647,10,0.0147058823529,0,10,10,0,10,0,0.0,0,0.0,14,0.0205882352941,666,0.979411764706,656,0.964705882353,07,Ashe,3700907
Ashe,302,297,0.983443708609,1,0.00331125827815,0,0.0,0,0.0,0,0.0,4,0.0132450331126,1,4,4,1,5,0,0.0,1,0.00331125827815,0,0.0,302,1.0,297,0.983443708609,08,Ashe,3700908
Ashe,4718,4404,0.933446375583,51,0.0108096651123,7,0.00148367952522,26,0.00551080966511,187,0.0396354387452,43,0.00911403136922,67,28,23,62,90,16,0.00339126748622,67,0.0142009325986,264,0.0559559135227,4454,0.944044086477,4337,0.919245442984,09,Ashe,3700909
Ashe,413,401,0.970944309927,0,0.0,2,0.00484261501211,1,0.00242130750605,0,0.0,9,0.0217917675545,3,9,8,2,11,3,0.00726392251816,3,0.00726392251816,9,0.0217917675545,404,0.978208232446,392,0.949152542373,10,Ashe,3700910
Ashe,2652,2552,0.962292609351,18,0.00678733031674,4,0.00150829562594,2,0.000754147812971,61,0.0230015082956,15,0.00565610859729,28,8,8,28,36,10,0.00377073906486,28,0.0105580693816,171,0.064479638009,2481,0.935520361991,2447,0.92269984917,11,Ashe,3700911
Ashe,868,846,0.97465437788,3,0.00345622119816,1,0.00115207373272,1,0.00115207373272,0,0.0,17,0.0195852534562,7,15,14,6,21,4,0.00460829493088,7,0.00806451612903,19,0.0218894009217,849,0.978110599078,827,0.952764976959,12,Ashe,3700912
Ashe,1376,1339,0.973110465116,5,0.00363372093023,6,0.00436046511628,3,0.00218023255814,16,0.0116279069767,7,0.00508720930233,7,10,10,7,17,2,0.00145348837209,7,0.00508720930233,73,0.0530523255814,1303,0.946947674419,1286,0.934593023256,13,Ashe,3700913
Ashe,2708,2643,0.97599704579,3,0.00110782865583,8,0.00295420974889,10,0.00369276218612,24,0.00886262924668,20,0.00738552437223,9,21,17,5,26,6,0.00221565731167,9,0.0033234859675,77,0.0284342688331,2631,0.971565731167,2601,0.960487444609,14,Ashe,3700914
Ashe,1104,1058,0.958333333333,3,0.00271739130435,6,0.0054347826087,3,0.00271739130435,31,0.0280797101449,3,0.00271739130435,3,7,7,3,10,0,0.0,3,0.00271739130435,47,0.0425724637681,1057,0.957427536232,1042,0.94384057971,15,Ashe,3700915
Ashe,2614,2517,0.962892119357,11,0.00420811017598,3,0.00114766641163,12,0.00459066564652,32,0.0122417750574,39,0.0149196633512,23,19,18,22,41,12,0.00459066564652,23,0.00879877582249,102,0.0390206579954,2512,0.960979342005,2452,0.938026013772,16,Ashe,3700916
Ashe,1230,1187,0.965040650407,2,0.00162601626016,6,0.00487804878049,1,0.000813008130081,17,0.0138211382114,17,0.0138211382114,8,13,13,8,21,6,0.00487804878049,8,0.00650406504065,23,0.0186991869919,1207,0.981300813008,1186,0.964227642276,17,Ashe,3700917
Ashe,240,233,0.970833333333,1,0.00416666666667,1,0.00416666666667,0,0.0,0,0.0,5,0.0208333333333,1,6,6,1,7,0,0.0,1,0.00416666666667,4,0.0166666666667,236,0.983333333333,229,0.954166666667,18,Ashe,3700918
Ashe,4614,4262,0.923710446467,49,0.0106198526225,10,0.00216731686173,38,0.00823580407456,194,0.0420459471175,61,0.0132206328565,76,35,35,76,111,27,0.00585175552666,76,0.0164716081491,413,0.0895101863893,4201,0.910489813611,4057,0.879280450802,20,Ashe,3700920
Avery,1297,1195,0.921356977641,19,0.0146491904395,6,0.00462606013878,4,0.00308404009252,63,0.0485736314572,10,0.0077101002313,21,13,13,21,34,2,0.00154202004626,21,0.0161912104857,122,0.0940632228219,1175,0.905936777178,1134,0.87432536623,01,Avery,3701101
Avery,2996,2785,0.929572763685,68,0.022696929239,13,0.0043391188251,24,0.00801068090788,56,0.018691588785,50,0.0166889185581,77,38,36,75,113,9,0.00300400534045,77,0.0257009345794,131,0.0437249666222,2865,0.956275033378,2717,0.906875834446,02,Avery,3701102
Avery,672,660,0.982142857143,0,0.0,2,0.00297619047619,1,0.0014880952381,3,0.00446428571429,6,0.00892857142857,0,3,3,0,3,0,0.0,0,0.0,17,0.0252976190476,655,0.974702380952,652,0.970238095238,03,Avery,3701103
Avery,132,127,0.962121212121,3,0.0227272727273,0,0.0,0,0.0,0,0.0,2,0.0151515151515,3,2,2,3,5,0,0.0,3,0.0227272727273,0,0.0,132,1.0,127,0.962121212121,04,Avery,3701104
Avery,614,593,0.965798045603,4,0.00651465798046,3,0.00488599348534,0,0.0,11,0.0179153094463,3,0.00488599348534,6,5,4,5,10,2,0.00325732899023,6,0.00977198697068,12,0.0195439739414,602,0.980456026059,592,0.964169381107,05,Avery,3701105
Avery,1227,1172,0.955175224124,7,0.00570497147514,9,0.00733496332518,0,0.0,27,0.0220048899756,12,0.00977995110024,9,9,9,9,18,2,0.00162999185004,9,0.00733496332518,55,0.0448247758761,1172,0.955175224124,1154,0.940505297474,06,Avery,3701106
Avery,296,289,0.976351351351,4,0.0135135135135,1,0.00337837837838,0,0.0,1,0.00337837837838,1,0.00337837837838,4,2,2,4,6,0,0.0,4,0.0135135135135,3,0.0101351351351,293,0.989864864865,287,0.969594594595,07,Avery,3701107
Avery,443,424,0.957110609481,1,0.00225733634312,2,0.00451467268623,2,0.00451467268623,13,0.0293453724605,1,0.00225733634312,1,2,2,1,3,0,0.0,1,0.00225733634312,30,0.0677200902935,413,0.932279909707,407,0.918735891648,08,Avery,3701108
Avery,490,482,0.983673469388,0,0.0,1,0.00204081632653,0,0.0,5,0.0102040816327,2,0.00408163265306,0,2,2,0,2,0,0.0,0,0.0,10,0.0204081632653,480,0.979591836735,478,0.975510204082,09,Avery,3701109
Avery,2930,2243,0.765529010239,579,0.197610921502,19,0.00648464163823,11,0.0037542662116,70,0.0238907849829,8,0.00273037542662,581,26,25,580,606,2,0.000682593856655,581,0.198293515358,109,0.0372013651877,2821,0.962798634812,2204,0.752218430034,10,Avery,3701110
Avery,453,416,0.918322295806,0,0.0,1,0.00220750551876,8,0.0176600441501,14,0.0309050772627,14,0.0309050772627,0,14,14,0,14,0,0.0,0,0.0,30,0.0662251655629,423,0.933774834437,400,0.883002207506,11,Avery,3701111
Avery,384,377,0.981770833333,0,0.0,1,0.00260416666667,0,0.0,4,0.0104166666667,2,0.00520833333333,0,3,3,0,3,0,0.0,0,0.0,7,0.0182291666667,377,0.981770833333,374,0.973958333333,12,Avery,3701112
Avery,676,664,0.98224852071,0,0.0,1,0.00147928994083,2,0.00295857988166,7,0.0103550295858,2,0.00295857988166,0,3,3,0,3,0,0.0,0,0.0,20,0.0295857988166,656,0.970414201183,651,0.963017751479,13,Avery,3701113
Avery,1189,1148,0.965517241379,7,0.00588730025231,0,0.0,3,0.00252312867956,22,0.0185029436501,9,0.00756938603869,9,6,6,9,15,2,0.00168208578638,9,0.00756938603869,42,0.0353238015139,1147,0.964676198486,1124,0.945332211943,14,Avery,3701114
Avery,1096,1002,0.914233576642,1,0.000912408759124,7,0.00638686131387,5,0.00456204379562,71,0.0647810218978,10,0.00912408759124,2,12,12,2,14,1,0.000912408759124,2,0.00182481751825,85,0.0775547445255,1011,0.922445255474,990,0.903284671533,15,Avery,3701115
Avery,1207,1134,0.93951946976,7,0.00579950289975,3,0.00248550124275,3,0.00248550124275,54,0.0447390223695,6,0.0049710024855,7,6,6,7,13,0,0.0,7,0.00579950289975,92,0.076222038111,1115,0.923777961889,1097,0.908864954432,16,Avery,3701116
Avery,711,695,0.977496483826,9,0.0126582278481,0,0.0,0,0.0,4,0.0056258790436,3,0.0042194092827,9,0,0,9,9,0,0.0,9,0.0126582278481,10,0.014064697609,701,0.985935302391,691,0.971870604782,17,Avery,3701117
Avery,516,500,0.968992248062,0,0.0,4,0.0077519379845,0,0.0,6,0.0116279069767,6,0.0116279069767,0,6,6,0,6,0,0.0,0,0.0,18,0.0348837209302,498,0.96511627907,492,0.953488372093,18,Avery,3701118
Avery,468,458,0.978632478632,0,0.0,2,0.0042735042735,1,0.00213675213675,4,0.00854700854701,3,0.00641025641026,0,5,5,0,5,0,0.0,0,0.0,4,0.00854700854701,464,0.991452991453,458,0.978632478632,19,Avery,3701119
Beaufort,1621,823,0.507711289328,734,0.452806909315,6,0.00370141887724,2,0.00123380629241,26,0.0160394818014,30,0.0185070943862,753,19,15,749,768,19,0.0117211597779,753,0.464528069093,48,0.0296113510179,1573,0.970388648982,811,0.500308451573,AUROR,Beaufort,37013AUROR
Beaufort,2412,2096,0.868988391376,153,0.0634328358209,3,0.00124378109453,7,0.00290215588723,132,0.0547263681592,21,0.00870646766169,169,9,6,166,175,16,0.00663349917081,169,0.0700663349917,189,0.0783582089552,2223,0.921641791045,2044,0.847429519071,BEADM,Beaufort,37013BEADM
Beaufort,2354,1223,0.519541206457,1013,0.430331350892,20,0.00849617672048,9,0.00382327952421,52,0.0220900594732,37,0.0157179269329,1044,26,24,1042,1068,31,0.0131690739167,1044,0.443500424809,113,0.0480033984707,2241,0.951996601529,1185,0.503398470688,BELHV,Beaufort,37013BELHV
Beaufort,1008,658,0.652777777778,319,0.316468253968,4,0.00396825396825,5,0.00496031746032,7,0.00694444444444,15,0.014880952381,323,12,12,323,335,4,0.00396825396825,323,0.320436507937,19,0.0188492063492,989,0.981150793651,649,0.643849206349,BLCK,Beaufort,37013BLCK
Beaufort,6147,4281,0.696437286481,1436,0.233609891004,9,0.00146412884334,19,0.00309093866927,312,0.0507564665691,90,0.0146412884334,1491,39,31,1483,1522,55,0.00894745404262,1491,0.242557345046,431,0.0701155034976,5716,0.929884496502,4175,0.679193102326,CHOCO,Beaufort,37013CHOCO
Beaufort,1485,881,0.593265993266,570,0.383838383838,5,0.003367003367,7,0.0047138047138,3,0.0020202020202,19,0.0127946127946,584,10,8,582,592,14,0.00942760942761,584,0.393265993266,31,0.0208754208754,1454,0.979124579125,863,0.581144781145,EDWAR,Beaufort,37013EDWAR
Beaufort,2141,1861,0.869219990659,235,0.109761793554,3,0.0014012143858,19,0.00887435777674,4,0.00186828584773,19,0.00887435777674,247,10,6,243,253,12,0.0056048575432,247,0.115366651098,21,0.00980850070061,2120,0.990191499299,1848,0.863148061653,GILEA,Beaufort,37013GILEA
Beaufort,1191,1032,0.866498740554,113,0.0948782535684,7,0.00587741393787,0,0.0,32,0.0268681780017,7,0.00587741393787,115,9,8,114,123,2,0.0016792611251,115,0.0965575146935,67,0.056255247691,1124,0.943744752309,1010,0.848026868178,HB,Beaufort,37013HB
Beaufort,1933,1718,0.888773926539,191,0.0988101396793,9,0.00465597516813,1,0.000517330574237,1,0.000517330574237,13,0.00672529746508,199,14,13,198,212,8,0.0041386445939,199,0.102948784273,28,0.0144852560786,1905,0.985514743921,1701,0.879979306777,NCRK,Beaufort,37013NCRK
Beaufort,1892,1238,0.654334038055,567,0.299682875264,1,0.000528541226216,9,0.00475687103594,54,0.0285412262156,23,0.012156448203,581,8,4,577,585,14,0.00739957716702,581,0.307082452431,78,0.0412262156448,1814,0.958773784355,1222,0.645877378436,OLDF,Beaufort,37013OLDF
Beaufort,1792,1114,0.621651785714,573,0.319754464286,31,0.0172991071429,0,0.0,63,0.03515625,11,0.00613839285714,581,39,34,576,615,8,0.00446428571429,581,0.32421875,161,0.08984375,1631,0.91015625,1052,0.587053571429,PANTE,Beaufort,37013PANTE
Beaufort,1241,1121,0.903303787268,80,0.0644641418211,4,0.00322320709106,4,0.00322320709106,20,0.0161160354553,12,0.00966962127317,87,9,9,87,96,7,0.00564061240935,87,0.0701047542305,61,0.0491539081386,1180,0.950846091861,1087,0.875906526994,PINET,Beaufort,37013PINET
Beaufort,2057,560,0.272241127856,1343,0.652892561983,1,0.000486144871172,23,0.0111813320369,85,0.0413223140496,45,0.0218765192027,1378,8,2,1372,1380,35,0.017015070491,1378,0.669907632474,136,0.0661157024793,1921,0.933884297521,525,0.255226057365,PSJW3,Beaufort,37013PSJW3
Beaufort,3282,2042,0.622181596587,686,0.20901889092,35,0.0106642291286,7,0.00213284582572,473,0.144119439366,39,0.0118829981718,694,47,45,692,739,8,0.00243753808653,694,0.211456429007,665,0.202620353443,2617,0.797379646557,1918,0.584399756246,RVRD,Beaufort,37013RVRD
Beaufort,2274,2126,0.93491644679,89,0.0391380826737,5,0.00219876868953,4,0.00175901495163,18,0.00791556728232,32,0.014072119613,94,29,29,94,123,5,0.00219876868953,94,0.0413368513632,42,0.0184696569921,2232,0.981530343008,2107,0.92656112577,SURBA,Beaufort,37013SURBA
Beaufort,3517,2705,0.769121410293,538,0.152971282343,18,0.005117998294,22,0.00625533124822,168,0.0477679840773,66,0.0187659937447,578,31,25,572,603,40,0.0113733295422,578,0.164344611885,236,0.0671026442991,3281,0.932897355701,2656,0.755189081604,TCRK,Beaufort,37013TCRK
Beaufort,2165,1010,0.466512702079,1038,0.479445727483,7,0.00323325635104,10,0.00461893764434,73,0.0337182448037,27,0.0124711316397,1055,21,13,1047,1068,17,0.00785219399538,1055,0.487297921478,146,0.0674364896074,2019,0.932563510393,949,0.438337182448,WASH1,Beaufort,37013WASH1
Beaufort,2198,932,0.424021838035,1159,0.527297543221,6,0.00272975432211,17,0.00773430391265,41,0.0186533212011,43,0.0195632393085,1191,14,10,1187,1201,32,0.0145586897179,1191,0.541856232939,85,0.0386715195632,2113,0.961328480437,909,0.4135577798,WASH2,Beaufort,37013WASH2
Beaufort,3297,2179,0.660903851987,843,0.255686988171,6,0.00181983621474,6,0.00181983621474,226,0.0685471640886,37,0.0112223233242,866,24,13,855,879,23,0.00697603882317,866,0.262663026994,309,0.0937215650591,2988,0.906278434941,2111,0.640279041553,WASH4,Beaufort,37013WASH4
Beaufort,1712,1163,0.679322429907,358,0.209112149533,9,0.00525700934579,8,0.00467289719626,165,0.0963785046729,9,0.00525700934579,366,13,9,362,375,8,0.00467289719626,366,0.213785046729,219,0.127920560748,1493,0.872079439252,1128,0.658878504673,WASHP,Beaufort,37013WASHP
Beaufort,2040,1788,0.876470588235,185,0.0906862745098,19,0.0093137254902,5,0.00245098039216,31,0.0151960784314,12,0.00588235294118,192,24,24,192,216,7,0.00343137254902,192,0.0941176470588,81,0.0397058823529,1959,0.960294117647,1755,0.860294117647,WDPD,Beaufort,37013WDPD
Bertie,1229,593,0.482506102522,614,0.499593165175,3,0.00244100895037,0,0.0,8,0.00650935720098,11,0.00895036615134,621,9,7,619,628,7,0.00569568755085,621,0.505288852726,13,0.0105777054516,1216,0.989422294548,588,0.478437754272,C1,Bertie,37015C1
Bertie,2182,701,0.321264894592,1449,0.664069660862,9,0.00412465627864,0,0.0,14,0.006416131989,9,0.00412465627864,1451,11,11,1451,1462,2,0.000916590284143,1451,0.664986251146,29,0.0132905591201,2153,0.98670944088,690,0.316223648029,C2,Bertie,37015C2
Bertie,471,58,0.123142250531,411,0.872611464968,1,0.00212314225053,0,0.0,0,0.0,1,0.00212314225053,412,1,1,412,413,1,0.00212314225053,412,0.874734607219,8,0.0169851380042,463,0.983014861996,56,0.11889596603,IW,Bertie,37015IW
Bertie,1103,517,0.468721668178,573,0.519492293744,3,0.00271985494107,1,0.00090661831369,0,0.0,9,0.00815956482321,581,11,3,573,584,8,0.00725294650952,581,0.526745240254,1,0.00090661831369,1102,0.999093381686,516,0.467815049864,M1,Bertie,37015M1
Bertie,1290,457,0.354263565891,813,0.63023255814,3,0.00232558139535,1,0.00077519379845,0,0.0,16,0.0124031007752,828,10,3,821,831,15,0.0116279069767,828,0.641860465116,10,0.0077519379845,1280,0.992248062016,452,0.350387596899,M2,Bertie,37015M2
Bertie,992,400,0.403225806452,578,0.582661290323,3,0.00302419354839,3,0.00302419354839,1,0.00100806451613,7,0.0070564516129,580,7,7,580,587,2,0.00201612903226,580,0.584677419355,4,0.00403225806452,988,0.995967741935,398,0.401209677419,MH,Bertie,37015MH
Bertie,1671,381,0.228007181329,1266,0.75763016158,7,0.00418910831837,0,0.0,11,0.0065828845003,6,0.00359066427289,1271,10,7,1268,1278,5,0.00299222022741,1271,0.760622381807,24,0.0143626570916,1647,0.985637342908,369,0.220825852783,RX,Bertie,37015RX
Bertie,1410,272,0.192907801418,1094,0.775886524823,6,0.00425531914894,0,0.0,30,0.0212765957447,8,0.00567375886525,1102,12,6,1096,1108,8,0.00567375886525,1102,0.781560283688,49,0.0347517730496,1361,0.96524822695,259,0.183687943262,SN,Bertie,37015SN
Bertie,7005,2116,0.302069950036,4631,0.661099214847,53,0.00756602426838,82,0.0117059243398,18,0.00256959314775,105,0.0149892933619,4722,112,64,4674,4786,91,0.0129907209136,4722,0.67408993576,83,0.0118486795146,6922,0.988151320485,2083,0.297359029265,W1,Bertie,37015W1
Bertie,966,906,0.937888198758,42,0.0434782608696,4,0.00414078674948,8,0.00828157349896,0,0.0,6,0.00621118012422,48,6,4,46,52,6,0.00621118012422,48,0.0496894409938,1,0.00103519668737,965,0.998964803313,905,0.93685300207,W2,Bertie,37015W2
Bertie,1409,174,0.123491838183,1193,0.846699787083,3,0.00212916962385,13,0.00922640170334,12,0.00851667849539,14,0.00993612491128,1197,8,6,1195,1203,4,0.0028388928318,1197,0.849538679915,37,0.0262597586941,1372,0.973740241306,164,0.116394606104,WD,Bertie,37015WD
Bertie,1554,913,0.587516087516,632,0.406692406692,1,0.000643500643501,1,0.000643500643501,2,0.001287001287,5,0.0032175032175,635,3,2,634,637,3,0.0019305019305,635,0.408622908623,8,0.00514800514801,1546,0.994851994852,913,0.587516087516,WH,Bertie,37015WH
Bladen,1094,745,0.680987202925,268,0.244972577697,17,0.0155393053016,3,0.00274223034735,42,0.0383912248629,19,0.0173674588665,282,21,20,281,302,14,0.0127970749543,282,0.257769652651,73,0.0667276051188,1021,0.933272394881,723,0.660877513711,P10,Bladen,37017P10
Bladen,4467,2969,0.66465189165,866,0.193866129393,54,0.0120886501007,4,0.000895455563018,493,0.110364898142,81,0.0181329751511,894,102,85,877,979,28,0.00626818894112,894,0.200134318334,629,0.140810387285,3838,0.859189612715,2874,0.643384822028,P15,Bladen,37017P15
Bladen,2047,1668,0.814851001466,326,0.159257449927,19,0.00928187591597,7,0.00341963849536,10,0.00488519785051,17,0.00830483634587,337,25,23,335,360,11,0.00537371763556,337,0.164631167562,40,0.0195407914021,2007,0.980459208598,1644,0.803126526624,P201,Bladen,37017P201
Bladen,3962,2853,0.7200908632,932,0.235234729934,43,0.0108531044927,3,0.000757193336699,66,0.0166582534074,65,0.0164058556285,967,83,66,950,1033,35,0.00883392226148,967,0.244068652196,132,0.0333165068147,3830,0.966683493185,2798,0.706208985361,P202,Bladen,37017P202
Bladen,1829,869,0.475123018043,835,0.456533624932,29,0.01585565883,3,0.00164024056862,66,0.0360852925096,27,0.0147621651176,848,42,37,843,885,13,0.00710770913067,848,0.463641334062,98,0.0535811919081,1731,0.946418808092,848,0.463641334062,P25,Bladen,37017P25
Bladen,1884,345,0.183121019108,1141,0.605626326964,343,0.182059447983,0,0.0,6,0.0031847133758,49,0.026008492569,1176,381,357,1152,1533,35,0.0185774946921,1176,0.624203821656,13,0.00690021231423,1871,0.993099787686,341,0.180997876858,P30,Bladen,37017P30
Bladen,1217,570,0.468364831553,508,0.417419884963,26,0.0213640098603,4,0.00328677074774,82,0.0673788003287,27,0.0221857025472,522,38,35,519,557,14,0.0115036976171,522,0.42892358258,117,0.0961380443714,1100,0.903861955629,543,0.446179129006,P35,Bladen,37017P35
Bladen,2304,1528,0.663194444444,582,0.252604166667,19,0.00824652777778,4,0.00173611111111,147,0.0638020833333,24,0.0104166666667,594,28,27,593,621,12,0.00520833333333,594,0.2578125,194,0.0842013888889,2110,0.915798611111,1485,0.64453125,P40,Bladen,37017P40
Bladen,965,706,0.731606217617,170,0.176165803109,13,0.0134715025907,0,0.0,68,0.0704663212435,8,0.00829015544041,172,13,13,172,185,2,0.0020725388601,172,0.178238341969,100,0.103626943005,865,0.896373056995,684,0.708808290155,P45,Bladen,37017P45
Bladen,4042,1768,0.437407224146,2041,0.504948045522,12,0.00296882731321,22,0.00544285007422,156,0.0385947550717,43,0.0106382978723,2068,34,22,2056,2090,27,0.00667986145473,2068,0.511627906977,202,0.0499752597724,3840,0.950024740228,1738,0.429985155863,P501,Bladen,37017P501
Bladen,2638,1212,0.459438968916,1275,0.483320697498,18,0.0068233510235,9,0.00341167551175,79,0.029946929492,45,0.0170583775588,1296,38,34,1292,1330,21,0.00796057619409,1296,0.491281273692,124,0.0470053070508,2514,0.952994692949,1180,0.447308567096,P502,Bladen,37017P502
Bladen,1035,625,0.6038647343,363,0.350724637681,16,0.0154589371981,0,0.0,19,0.0183574879227,12,0.0115942028986,370,18,18,370,388,7,0.00676328502415,370,0.357487922705,45,0.0434782608696,990,0.95652173913,596,0.575845410628,P55,Bladen,37017P55
Bladen,2318,1147,0.494823123382,907,0.391285591027,54,0.02329594478,5,0.00215703192407,170,0.0733390854185,35,0.0150992234685,926,65,64,925,990,19,0.00819672131148,926,0.399482312338,222,0.0957722174288,2096,0.904227782571,1104,0.476272648835,P60,Bladen,37017P60
Bladen,909,654,0.719471947195,202,0.222222222222,11,0.012101210121,0,0.0,37,0.040704070407,5,0.00550055005501,206,16,12,202,218,4,0.004400440044,206,0.226622662266,78,0.0858085808581,831,0.914191419142,613,0.674367436744,P65,Bladen,37017P65
Bladen,733,446,0.608458390177,246,0.335607094134,5,0.00682128240109,1,0.00136425648022,25,0.0341064120055,10,0.0136425648022,251,9,7,249,258,5,0.00682128240109,251,0.342428376535,41,0.0559345156889,692,0.944065484311,429,0.585266030014,P70,Bladen,37017P70
Bladen,1850,649,0.350810810811,1075,0.581081081081,57,0.0308108108108,4,0.00216216216216,36,0.0194594594595,29,0.0156756756757,1091,77,69,1083,1160,16,0.00864864864865,1091,0.58972972973,61,0.032972972973,1789,0.967027027027,630,0.340540540541,P75,Bladen,37017P75
Bladen,1896,1052,0.554852320675,531,0.280063291139,13,0.00685654008439,6,0.00316455696203,272,0.143459915612,22,0.0116033755274,544,25,20,539,564,13,0.00685654008439,544,0.286919831224,333,0.175632911392,1563,0.824367088608,1012,0.533755274262,P80,Bladen,37017P80
Brunswick,2723,1839,0.675358060962,687,0.252295262578,31,0.0113845023871,10,0.00367242012486,74,0.027175908924,82,0.0301138450239,744,66,51,729,795,57,0.0209327947117,744,0.27322805729,144,0.052882849798,2579,0.947117150202,1771,0.650385604113,01,Brunswick,3701901
Brunswick,7119,4746,0.666666666667,1539,0.21618204804,100,0.0140469167018,42,0.00589970501475,494,0.0693917685068,198,0.0278128950695,1656,172,141,1625,1797,117,0.0164348925411,1656,0.232616940582,935,0.131338671162,6184,0.868661328838,4372,0.614131198202,02,Brunswick,3701902
Brunswick,2408,1397,0.580149501661,789,0.327657807309,24,0.00996677740864,15,0.0062292358804,109,0.0452657807309,74,0.03073089701,831,50,42,823,873,42,0.0174418604651,831,0.345099667774,216,0.0897009966777,2192,0.910299003322,1307,0.542774086379,03,Brunswick,3701903
Brunswick,13819,11262,0.814964903394,1744,0.126203053767,66,0.00477603299805,193,0.0139662783125,248,0.0179463058108,306,0.0221434257182,1906,163,119,1862,2025,162,0.0117229900861,1906,0.137926043853,640,0.0463130472538,13179,0.953686952746,10943,0.791880743903,04,Brunswick,3701904
Brunswick,5335,4304,0.806747891284,696,0.13045923149,64,0.0119962511715,21,0.00393626991565,118,0.0221180880975,132,0.0247422680412,740,132,119,727,859,44,0.00824742268041,740,0.138706654171,245,0.0459231490159,5090,0.954076850984,4218,0.790627928772,05,Brunswick,3701905
Brunswick,2408,1734,0.720099667774,588,0.244186046512,19,0.0078903654485,4,0.00166112956811,12,0.00498338870432,51,0.0211794019934,615,47,39,607,654,27,0.0112126245847,615,0.255398671096,35,0.0145348837209,2373,0.985465116279,1716,0.712624584718,06,Brunswick,3701906
Brunswick,3167,2729,0.861698768551,295,0.0931480896748,14,0.0044205873066,16,0.00505209977897,60,0.0189453741711,53,0.0167350805178,315,42,41,314,356,20,0.00631512472371,315,0.0994632143985,138,0.0435743605936,3029,0.956425639406,2654,0.838017050837,07,Brunswick,3701907
Brunswick,4769,4080,0.855525267352,460,0.0964562801426,14,0.00293562591738,43,0.00901656531768,58,0.0121618788006,114,0.0239043824701,505,59,52,498,557,45,0.00943594044873,505,0.105892220591,164,0.0343887607465,4605,0.965611239254,3991,0.83686307402,08,Brunswick,3701908
Brunswick,1196,1142,0.954849498328,6,0.00501672240803,10,0.00836120401338,7,0.00585284280936,23,0.0192307692308,8,0.0066889632107,6,17,17,6,23,0,0.0,6,0.00501672240803,30,0.0250836120401,1166,0.97491638796,1139,0.952341137124,09,Brunswick,3701909
Brunswick,6186,5659,0.914807630133,375,0.060620756547,16,0.00258648561267,21,0.00339476236663,46,0.00743614613644,69,0.0111542192047,405,38,36,403,441,30,0.00484966052376,405,0.0654704170708,107,0.0172971225348,6079,0.982702877465,5615,0.907694794698,10,Brunswick,3701910
Brunswick,3657,2097,0.573420836751,1346,0.368061252393,40,0.0109379272628,7,0.00191413727099,108,0.0295324036095,59,0.0161334427126,1377,66,58,1369,1435,31,0.00847689362866,1377,0.376538146021,202,0.0552365326771,3455,0.944763467323,2035,0.556467049494,11,Brunswick,3701911
Brunswick,3747,3363,0.897518014412,270,0.0720576461169,30,0.0080064051241,6,0.00160128102482,36,0.00960768614892,42,0.0112089671737,290,50,48,288,338,20,0.00533760341607,290,0.077395249533,77,0.0205497731519,3670,0.979450226848,3331,0.888977848946,12,Brunswick,3701912
Brunswick,5323,4373,0.82152921285,572,0.107458200263,64,0.0120232951343,28,0.00526019162127,169,0.0317490137141,117,0.0219800864174,639,99,83,623,722,67,0.0125868870937,639,0.120045087357,370,0.0695096749953,4953,0.930490325005,4209,0.790719519068,13,Brunswick,3701913
Brunswick,5142,4708,0.915597043952,205,0.0398677557371,15,0.00291715285881,50,0.0097238428627,106,0.0206145468689,58,0.0112796577207,233,33,29,229,262,28,0.00544535200311,233,0.0453131077402,237,0.0460910151692,4905,0.953908984831,4593,0.893232205368,14,Brunswick,3701914
Brunswick,6018,5124,0.851445663011,468,0.0777666999003,58,0.00963775340645,37,0.00614822200066,234,0.0388833499501,97,0.0161183117315,498,80,80,498,578,30,0.0049850448654,498,0.0827517447657,458,0.0761050182785,5560,0.923894981722,4950,0.822532402792,15,Brunswick,3701915
Brunswick,4767,4487,0.941262848752,125,0.0262219425215,20,0.00419551080344,17,0.00356618418292,84,0.0176211453744,34,0.00713236836585,133,32,32,133,165,8,0.00167820432138,133,0.0279001468429,208,0.0436333123558,4559,0.956366687644,4380,0.918816865953,16,Brunswick,3701916
Brunswick,5873,4339,0.738804699472,1300,0.2213519496,29,0.00493785118338,15,0.00255406095692,121,0.0206027583858,69,0.0117486804018,1331,66,53,1318,1384,31,0.0052783926443,1331,0.226630342244,237,0.0403541631194,5636,0.959645836881,4246,0.722969521539,17,Brunswick,3701917
Brunswick,3377,2749,0.81403612674,235,0.069588392064,31,0.0091797453361,2,0.000592241634587,307,0.0909090909091,53,0.0156944033166,244,36,36,244,280,9,0.00266508735564,244,0.0722534794196,444,0.131477642878,2933,0.868522357122,2654,0.785904649097,18,Brunswick,3701918
Brunswick,4816,4473,0.928779069767,150,0.031146179402,21,0.00436046511628,25,0.00519102990033,80,0.0166112956811,67,0.0139119601329,175,51,49,173,224,25,0.00519102990033,175,0.0363372093023,237,0.0492109634551,4579,0.950789036545,4351,0.903446843854,19,Brunswick,3701919
Brunswick,4342,3964,0.912943344081,172,0.0396130815292,44,0.0101335789959,10,0.00230308613542,80,0.0184246890834,72,0.016582220175,201,70,69,200,270,29,0.00667894979272,201,0.046292031322,205,0.0472132657761,4137,0.952786734224,3867,0.890603408567,20,Brunswick,3701920
Brunswick,5904,5441,0.921578590786,238,0.0403116531165,22,0.00372628726287,35,0.00592818428184,52,0.00880758807588,116,0.019647696477,289,79,69,279,358,51,0.00863821138211,289,0.0489498644986,156,0.0264227642276,5748,0.973577235772,5340,0.904471544715,21,Brunswick,3701921
Brunswick,2619,2530,0.966017563956,17,0.00649102710958,14,0.0053455517373,8,0.00305460099275,14,0.0053455517373,36,0.0137457044674,21,39,37,19,58,4,0.00152730049637,21,0.00801832760596,45,0.0171821305842,2574,0.982817869416,2495,0.952653684612,22,Brunswick,3701922
Brunswick,2716,2653,0.976804123711,14,0.00515463917526,15,0.00552282768778,5,0.00184094256259,1,0.000368188512518,28,0.0103092783505,23,32,26,17,49,9,0.00331369661267,23,0.00846833578792,19,0.00699558173785,2697,0.993004418262,2641,0.972385861561,23,Brunswick,3701923
Buncombe,2310,1522,0.658874458874,699,0.302597402597,5,0.0021645021645,25,0.0108225108225,12,0.00519480519481,47,0.0203463203463,728,22,8,714,736,29,0.0125541125541,728,0.315151515152,75,0.0324675324675,2235,0.967532467532,1461,0.632467532468,01.1,Buncombe,3702101.1
Buncombe,4100,2788,0.68,1111,0.270975609756,13,0.00317073170732,39,0.00951219512195,30,0.00731707317073,119,0.0290243902439,1180,58,34,1156,1214,69,0.0168292682927,1180,0.287804878049,100,0.0243902439024,4000,0.975609756098,2719,0.663170731707,02.1,Buncombe,3702102.1
Buncombe,2781,2251,0.809421071557,414,0.148867313916,14,0.00503416037397,22,0.0079108234448,14,0.00503416037397,66,0.0237324703344,439,48,41,432,480,25,0.00898957209637,439,0.157856886012,90,0.0323624595469,2691,0.967637540453,2193,0.788565264293,03.1,Buncombe,3702103.1
Buncombe,1566,1473,0.94061302682,51,0.0325670498084,1,0.000638569604087,14,0.00893997445722,7,0.00446998722861,20,0.0127713920817,57,7,7,57,64,6,0.00383141762452,57,0.036398467433,37,0.0236270753512,1529,0.976372924649,1445,0.922733077905,04.1,Buncombe,3702104.1
Buncombe,2748,2631,0.957423580786,23,0.00836972343523,0,0.0,35,0.0127365356623,32,0.0116448326055,27,0.00982532751092,27,11,11,27,38,4,0.00145560407569,27,0.00982532751092,70,0.0254730713246,2678,0.974526928675,2591,0.942867540029,05.1,Buncombe,3702105.1
Buncombe,1665,1505,0.903903903904,94,0.0564564564565,6,0.0036036036036,16,0.00960960960961,25,0.015015015015,19,0.0114114114114,105,9,9,105,114,11,0.00660660660661,105,0.0630630630631,52,0.0312312312312,1613,0.968768768769,1482,0.89009009009,06.1,Buncombe,3702106.1
Buncombe,1933,1607,0.831350232799,244,0.126228660114,6,0.00310398344542,15,0.00775995861355,12,0.00620796689084,49,0.0253491981376,265,21,17,261,282,21,0.010863942059,265,0.137092602173,46,0.0237972064149,1887,0.976202793585,1575,0.814795654423,07.1,Buncombe,3702107.1
Buncombe,4216,3275,0.776802656546,584,0.138519924099,18,0.00426944971537,25,0.00592979127135,168,0.0398481973435,146,0.0346299810247,663,52,46,657,709,79,0.0187381404175,663,0.157258064516,316,0.0749525616698,3900,0.92504743833,3158,0.749051233397,09.1,Buncombe,3702109.1
Buncombe,2989,1384,0.463031114085,1475,0.493476078956,16,0.00535296085647,13,0.00434928069588,20,0.00669120107059,81,0.0270993643359,1541,47,25,1519,1566,66,0.022080963533,1541,0.515557042489,51,0.01706256273,2938,0.98293743727,1355,0.453328872533,10.1,Buncombe,3702110.1
Buncombe,9126,6370,0.698005698006,1811,0.198444006136,38,0.00416392724085,126,0.0138067061144,482,0.0528161297392,299,0.0327635327635,1960,136,111,1935,2071,149,0.0163269778654,1960,0.214770984002,899,0.0985097523559,8227,0.901490247644,6013,0.658886697348,100.1,Buncombe,37021100.1
Buncombe,10497,8602,0.819472230161,749,0.0713537201105,25,0.00238163284748,290,0.0276269410308,595,0.05668286177,236,0.0224826140802,861,73,63,851,924,112,0.0106697151567,861,0.0820234352672,1448,0.137944174526,9049,0.862055825474,7837,0.746594265028,101.1,Buncombe,37021101.1
Buncombe,5975,5381,0.900585774059,320,0.0535564853556,11,0.0018410041841,99,0.0165690376569,50,0.00836820083682,114,0.0190794979079,377,50,40,367,417,57,0.00953974895397,377,0.0630962343096,133,0.0222594142259,5842,0.977740585774,5309,0.888535564854,102.1,Buncombe,37021102.1
Buncombe,4856,4162,0.857084019769,439,0.0904036243822,15,0.00308896210873,58,0.0119439868204,24,0.00494233937397,158,0.0325370675453,538,51,36,523,574,99,0.0203871499176,538,0.1107907743,138,0.0284184514003,4718,0.9715815486,4069,0.837932454695,103.1,Buncombe,37021103.1
Buncombe,3081,2960,0.960727036676,44,0.0142810775722,4,0.00129827977929,22,0.00714053878611,9,0.00292112950341,42,0.0136319376826,56,17,16,55,72,12,0.00389483933788,56,0.0181759169101,60,0.0194741966894,3021,0.980525803311,2915,0.946121389159,104.1,Buncombe,37021104.1
Buncombe,5926,4573,0.771684103949,514,0.0867364157948,49,0.00826864664192,30,0.00506243671954,576,0.0971987850152,184,0.0310496118799,609,89,78,598,687,95,0.0160310496119,609,0.102767465407,1074,0.18123523456,4852,0.81876476544,4159,0.701822477219,105.1,Buncombe,37021105.1
Buncombe,6306,5000,0.792895654932,465,0.0737392959087,24,0.00380589914367,214,0.0339359340311,364,0.057722803679,239,0.0379004123057,581,78,71,574,652,116,0.0183951791944,581,0.0921344751031,776,0.123057405645,5530,0.876942594355,4660,0.738978750396,106.1,Buncombe,37021106.1
Buncombe,7660,7275,0.949738903394,56,0.00731070496084,18,0.0023498694517,26,0.00339425587467,159,0.0207571801567,126,0.0164490861619,109,79,68,98,177,53,0.00691906005222,109,0.0142297650131,318,0.0415143603133,7342,0.958485639687,7125,0.930156657963,107.1,Buncombe,37021107.1
Buncombe,1528,950,0.621727748691,508,0.332460732984,14,0.00916230366492,3,0.00196335078534,11,0.00719895287958,42,0.0274869109948,533,40,27,520,560,25,0.0163612565445,533,0.348821989529,39,0.0255235602094,1489,0.974476439791,926,0.606020942408,11.1,Buncombe,3702111.1
Buncombe,2190,1919,0.876255707763,155,0.0707762557078,8,0.00365296803653,13,0.00593607305936,46,0.02100456621,49,0.0223744292237,172,17,15,170,187,17,0.00776255707763,172,0.0785388127854,158,0.0721461187215,2032,0.927853881279,1820,0.831050228311,12.1,Buncombe,3702112.1
Buncombe,3003,2131,0.709623709624,662,0.220446220446,5,0.001665001665,15,0.004995004995,85,0.028305028305,105,0.034965034965,735,33,24,726,759,73,0.024309024309,735,0.244755244755,195,0.0649350649351,2808,0.935064935065,2043,0.68031968032,13.1,Buncombe,3702113.1
Buncombe,3044,2170,0.712877792378,526,0.172798948752,4,0.00131406044678,19,0.00624178712221,216,0.0709592641261,109,0.0358081471748,590,32,16,574,606,64,0.0210249671485,590,0.1938239159,465,0.152759526938,2579,0.847240473062,1955,0.642247043364,14.2,Buncombe,3702114.2
Buncombe,2287,2123,0.928290336686,68,0.0297332750328,9,0.0039352864014,11,0.0048097944906,30,0.013117621338,46,0.0201136860516,85,22,22,85,107,17,0.0074333187582,85,0.037166593791,81,0.0354175776126,2206,0.964582422387,2068,0.904241364233,15.1,Buncombe,3702115.1
Buncombe,1830,1658,0.906010928962,94,0.0513661202186,2,0.00109289617486,29,0.0158469945355,20,0.0109289617486,27,0.0147540983607,104,9,8,103,112,10,0.00546448087432,104,0.0568306010929,50,0.0273224043716,1780,0.972677595628,1627,0.889071038251,17.1,Buncombe,3702117.1
Buncombe,2159,1603,0.7424733673,279,0.129226493747,7,0.0032422417786,111,0.0514126910607,102,0.0472440944882,57,0.0264011116258,307,25,22,304,329,28,0.0129689671144,307,0.142195460862,168,0.0778138026864,1991,0.922186197314,1552,0.718851320056,19.1,Buncombe,3702119.1
Buncombe,1153,955,0.82827406765,153,0.132697311362,1,0.000867302688638,27,0.0234171725932,4,0.00346921075455,13,0.0112749349523,157,5,5,157,162,4,0.00346921075455,157,0.136166522116,26,0.0225498699046,1127,0.977450130095,938,0.813529921943,20.1,Buncombe,3702120.1
Buncombe,3211,2786,0.867642478979,175,0.0545001557147,18,0.00560573030209,25,0.00778573653068,129,0.0401744004983,78,0.0242914979757,214,36,29,207,243,39,0.0121457489879,214,0.0666459047026,291,0.0906259732171,2920,0.909374026783,2648,0.824665213329,24.1,Buncombe,3702124.1
Buncombe,3028,2579,0.851717305152,217,0.0716644649934,19,0.00627476882431,71,0.0234478203435,58,0.0191545574637,84,0.0277410832232,252,50,48,250,300,35,0.0115587846764,252,0.0832232496697,165,0.0544914134742,2863,0.945508586526,2496,0.824306472919,25.1,Buncombe,3702125.1
Buncombe,2189,1769,0.808131566926,146,0.0666971219735,8,0.00365463682047,51,0.0232983097305,165,0.0753768844221,50,0.0228414801279,163,23,21,161,184,17,0.00776610324349,163,0.074463225217,285,0.130196436729,1904,0.869803563271,1676,0.765646413888,26.1,Buncombe,3702126.1
Buncombe,3003,2730,0.909090909091,133,0.044289044289,11,0.003663003663,40,0.01332001332,34,0.011322011322,55,0.018315018315,155,27,23,151,178,22,0.00732600732601,155,0.0516150516151,105,0.034965034965,2898,0.965034965035,2662,0.886446886447,28.1,Buncombe,3702128.1
Buncombe,5301,4801,0.905678173929,146,0.0275419732126,25,0.00471609130353,138,0.0260328239955,98,0.0184870779098,93,0.0175438596491,186,50,44,180,230,40,0.00754574608564,186,0.0350877192982,269,0.050745142426,5032,0.949254857574,4639,0.875117902283,30.1,Buncombe,3702130.1
Buncombe,1345,1323,0.983643122677,5,0.00371747211896,0,0.0,4,0.00297397769517,2,0.00148698884758,11,0.00817843866171,12,4,4,12,16,7,0.00520446096654,12,0.0089219330855,13,0.00966542750929,1332,0.990334572491,1310,0.973977695167,31.1,Buncombe,3702131.1
Buncombe,2868,2577,0.898535564854,138,0.0481171548117,12,0.00418410041841,14,0.00488145048815,54,0.0188284518828,73,0.0254532775453,168,48,43,163,211,30,0.010460251046,168,0.0585774058577,223,0.0777545327755,2645,0.922245467225,2427,0.846234309623,32.1,Buncombe,3702132.1
Buncombe,1569,1478,0.942001274697,48,0.0305927342256,2,0.0012746972594,12,0.00764818355641,2,0.0012746972594,27,0.0172084130019,63,12,11,62,74,15,0.00956022944551,63,0.0401529636711,21,0.0133843212237,1548,0.986615678776,1463,0.932441045252,33.2,Buncombe,3702133.2
Buncombe,2564,2292,0.89391575663,152,0.0592823712949,10,0.00390015600624,13,0.00507020280811,24,0.00936037441498,73,0.0284711388456,169,49,47,167,216,17,0.00663026521061,169,0.0659126365055,85,0.033151326053,2479,0.966848673947,2245,0.875585023401,33.3,Buncombe,3702133.3
Buncombe,1330,1268,0.953383458647,32,0.0240601503759,0,0.0,5,0.00375939849624,7,0.00526315789474,18,0.0135338345865,40,7,6,39,46,8,0.00601503759398,40,0.0300751879699,16,0.012030075188,1314,0.987969924812,1259,0.946616541353,34.1,Buncombe,3702134.1
Buncombe,2386,2027,0.849538977368,238,0.0997485331098,8,0.00335289186924,21,0.00880134115675,29,0.012154233026,63,0.0264040234702,274,35,29,268,303,36,0.0150880134116,274,0.114836546521,71,0.0297569153395,2315,0.970243084661,1998,0.837384744342,35.1,Buncombe,3702135.1
Buncombe,2660,2495,0.937969924812,77,0.0289473684211,6,0.00225563909774,14,0.00526315789474,35,0.0131578947368,33,0.0124060150376,85,22,21,84,106,8,0.00300751879699,85,0.031954887218,68,0.0255639097744,2592,0.974436090226,2464,0.926315789474,36.1,Buncombe,3702136.1
Buncombe,1763,1714,0.972206466251,4,0.0022688598979,8,0.0045377197958,9,0.00510493477028,2,0.00113442994895,26,0.0147475893364,10,18,18,10,28,6,0.00340328984685,10,0.00567214974475,28,0.0158820192853,1735,0.984117980715,1692,0.959727736812,37.1,Buncombe,3702137.1
Buncombe,2130,2043,0.959154929577,7,0.00328638497653,6,0.00281690140845,11,0.00516431924883,25,0.0117370892019,38,0.0178403755869,23,13,13,23,36,16,0.0075117370892,23,0.0107981220657,47,0.0220657276995,2083,0.9779342723,2018,0.947417840376,38.2,Buncombe,3702138.2
Buncombe,4082,3774,0.924546790789,149,0.0365017148457,26,0.00636942675159,28,0.00685938265556,42,0.0102890739833,63,0.015433610975,172,54,49,167,221,23,0.00563449289564,172,0.0421362077413,127,0.031112199902,3955,0.968887800098,3698,0.905928466438,38.3,Buncombe,3702138.3
Buncombe,4899,4713,0.962033067973,37,0.0075525617473,22,0.00449071239028,17,0.00347009593795,41,0.00836905490917,69,0.0140845070423,57,56,54,55,111,20,0.00408246580935,57,0.0116350275566,126,0.0257195345989,4773,0.974280465401,4634,0.945907328026,39.1,Buncombe,3702139.1
Buncombe,4388,4096,0.933454876937,31,0.00706472196901,16,0.00364630811304,15,0.00341841385597,158,0.0360072926162,72,0.0164083865087,73,39,36,70,109,42,0.00957155879672,73,0.0166362807657,489,0.111440291705,3899,0.888559708295,3809,0.86804922516,41.1,Buncombe,3702141.1
Buncombe,5260,4849,0.921863117871,103,0.0195817490494,21,0.00399239543726,90,0.0171102661597,116,0.0220532319392,81,0.0153992395437,127,47,43,123,170,24,0.00456273764259,127,0.024144486692,252,0.0479087452471,5008,0.952091254753,4735,0.900190114068,44.1,Buncombe,3702144.1
Buncombe,5772,5202,0.901247401247,117,0.0202702702703,25,0.00433125433125,40,0.00693000693001,265,0.0459112959113,123,0.0213097713098,175,64,57,168,232,58,0.0100485100485,175,0.0303187803188,501,0.0867983367983,5271,0.913201663202,5004,0.866943866944,45.1,Buncombe,3702145.1
Buncombe,1673,1570,0.938433950986,11,0.00657501494322,12,0.00717274357442,21,0.0125523012552,41,0.0245068738793,18,0.0107591153616,17,20,19,16,36,6,0.00358637178721,17,0.0101613867304,80,0.0478182904961,1593,0.952181709504,1535,0.917513448894,46.1,Buncombe,3702146.1
Buncombe,5810,5527,0.951290877797,45,0.00774526678141,19,0.00327022375215,20,0.00344234079174,105,0.0180722891566,94,0.0161790017212,72,71,63,64,135,27,0.00464716006885,72,0.0123924268503,230,0.039586919105,5580,0.960413080895,5415,0.932013769363,47.1,Buncombe,3702147.1
Buncombe,5273,4712,0.893608951261,128,0.0242746064859,32,0.00606865162147,32,0.00606865162147,280,0.0531007016878,89,0.0168784373222,168,69,59,158,227,40,0.00758581452683,168,0.0318604210127,453,0.0859093495164,4820,0.914090650484,4576,0.86781718187,48.1,Buncombe,3702148.1
Buncombe,5705,5464,0.957756354075,58,0.010166520596,32,0.00560911481157,25,0.00438212094654,54,0.00946538124452,72,0.012620508326,91,55,53,89,144,33,0.00578439964943,91,0.0159509202454,176,0.0308501314636,5529,0.969149868536,5359,0.9393514461,49.1,Buncombe,3702149.1
Buncombe,2017,1965,0.974219137333,1,0.000495785820526,3,0.00148735746158,4,0.0019831432821,14,0.00694100148736,30,0.0148735746158,7,17,17,7,24,6,0.00297471492315,7,0.00347050074368,21,0.010411502231,1996,0.989588497769,1959,0.97124442241,50.1,Buncombe,3702150.1
Buncombe,5279,4983,0.943928774389,47,0.00890320136389,32,0.0060617541201,61,0.0115552187914,73,0.0138283765865,83,0.015722674749,73,77,69,65,142,26,0.00492517522258,73,0.0138283765865,207,0.0392119719644,5072,0.960788028036,4862,0.921007766622,52.1,Buncombe,3702152.1
Buncombe,4056,3875,0.955374753452,51,0.012573964497,20,0.00493096646943,8,0.00197238658777,56,0.0138067061144,46,0.0113412228797,60,46,46,60,106,9,0.00221893491124,60,0.0147928994083,132,0.0325443786982,3924,0.967455621302,3808,0.938856015779,53.1,Buncombe,3702153.1
Buncombe,3875,3544,0.914580645161,140,0.0361290322581,9,0.00232258064516,77,0.0198709677419,38,0.0098064516129,67,0.0172903225806,166,23,22,165,188,26,0.00670967741935,166,0.0428387096774,78,0.0201290322581,3797,0.979870967742,3502,0.903741935484,55.1,Buncombe,3702155.1
Buncombe,3534,3277,0.9272778721,94,0.0265987549519,19,0.00537634408602,82,0.0232031692134,29,0.00820599886814,33,0.00933786078098,101,26,26,101,127,7,0.00198075834748,101,0.0285795132994,98,0.0277306168647,3436,0.972269383135,3209,0.908036219581,57.1,Buncombe,3702157.1
Buncombe,2364,2240,0.947546531303,28,0.0118443316413,8,0.00338409475465,25,0.0105752961083,40,0.0169204737733,23,0.00972927241963,32,24,24,32,56,4,0.00169204737733,32,0.0135363790186,128,0.0541455160745,2236,0.945854483926,2155,0.911590524535,58.1,Buncombe,3702158.1
Buncombe,4208,4021,0.955560836502,45,0.0106939163498,20,0.00475285171103,29,0.00689163498099,11,0.00261406844106,82,0.0194866920152,60,71,67,56,127,15,0.00356463878327,60,0.0142585551331,68,0.0161596958175,4140,0.983840304183,3971,0.943678707224,59.1,Buncombe,3702159.1
Buncombe,1300,1140,0.876923076923,25,0.0192307692308,4,0.00307692307692,22,0.0169230769231,81,0.0623076923077,28,0.0215384615385,34,14,14,34,48,9,0.00692307692308,34,0.0261538461538,161,0.123846153846,1139,0.876153846154,1075,0.826923076923,60.2,Buncombe,3702160.2
Buncombe,2892,2768,0.957123098202,37,0.0127939142462,2,0.000691562932227,33,0.0114107883817,8,0.00276625172891,44,0.015214384509,56,15,15,56,71,19,0.00656984785615,56,0.0193637621024,36,0.0124481327801,2856,0.98755186722,2746,0.949515905947,61.1,Buncombe,3702161.1
Buncombe,3674,3341,0.909363091998,120,0.0326619488296,12,0.00326619488296,27,0.00734893848666,86,0.0234077299946,88,0.0239520958084,158,36,34,156,192,38,0.0103429504627,158,0.0430048992923,187,0.0508982035928,3487,0.949101796407,3250,0.884594447469,62.1,Buncombe,3702162.1
Buncombe,790,767,0.970886075949,6,0.00759493670886,6,0.00759493670886,3,0.00379746835443,3,0.00379746835443,5,0.00632911392405,7,7,7,7,14,1,0.00126582278481,7,0.00886075949367,25,0.0316455696203,765,0.96835443038,745,0.943037974684,63.1,Buncombe,3702163.1
Buncombe,2671,2443,0.914638712093,108,0.0404342942718,22,0.00823661549981,18,0.0067390490453,39,0.0146012729315,41,0.0153500561587,119,48,43,114,162,11,0.00411830774991,119,0.0445526020217,69,0.0258330213403,2602,0.97416697866,2419,0.905653313366,64.1,Buncombe,3702164.1
Buncombe,4179,3864,0.924623115578,103,0.0246470447475,21,0.00502512562814,52,0.0124431682221,47,0.0112467097392,92,0.0220148360852,143,49,42,136,185,40,0.00957166786313,143,0.0342187126107,196,0.0469011725293,3983,0.953098827471,3737,0.894233070112,65.1,Buncombe,3702165.1
Buncombe,2558,2280,0.891321344801,84,0.0328381548084,24,0.00938232994527,41,0.0160281469898,75,0.029319781079,54,0.0211102423769,115,40,37,112,152,31,0.012118842846,115,0.0449569976544,222,0.0867865519937,2336,0.913213448006,2146,0.838936669273,66.1,Buncombe,3702166.1
Buncombe,2663,2546,0.95606458881,23,0.00863687570409,0,0.0,7,0.00262861434472,14,0.00525722868945,73,0.0274126924521,45,55,39,29,84,22,0.00826135936913,45,0.0168982350732,51,0.019151333083,2612,0.980848666917,2516,0.944799098761,67.1,Buncombe,3702167.1
Buncombe,6332,5683,0.89750473784,136,0.0214782059381,43,0.00679090334807,50,0.00789639924195,303,0.0478521794062,117,0.0184775742262,170,84,82,168,252,34,0.00536955148452,170,0.0268477574226,583,0.0920720151611,5749,0.907927984839,5430,0.857548957675,68.1,Buncombe,3702168.1
Buncombe,4104,3728,0.908382066277,110,0.0268031189084,19,0.00462962962963,35,0.00852826510721,106,0.025828460039,106,0.025828460039,174,41,32,165,206,64,0.0155945419103,174,0.0423976608187,234,0.0570175438596,3870,0.94298245614,3619,0.881822612086,69.1,Buncombe,3702169.1
Buncombe,3508,3065,0.873717217788,109,0.0310718358039,20,0.00570125427594,52,0.0148232611174,166,0.0473204104903,96,0.0273660205245,156,42,37,151,193,47,0.0133979475485,156,0.0444697833523,381,0.108608893957,3127,0.891391106043,2881,0.821265678449,70.1,Buncombe,3702170.1
Buncombe,5176,4605,0.889683153014,209,0.0403786707883,13,0.00251159196291,67,0.0129443585781,218,0.0421174652241,64,0.0123647604328,224,32,31,223,255,15,0.00289799072643,224,0.0432766615147,391,0.0755409582689,4785,0.924459041731,4454,0.860510046368,71.1,Buncombe,3702171.1
Burke,4856,4169,0.85852553542,249,0.0512767710049,14,0.00288303130148,242,0.0498352553542,110,0.0226523887974,72,0.0148270181219,289,27,23,285,312,40,0.00823723228995,289,0.0595140032949,180,0.0370675453048,4676,0.962932454695,4122,0.848846787479,0001,Burke,370230001
Burke,1738,1567,0.901611047181,17,0.00978135788262,8,0.00460299194476,93,0.0535097813579,26,0.0149597238205,27,0.0155350978136,26,20,20,26,46,9,0.00517836593786,26,0.0149597238205,43,0.0247410817031,1695,0.975258918297,1559,0.897008055236,0003,Burke,370230003
Burke,4573,4147,0.906844522195,45,0.00984036737372,10,0.00218674830527,252,0.0551060572928,53,0.0115897660179,66,0.0144325388148,72,35,34,71,106,27,0.00590422042423,72,0.0157445877979,113,0.0247102558496,4460,0.97528974415,4097,0.895910780669,0011,Burke,370230011
Burke,2636,2552,0.96813353566,10,0.00379362670713,3,0.00113808801214,42,0.01593323217,8,0.00303490136571,21,0.00796661608498,14,16,16,14,30,4,0.00151745068285,14,0.00531107738998,17,0.00644916540212,2619,0.993550834598,2543,0.964719271624,0012,Burke,370230012
Burke,4510,4141,0.918181818182,59,0.0130820399113,9,0.0019955654102,181,0.040133037694,62,0.0137472283814,58,0.0128603104213,84,24,24,84,108,25,0.00554323725055,84,0.0186252771619,115,0.0254988913525,4395,0.974501108647,4096,0.908203991131,0013,Burke,370230013
Burke,3469,3201,0.922744306717,11,0.00317094263477,6,0.00172960507351,140,0.0403574517152,76,0.0219083309311,35,0.0100893629288,21,16,15,20,36,10,0.00288267512251,21,0.00605361775728,106,0.0305563562986,3363,0.969443643701,3171,0.914096281349,0014,Burke,370230014
Burke,2440,2138,0.876229508197,37,0.0151639344262,14,0.00573770491803,143,0.058606557377,74,0.0303278688525,34,0.0139344262295,53,30,25,48,78,16,0.00655737704918,53,0.0217213114754,110,0.0450819672131,2330,0.954918032787,2104,0.862295081967,0015,Burke,370230015
Burke,678,663,0.977876106195,1,0.00147492625369,0,0.0,3,0.00442477876106,2,0.00294985250737,9,0.0132743362832,1,8,8,1,9,0,0.0,1,0.00147492625369,11,0.0162241887906,667,0.983775811209,654,0.964601769912,0018,Burke,370230018
Burke,714,646,0.904761904762,60,0.0840336134454,1,0.00140056022409,1,0.00140056022409,1,0.00140056022409,5,0.00700280112045,64,4,2,62,66,4,0.00560224089636,64,0.0896358543417,5,0.00700280112045,709,0.99299719888,642,0.899159663866,0019,Burke,370230019
Burke,1047,862,0.823304680038,165,0.157593123209,6,0.00573065902579,9,0.00859598853868,0,0.0,5,0.00477554918816,168,6,6,168,174,3,0.00286532951289,168,0.160458452722,4,0.00382043935053,1043,0.996179560649,859,0.820439350525,0020,Burke,370230020
Burke,2112,1993,0.94365530303,25,0.0118371212121,3,0.00142045454545,46,0.0217803030303,17,0.00804924242424,28,0.0132575757576,36,13,13,36,49,11,0.00520833333333,36,0.0170454545455,40,0.0189393939394,2072,0.981060606061,1970,0.932765151515,0021,Burke,370230021
Burke,2887,2651,0.918254243159,44,0.0152407343263,3,0.00103914097679,141,0.0488396259092,29,0.0100450294423,19,0.00658122618635,48,4,4,48,52,4,0.00138552130239,48,0.0166262556287,44,0.0152407343263,2843,0.984759265674,2643,0.915483200554,0022,Burke,370230022
Burke,3547,3341,0.941922751621,42,0.0118409923879,3,0.000845785170567,89,0.0250916267268,31,0.00873978009586,41,0.0115590639977,59,19,17,57,76,17,0.00479278263321,59,0.0166337750211,88,0.0248096983366,3459,0.975190301663,3295,0.928954045672,0024,Burke,370230024
Burke,3667,3362,0.916825743114,78,0.0212707935642,8,0.00218161985274,149,0.0406326697573,9,0.00245432233433,61,0.0166348513771,89,54,53,88,142,11,0.00299972729752,89,0.0242705208617,44,0.0119989091901,3623,0.98800109081,3335,0.909462776111,0029,Burke,370230029
Burke,3614,2063,0.570835639181,614,0.169894853348,19,0.00525733259546,160,0.0442722744881,629,0.174045379081,129,0.035694521306,659,49,39,649,698,45,0.0124515771998,659,0.182346430548,950,0.262866629773,2664,0.737133370227,1861,0.51494189264,0031,Burke,370230031
Burke,3041,2315,0.761262742519,254,0.0835251561986,65,0.0213745478461,62,0.0203880302532,255,0.0838539953963,90,0.0295955277869,292,85,78,285,370,38,0.01249588951,292,0.0960210457086,483,0.158829332456,2558,0.841170667544,2203,0.724432752384,0034,Burke,370230034
Burke,2509,1580,0.629732961339,370,0.1474691112,20,0.00797130330809,35,0.0139497807892,445,0.177361498605,59,0.0235153447589,396,31,27,392,423,26,0.0103626943005,396,0.1578318055,606,0.241530490235,1903,0.758469509765,1482,0.59067357513,0035,Burke,370230035
Burke,2851,2586,0.907050157839,47,0.016485443704,5,0.0017537706068,91,0.0319186250438,67,0.0235005261312,55,0.0192914766749,56,33,33,56,89,9,0.00315678709225,56,0.0196422307962,98,0.0343739038934,2753,0.965626096107,2559,0.897579796563,0036,Burke,370230036
Burke,3456,2731,0.790219907407,219,0.0633680555556,18,0.00520833333333,214,0.0619212962963,225,0.0651041666667,49,0.0141782407407,242,30,29,241,271,23,0.00665509259259,242,0.0700231481481,354,0.102430555556,3102,0.897569444444,2641,0.764178240741,0038,Burke,370230038
Burke,3134,2370,0.756222080408,415,0.132418634333,10,0.00319081046586,157,0.050095724314,82,0.02616464582,100,0.0319081046586,463,32,25,456,488,48,0.0153158902361,463,0.147734524569,205,0.0654116145501,2929,0.93458838545,2304,0.735162731334,0039,Burke,370230039
Burke,2630,2239,0.851330798479,156,0.0593155893536,14,0.00532319391635,102,0.038783269962,64,0.0243346007605,55,0.0209125475285,176,25,24,175,200,20,0.00760456273764,176,0.0669201520913,151,0.0574144486692,2479,0.942585551331,2191,0.833079847909,0040,Burke,370230040
Burke,4725,3701,0.78328042328,757,0.160211640212,16,0.00338624338624,68,0.0143915343915,40,0.00846560846561,143,0.0302645502646,863,55,32,840,895,106,0.0224338624339,863,0.182645502646,77,0.0162962962963,4648,0.983703703704,3663,0.775238095238,0047,Burke,370230047
Burke,2614,2278,0.871461361897,197,0.075363427697,4,0.00153022188217,55,0.0210405508799,29,0.0110941086458,51,0.0195103289977,236,5,5,236,241,39,0.0149196633512,236,0.0902830910482,82,0.0313695485845,2532,0.968630451415,2237,0.855776587605,0048,Burke,370230048
Burke,4833,3968,0.821022139458,392,0.0811090420029,10,0.00206910821436,325,0.0672460169667,48,0.00993171942893,90,0.0186219739292,451,33,21,439,472,59,0.0122077384647,451,0.0933167804676,121,0.0250362093938,4712,0.974963790606,3916,0.810262776743,0051,Burke,370230051
Burke,2259,1731,0.766268260292,174,0.0770252324037,9,0.00398406374502,297,0.131474103586,20,0.00885347498893,28,0.0123948649845,193,18,13,188,206,19,0.00841080123949,193,0.0854360336432,43,0.0190349712262,2216,0.980965028774,1715,0.759185480301,0052,Burke,370230052
Burke,3701,3398,0.918130235072,27,0.00729532558768,9,0.00243177519589,169,0.045663334234,46,0.0124290732235,52,0.0140502566874,45,34,34,45,79,18,0.00486355039179,45,0.0121588759795,78,0.0210753850311,3623,0.978924614969,3379,0.912996487436,0053,Burke,370230053
Burke,1180,1104,0.935593220339,32,0.0271186440678,1,0.000847457627119,9,0.00762711864407,10,0.00847457627119,24,0.0203389830508,42,13,9,38,51,10,0.00847457627119,42,0.035593220339,17,0.014406779661,1163,0.985593220339,1099,0.931355932203,0062,Burke,370230062
Burke,1066,1017,0.954033771107,11,0.0103189493433,5,0.0046904315197,9,0.00844277673546,5,0.0046904315197,19,0.0178236397749,16,11,11,16,27,5,0.0046904315197,16,0.015009380863,6,0.00562851782364,1060,0.994371482176,1016,0.953095684803,0064,Burke,370230064
Burke,3303,2046,0.619436875568,1082,0.327580986982,5,0.00151377535574,62,0.0187708144111,74,0.0224038752649,34,0.010293672419,1100,19,17,1098,1117,18,0.00544959128065,1100,0.333030578262,95,0.028761731759,3208,0.971238268241,2030,0.614592794429,0065,Burke,370230065
Burke,3602,2877,0.798722931705,383,0.106329816768,20,0.00555247084953,116,0.0322043309273,135,0.0374791782343,71,0.0197112715158,410,44,43,409,453,27,0.00749583564686,410,0.113825652415,206,0.0571904497501,3396,0.94280955025,2839,0.788173237091,0066,Burke,370230066
Burke,3520,3279,0.931534090909,39,0.0110795454545,7,0.00198863636364,26,0.00738636363636,102,0.0289772727273,67,0.0190340909091,65,36,33,62,98,26,0.00738636363636,65,0.0184659090909,142,0.0403409090909,3378,0.959659090909,3247,0.922443181818,0070,Burke,370230070
Cabarrus,3038,2754,0.906517445688,151,0.0497037524687,12,0.00394996708361,22,0.00724160631995,38,0.0125082290981,61,0.0200789993417,185,21,20,184,205,34,0.0111915734036,185,0.0608953258723,148,0.0487162606978,2890,0.951283739302,2662,0.876234364714,01-02,Cabarrus,3702501-02
Cabarrus,5062,3726,0.736072698538,998,0.197155274595,14,0.00276570525484,206,0.0406953773212,35,0.0069142631371,83,0.0163966811537,1021,41,36,1016,1057,23,0.00454365863295,1021,0.201698933228,133,0.026274199921,4929,0.973725800079,3641,0.719280916634,01-04,Cabarrus,3702501-04
Cabarrus,3569,2702,0.757074810871,558,0.156346315495,21,0.00588400112076,193,0.0540767722051,17,0.00476323900252,78,0.0218548613057,612,33,23,602,635,54,0.0151302885962,612,0.171476604091,111,0.0311011487812,3458,0.968898851219,2637,0.73886242645,01-06,Cabarrus,3702501-06
Cabarrus,3120,2650,0.849358974359,322,0.103205128205,8,0.0025641025641,103,0.0330128205128,11,0.00352564102564,26,0.00833333333333,337,21,15,331,352,15,0.00480769230769,337,0.108012820513,73,0.0233974358974,3047,0.976602564103,2601,0.833653846154,01-07,Cabarrus,3702501-07
Cabarrus,4558,3480,0.763492759982,773,0.169591926283,20,0.00438788942519,62,0.0136024572181,102,0.0223782360685,121,0.0265467310224,851,45,32,838,883,78,0.0171127687582,851,0.186704695042,299,0.0655989469065,4259,0.934401053093,3323,0.729047827995,01-08,Cabarrus,3702501-08
Cabarrus,1231,1171,0.951259138911,22,0.0178716490658,9,0.00731112916328,11,0.0089358245329,11,0.0089358245329,7,0.00568643379366,26,11,11,26,37,4,0.00324939073924,26,0.021121039805,26,0.021121039805,1205,0.978878960195,1157,0.939886271324,01-09,Cabarrus,3702501-09
Cabarrus,3883,3142,0.809168168942,441,0.113571980428,20,0.00515065670873,127,0.0327066701004,56,0.0144218387844,97,0.0249806850373,490,44,40,486,530,49,0.0126191089364,490,0.126191089364,186,0.0479011073912,3697,0.952098892609,3014,0.776203966006,01-10,Cabarrus,3702501-10
Cabarrus,4317,3358,0.777854991893,596,0.138058837155,12,0.00277970813065,86,0.019921241603,156,0.0361362056984,109,0.02524901552,660,50,33,643,693,64,0.0148251100301,660,0.152883947186,364,0.0843178132963,3953,0.915682186704,3195,0.740097289785,02-01,Cabarrus,3702502-01
Cabarrus,6342,4658,0.734468621886,819,0.129139072848,43,0.00678019552192,175,0.0275938189845,522,0.0823084200568,125,0.0197098707032,884,72,58,870,942,65,0.0102491327657,884,0.139388205613,1044,0.164616840114,5298,0.835383159886,4194,0.661305581835,02-02,Cabarrus,3702502-02
Cabarrus,7619,6111,0.802073762961,980,0.128625803911,21,0.00275626722667,196,0.0257251607823,162,0.0212626328915,149,0.0195563722273,1042,60,50,1032,1092,62,0.00813755085969,1042,0.136763354771,515,0.0675941724636,7104,0.932405827536,5815,0.763223520147,02-03,Cabarrus,3702502-03
Cabarrus,5106,4070,0.797101449275,528,0.103407755582,5,0.000979240109675,157,0.0307481394438,252,0.0493537015276,94,0.0184097140619,558,30,27,555,585,30,0.00587544065805,558,0.10928319624,458,0.0896983940462,4648,0.910301605954,3881,0.76008617313,02-05,Cabarrus,3702502-05
Cabarrus,5262,3529,0.67065754466,1066,0.202584568605,30,0.00570125427594,106,0.020144431775,375,0.0712656784493,156,0.0296465222349,1161,52,45,1154,1206,95,0.0180539718738,1161,0.220638540479,661,0.12561763588,4601,0.87438236412,3299,0.626947928544,02-06,Cabarrus,3702502-06
Cabarrus,3448,3089,0.895881670534,184,0.0533642691415,7,0.00203016241299,105,0.0304524361949,30,0.00870069605568,33,0.00957076566125,191,21,17,187,208,7,0.00203016241299,191,0.0553944315545,103,0.0298723897912,3345,0.970127610209,3021,0.876160092807,02-07,Cabarrus,3702502-07
Cabarrus,7704,5763,0.748052959502,1233,0.160046728972,20,0.00259605399792,398,0.0516614745587,118,0.0153167185877,172,0.0223260643821,1329,49,35,1315,1364,96,0.01246105919,1329,0.172507788162,469,0.0608774662513,7235,0.939122533749,5465,0.709371754933,02-08,Cabarrus,3702502-08
Cabarrus,6954,4724,0.679321253955,1303,0.187374173138,9,0.00129421915444,667,0.0959160195571,76,0.0109289617486,175,0.0251653724475,1391,44,25,1372,1416,88,0.0126545872879,1391,0.200028760426,418,0.0601092896175,6536,0.939890710383,4412,0.634454989934,02-09,Cabarrus,3702502-09
Cabarrus,4687,4066,0.867505867293,397,0.0847023682526,11,0.00234691700448,71,0.0151482824835,61,0.0130147215703,81,0.0172818433966,422,39,38,421,460,25,0.00533390228291,422,0.0900362705355,162,0.0345636867933,4525,0.965436313207,3986,0.850437379987,03-00,Cabarrus,3702503-00
Cabarrus,4339,2734,0.630099101175,1227,0.282784051625,10,0.00230467849735,34,0.00783590689099,210,0.0483982484443,124,0.0285780133671,1302,32,24,1294,1326,75,0.0172850887301,1302,0.300069140355,406,0.0935699469924,3933,0.906430053008,2583,0.595298455865,04-01,Cabarrus,3702504-01
Cabarrus,4154,2331,0.561145883486,1265,0.304525758305,18,0.00433317284545,68,0.0163697640828,322,0.0775156475686,150,0.0361097737121,1366,43,35,1358,1401,101,0.0243139142995,1366,0.328839672605,584,0.140587385652,3570,0.859412614348,2143,0.515888300433,04-02,Cabarrus,3702504-02
Cabarrus,3800,2510,0.660526315789,965,0.253947368421,12,0.00315789473684,20,0.00526315789474,233,0.0613157894737,60,0.0157894736842,1003,32,24,995,1027,38,0.01,1003,0.263947368421,315,0.0828947368421,3485,0.917105263158,2445,0.643421052632,04-03,Cabarrus,3702504-03
Cabarrus,2026,1226,0.605133267522,687,0.339091806515,1,0.000493583415597,5,0.00246791707799,82,0.040473840079,25,0.0123395853899,702,8,7,701,709,15,0.00740375123396,702,0.346495557749,131,0.0646594274432,1895,0.935340572557,1177,0.580947680158,04-04,Cabarrus,3702504-04
Cabarrus,2920,2064,0.706849315068,537,0.183904109589,11,0.00376712328767,22,0.00753424657534,223,0.0763698630137,63,0.0215753424658,561,32,29,558,590,24,0.00821917808219,561,0.192123287671,428,0.146575342466,2492,0.853424657534,1890,0.647260273973,04-05,Cabarrus,3702504-05
Cabarrus,3631,2015,0.554943541724,953,0.262462131644,18,0.00495731203525,59,0.0162489672267,458,0.126136050675,128,0.0352519966951,1027,40,35,1022,1062,74,0.0203800605894,1027,0.282842192234,653,0.17984026439,2978,0.82015973561,1887,0.519691545029,04-06,Cabarrus,3702504-06
Cabarrus,2596,2037,0.784668721109,165,0.0635593220339,1,0.000385208012327,21,0.00808936825886,314,0.120955315871,58,0.0223420647149,198,6,5,197,203,33,0.0127118644068,198,0.0762711864407,443,0.170647149461,2153,0.829352850539,1923,0.740755007704,04-07,Cabarrus,3702504-07
Cabarrus,1864,1588,0.851931330472,170,0.0912017167382,9,0.00482832618026,14,0.00751072961373,48,0.0257510729614,35,0.0187768240343,183,21,19,181,202,13,0.00697424892704,183,0.0981759656652,114,0.0611587982833,1750,0.938841201717,1537,0.824570815451,04-08,Cabarrus,3702504-08
Cabarrus,2987,2426,0.81218613994,411,0.137596250418,12,0.00401740877134,47,0.0157348510211,47,0.0157348510211,44,0.0147304988283,442,25,21,438,463,31,0.0103783059926,442,0.147974556411,106,0.0354871108135,2881,0.964512889186,2376,0.795446936726,04-09,Cabarrus,3702504-09
Cabarrus,4942,3975,0.804330230676,690,0.139619587212,16,0.00323755564549,72,0.0145690004047,111,0.0224605422906,78,0.0157830837718,729,32,32,729,761,39,0.00789154188588,729,0.147511129098,316,0.0639417239984,4626,0.936058276002,3792,0.767300687981,04-10,Cabarrus,3702504-10
Cabarrus,3799,3395,0.893656225322,230,0.06054224796,14,0.00368518031061,35,0.00921295077652,58,0.0152671755725,67,0.0176362200579,260,45,38,253,298,30,0.0078968149513,260,0.0684390629113,130,0.0342195314556,3669,0.965780468544,3335,0.87786259542,05-00,Cabarrus,3702505-00
Cabarrus,2636,2501,0.948786039454,25,0.00948406676783,9,0.00341426403642,20,0.00758725341426,60,0.0227617602428,21,0.00796661608498,37,15,15,37,52,12,0.00455235204856,37,0.0140364188164,85,0.0322458270106,2551,0.967754172989,2479,0.940440060698,06-00,Cabarrus,3702506-00
Cabarrus,1431,1391,0.972047519217,8,0.00559049615653,16,0.0111809923131,4,0.00279524807827,2,0.00139762403913,10,0.00698812019567,8,22,22,8,30,0,0.0,8,0.00559049615653,19,0.0132774283718,1412,0.986722571628,1378,0.962962962963,07-00,Cabarrus,3702507-00
Cabarrus,5607,5190,0.925628678438,293,0.0522561084359,10,0.00178348492955,21,0.00374531835206,48,0.00856072766185,45,0.00802568218299,309,28,27,308,336,16,0.00285357588728,309,0.0551096843232,91,0.0162297128589,5516,0.983770287141,5156,0.919564829677,08-00,Cabarrus,3702508-00
Cabarrus,3458,3268,0.945054945055,82,0.0237131289763,14,0.00404858299595,17,0.00491613649508,44,0.0127241179873,33,0.00954308849046,91,31,28,88,119,9,0.0026026604974,91,0.0263157894737,120,0.0347021399653,3338,0.965297860035,3198,0.924812030075,09-00,Cabarrus,3702509-00
Cabarrus,6241,5697,0.912834481654,300,0.0480692196763,39,0.00624899855792,46,0.0073706136837,61,0.00977407466752,98,0.0157026117609,337,73,66,330,403,37,0.00592853709341,337,0.0539977567697,184,0.0294824547348,6057,0.970517545265,5600,0.897292100625,10-00,Cabarrus,3702510-00
Cabarrus,7960,5333,0.669974874372,1405,0.176507537688,54,0.00678391959799,52,0.00653266331658,844,0.106030150754,272,0.0341708542714,1541,119,102,1524,1643,136,0.0170854271357,1541,0.193592964824,1664,0.209045226131,6296,0.790954773869,4680,0.587939698492,11-01,Cabarrus,3702511-01
Cabarrus,4158,3729,0.896825396825,212,0.0509860509861,11,0.0026455026455,26,0.00625300625301,95,0.0228475228475,85,0.0204425204425,271,32,24,263,295,59,0.0141895141895,271,0.0651755651756,203,0.0488215488215,3955,0.951178451178,3651,0.878066378066,11-02,Cabarrus,3702511-02
Cabarrus,991,610,0.615539858729,198,0.199798183653,1,0.00100908173562,1,0.00100908173562,170,0.171543895055,11,0.0110998990918,203,2,2,203,205,5,0.0050454086781,203,0.204843592331,257,0.259334006054,734,0.740665993946,546,0.550958627649,12-01,Cabarrus,3702512-01
Cabarrus,4030,1811,0.449379652605,1180,0.292803970223,31,0.00769230769231,23,0.00570719602978,874,0.216873449132,111,0.0275434243176,1232,51,45,1226,1277,52,0.0129032258065,1232,0.30570719603,1244,0.308684863524,2786,0.691315136476,1519,0.376923076923,12-02,Cabarrus,3702512-02
Cabarrus,2887,2143,0.742293037755,454,0.157256667821,9,0.00311742293038,102,0.0353307932109,137,0.0474541046069,42,0.0145479736751,473,17,15,471,488,19,0.00658122618635,473,0.163837894008,259,0.0897125043298,2628,0.91028749567,2035,0.704883962591,12-03,Cabarrus,3702512-03
Cabarrus,4666,2935,0.629018431204,966,0.207029575654,8,0.00171453064724,39,0.00835833690527,613,0.131375910844,105,0.022503214745,1037,37,22,1022,1059,71,0.0152164594942,1037,0.222246035148,857,0.183669095585,3809,0.816330904415,2743,0.587869695671,12-04,Cabarrus,3702512-04
Cabarrus,2651,2433,0.917766880422,145,0.0546963410034,7,0.00264051301396,14,0.00528102602791,19,0.00716710675217,33,0.0124481327801,163,11,11,163,174,18,0.00678989060732,163,0.0614862316107,73,0.0275367785741,2578,0.972463221426,2376,0.896265560166,12-05,Cabarrus,3702512-05
Cabarrus,2292,1465,0.639179755672,514,0.224258289703,9,0.00392670157068,13,0.00567190226876,251,0.109511343805,40,0.0174520069808,532,20,16,528,548,18,0.00785340314136,532,0.232111692845,426,0.185863874346,1866,0.814136125654,1324,0.577661431065,12-06,Cabarrus,3702512-06
Cabarrus,2438,438,0.179655455291,1637,0.671452009844,9,0.00369155045119,8,0.00328137817884,274,0.112387202625,72,0.0295324036095,1703,24,10,1689,1713,66,0.0270713699754,1703,0.69852337982,533,0.218621821165,1905,0.781378178835,232,0.0951599671862,12-07,Cabarrus,3702512-07
Cabarrus,3106,1884,0.606567933033,567,0.182549903413,13,0.00418544752093,16,0.00515132002576,524,0.168705730844,102,0.0328396651642,619,36,34,617,653,52,0.0167417900837,619,0.199291693496,860,0.276883451384,2246,0.723116548616,1631,0.525112685126,12-08,Cabarrus,3702512-08
Cabarrus,3348,2601,0.77688172043,520,0.15531660693,11,0.00328554360812,25,0.00746714456392,105,0.0313620071685,86,0.0256869772999,566,17,17,566,583,46,0.0137395459976,566,0.169056152927,242,0.0722819593787,3106,0.927718040621,2500,0.746714456392,12-09,Cabarrus,3702512-09
Cabarrus,1421,1310,0.921885995778,50,0.0351864883885,2,0.00140745953554,16,0.0112596762843,22,0.0154820548909,21,0.0147783251232,58,10,8,56,66,8,0.00562983814215,58,0.0408163265306,57,0.0401125967628,1364,0.959887403237,1275,0.897255453906,12-10,Cabarrus,3702512-10
Cabarrus,2674,1851,0.692221391174,489,0.18287210172,4,0.00149588631264,29,0.0108451757666,222,0.0830216903515,79,0.0295437546746,524,18,14,520,538,35,0.0130890052356,524,0.195961106956,439,0.164173522812,2235,0.835826477188,1696,0.634255796559,12-11,Cabarrus,3702512-11
Cabarrus,3058,2265,0.740680183126,503,0.164486592544,18,0.0058862001308,24,0.00784826684107,171,0.0559189012426,77,0.0251798561151,550,37,34,547,584,47,0.0153695225638,550,0.179856115108,358,0.117069980379,2700,0.882930019621,2116,0.691955526488,12-12,Cabarrus,3702512-12
Caldwell,5772,4945,0.856722106722,522,0.0904365904366,9,0.00155925155925,28,0.004851004851,159,0.0275467775468,109,0.0188842688843,591,33,28,586,619,69,0.0119542619543,591,0.102390852391,257,0.0445252945253,5515,0.955474705475,4877,0.844941094941,PR01,Caldwell,37027PR01
Caldwell,2355,2247,0.954140127389,45,0.0191082802548,0,0.0,3,0.00127388535032,27,0.0114649681529,33,0.0140127388535,64,7,5,62,69,19,0.00806794055202,64,0.0271762208068,44,0.0186836518047,2311,0.981316348195,2233,0.948195329087,PR02,Caldwell,37027PR02
Caldwell,5115,4803,0.939002932551,80,0.0156402737048,24,0.00469208211144,16,0.00312805474096,127,0.0248289345064,65,0.0127077223851,101,51,45,95,146,21,0.00410557184751,101,0.0197458455523,277,0.0541544477028,4838,0.945845552297,4690,0.916911045943,PR05,Caldwell,37027PR05
Caldwell,3606,3380,0.937326677759,119,0.0330005546312,12,0.00332778702163,18,0.00499168053245,40,0.0110926234054,37,0.01026067665,134,25,25,134,159,15,0.00415973377704,134,0.0371602884082,111,0.0307820299501,3495,0.96921797005,3317,0.919855795896,PR06,Caldwell,37027PR06
Caldwell,2754,2604,0.945533769063,90,0.0326797385621,10,0.00363108206245,11,0.0039941902687,14,0.00508351488744,25,0.00907770515614,100,25,24,99,124,10,0.00363108206245,100,0.0363108206245,38,0.0137981118373,2716,0.986201888163,2587,0.939360929557,PR07,Caldwell,37027PR07
Caldwell,1692,1616,0.955082742317,58,0.0342789598109,0,0.0,6,0.00354609929078,6,0.00354609929078,6,0.00354609929078,62,2,2,62,64,4,0.00236406619385,62,0.0366430260047,12,0.00709219858156,1680,0.992907801418,1610,0.951536643026,PR08,Caldwell,37027PR08
Caldwell,1876,1004,0.535181236674,647,0.344882729211,27,0.0143923240938,12,0.00639658848614,134,0.0714285714286,52,0.0277185501066,671,46,43,668,714,24,0.0127931769723,671,0.357675906183,284,0.151385927505,1592,0.848614072495,911,0.485607675906,PR09,Caldwell,37027PR09
Caldwell,3763,2890,0.768004251927,575,0.152803614138,15,0.00398618123837,11,0.00292319957481,169,0.0449109752857,103,0.0273717778368,653,25,25,653,678,78,0.0207281424395,653,0.173531756577,295,0.078394897688,3468,0.921605102312,2791,0.741695455753,PR12,Caldwell,37027PR12
Caldwell,4511,4406,0.97672356462,4,0.000886721347816,16,0.00354688539127,17,0.00376856572822,16,0.00354688539127,52,0.0115273775216,21,44,44,21,65,17,0.00376856572822,21,0.00465528707604,51,0.0113056971847,4460,0.988694302815,4374,0.969629793837,PR13,Caldwell,37027PR13
Caldwell,4898,4533,0.925479787668,89,0.018170681911,20,0.00408329930584,26,0.00530828909759,165,0.0336872192732,65,0.013270722744,117,35,31,113,148,28,0.00571661902817,117,0.0238873009392,317,0.0647202939976,4581,0.935279706002,4416,0.901592486729,PR14,Caldwell,37027PR14
Caldwell,3937,3779,0.959867919736,34,0.00863601727203,7,0.00177800355601,48,0.012192024384,40,0.01016002032,29,0.00736601473203,46,18,16,44,62,12,0.00304800609601,46,0.011684023368,115,0.0292100584201,3822,0.97078994158,3713,0.943103886208,PR15,Caldwell,37027PR15
Caldwell,2603,1798,0.690741452171,554,0.212831348444,4,0.00153668843642,21,0.0080676142912,138,0.0530157510565,88,0.0338071456012,612,22,17,607,629,58,0.0222819823281,612,0.235113330772,213,0.0818286592393,2390,0.918171340761,1743,0.66961198617,PR16,Caldwell,37027PR16
Caldwell,2544,2292,0.900943396226,97,0.0381289308176,4,0.00157232704403,31,0.0121855345912,77,0.0302672955975,43,0.0169025157233,121,19,14,116,135,24,0.00943396226415,121,0.0475628930818,141,0.0554245283019,2403,0.944575471698,2239,0.880110062893,PR17,Caldwell,37027PR17
Caldwell,5061,4829,0.954159257064,97,0.0191661726931,5,0.000987947046038,52,0.0102746492788,27,0.00533491404861,51,0.0100770598696,124,21,17,120,141,27,0.00533491404861,124,0.0245010867418,81,0.0160047421458,4980,0.983995257854,4779,0.944279786603,PR18,Caldwell,37027PR18
Caldwell,2345,1812,0.772707889126,318,0.135607675906,2,0.000852878464819,6,0.00255863539446,137,0.0584221748401,70,0.0298507462687,354,24,19,349,373,36,0.0153518123667,354,0.150959488273,195,0.0831556503198,2150,0.91684434968,1771,0.755223880597,PR19,Caldwell,37027PR19
Caldwell,4422,4280,0.967887833559,34,0.00768882858435,18,0.00407055630936,10,0.00226142017187,41,0.00927182270466,39,0.00881953867028,47,32,31,46,78,13,0.00293984622343,47,0.0106286748078,88,0.0199004975124,4334,0.980099502488,4239,0.958616010855,PR21,Caldwell,37027PR21
Caldwell,5094,4800,0.942285041225,102,0.020023557126,13,0.00255202198665,27,0.00530035335689,90,0.017667844523,62,0.0121711817825,135,28,25,132,160,33,0.00647820965842,135,0.0265017667845,190,0.0372987828818,4904,0.962701217118,4722,0.926972909305,PR22,Caldwell,37027PR22
Caldwell,2394,2336,0.975772765246,25,0.0104427736007,5,0.00208855472013,1,0.000417710944027,8,0.00334168755221,19,0.00793650793651,33,11,11,33,44,8,0.00334168755221,33,0.0137844611529,20,0.00835421888053,2374,0.991645781119,2324,0.970760233918,PR23,Caldwell,37027PR23
Caldwell,3074,2885,0.938516590761,37,0.0120364346129,5,0.00162654521796,7,0.00227716330514,89,0.0289525048796,51,0.0165907612232,51,19,19,51,70,14,0.00455432661028,51,0.0165907612232,188,0.0611581001952,2886,0.938841899805,2795,0.909238776838,PR24,Caldwell,37027PR24
Caldwell,2963,2824,0.953088086399,19,0.00641241984475,11,0.00371245359433,4,0.00134998312521,66,0.022274721566,39,0.0131623354708,40,23,23,40,63,21,0.00708741140736,40,0.0134998312521,107,0.0361120485994,2856,0.963887951401,2784,0.939588255147,PR25,Caldwell,37027PR25
Caldwell,1180,1141,0.966949152542,14,0.0118644067797,3,0.00254237288136,1,0.000847457627119,6,0.00508474576271,15,0.0127118644068,20,11,11,20,31,6,0.00508474576271,20,0.0169491525424,10,0.00847457627119,1170,0.991525423729,1137,0.963559322034,PR27,Caldwell,37027PR27
Caldwell,5912,5668,0.958728010825,33,0.00558186738836,13,0.00219891745602,48,0.00811907983762,68,0.01150202977,82,0.0138700947226,62,48,43,57,105,29,0.00490527740189,62,0.0104871447903,161,0.0272327469553,5751,0.972767253045,5603,0.947733423545,PR28,Caldwell,37027PR28
Caldwell,5158,4053,0.78576967817,493,0.0955796820473,34,0.00659170221016,51,0.00988755331524,404,0.0783249321442,123,0.0238464521132,564,62,57,559,621,71,0.0137650252036,564,0.109344707251,601,0.116518030244,4557,0.883481969756,3910,0.758045754168,PR29,Caldwell,37027PR29
Camden,3822,3129,0.818681318681,548,0.143380429095,7,0.0018315018315,38,0.00994243851387,11,0.00287807430665,89,0.023286237572,590,43,34,581,624,42,0.010989010989,590,0.154369440084,72,0.0188383045526,3750,0.981161695447,3091,0.808738880167,CH,Camden,37029CH
Camden,2506,2147,0.856743814844,207,0.0826017557861,9,0.00359138068635,75,0.0299281723863,31,0.012370311253,37,0.0147645650439,222,18,17,221,239,15,0.00598563447725,222,0.0885873902634,56,0.0223463687151,2450,0.977653631285,2130,0.84996009577,SH,Camden,37029SH
Camden,3652,2917,0.79874041621,561,0.153614457831,17,0.00465498357065,38,0.0104052573932,32,0.00876232201533,87,0.0238225629792,596,46,43,593,639,35,0.00958378970427,596,0.163198247536,87,0.0238225629792,3565,0.976177437021,2882,0.789156626506,SM,Camden,37029SM
Carteret,1517,1427,0.940672379697,18,0.0118655240606,8,0.00527356624918,16,0.0105471324984,17,0.0112063282795,31,0.0204350692156,23,27,27,23,50,5,0.00329597890574,23,0.0151615029664,23,0.0151615029664,1494,0.984838497034,1420,0.936058009229,ABCH,Carteret,37031ABCH
Carteret,694,676,0.974063400576,1,0.0014409221902,2,0.0028818443804,0,0.0,8,0.0115273775216,7,0.0100864553314,3,5,5,3,8,2,0.0028818443804,3,0.00432276657061,17,0.0244956772334,677,0.975504322767,669,0.963976945245,ATLN,Carteret,37031ATLN
Carteret,2990,2749,0.919397993311,84,0.0280936454849,29,0.00969899665552,17,0.0056856187291,37,0.0123745819398,74,0.0247491638796,125,56,51,120,176,41,0.0137123745819,125,0.0418060200669,101,0.033779264214,2889,0.966220735786,2698,0.902341137124,BCRK,Carteret,37031BCRK
Carteret,427,418,0.978922716628,2,0.00468384074941,1,0.00234192037471,1,0.00234192037471,0,0.0,5,0.0117096018735,4,2,2,4,6,2,0.00468384074941,4,0.00936768149883,0,0.0,427,1.0,418,0.978922716628,BETT,Carteret,37031BETT
Carteret,1749,1314,0.7512864494,373,0.213264722699,7,0.00400228702115,15,0.00857632933105,3,0.00171526586621,37,0.0211549456832,396,16,12,392,408,23,0.0131503716409,396,0.22641509434,42,0.0240137221269,1707,0.975986277873,1285,0.734705546026,BFT1,Carteret,37031BFT1
Carteret,4447,3887,0.874072408365,399,0.0897234090398,14,0.00314818979087,28,0.00629637958174,33,0.00742073307848,86,0.0193388801439,440,50,42,432,482,41,0.00921969867326,440,0.0989431077131,101,0.0227119406341,4346,0.977288059366,3825,0.860130425006,BFT2,Carteret,37031BFT2
Carteret,2965,2670,0.900505902192,156,0.0526138279933,18,0.00607082630691,40,0.0134907251265,26,0.00876897133221,55,0.0185497470489,171,36,36,171,207,15,0.00505902192243,171,0.0576728499157,94,0.0317032040472,2871,0.968296795953,2600,0.876897133221,BOGU,Carteret,37031BOGU
Carteret,3213,3065,0.953937130408,37,0.0115157173981,17,0.00529100529101,34,0.010582010582,24,0.00746965452848,36,0.0112044817927,45,29,27,43,72,8,0.00248988484283,45,0.0140056022409,59,0.0183629007158,3154,0.981637099284,3034,0.944288826642,CCCP,Carteret,37031CCCP
Carteret,327,326,0.996941896024,0,0.0,0,0.0,1,0.00305810397554,0,0.0,0,0.0,0,0,0,0,0,0,0.0,0,0.0,6,0.0183486238532,321,0.981651376147,320,0.978593272171,CDIS,Carteret,37031CDIS
Carteret,426,419,0.983568075117,0,0.0,1,0.00234741784038,1,0.00234741784038,1,0.00234741784038,4,0.0093896713615,0,2,2,0,2,0,0.0,0,0.0,1,0.00234741784038,425,0.99765258216,418,0.981220657277,DAVI,Carteret,37031DAVI
Carteret,3655,3536,0.967441860465,22,0.00601915184679,8,0.00218878248974,34,0.0093023255814,19,0.00519835841313,36,0.00984952120383,25,24,23,24,48,3,0.000820793433653,25,0.00683994528044,72,0.0196990424077,3583,0.980300957592,3483,0.952941176471,EMIS,Carteret,37031EMIS
Carteret,1207,1189,0.985086992543,0,0.0,3,0.00248550124275,3,0.00248550124275,0,0.0,12,0.009942004971,0,13,13,0,13,0,0.0,0,0.0,1,0.00082850041425,1206,0.999171499586,1188,0.984258492129,HAIS,Carteret,37031HAIS
Carteret,850,803,0.944705882353,22,0.0258823529412,1,0.00117647058824,4,0.00470588235294,9,0.0105882352941,11,0.0129411764706,22,5,5,22,27,0,0.0,22,0.0258823529412,12,0.0141176470588,838,0.985882352941,799,0.94,HARL,Carteret,37031HARL
Carteret,356,353,0.991573033708,1,0.00280898876404,0,0.0,1,0.00280898876404,0,0.0,1,0.00280898876404,1,1,1,1,2,0,0.0,1,0.00280898876404,0,0.0,356,1.0,353,0.991573033708,IBSP,Carteret,37031IBSP
Carteret,529,518,0.979206049149,0,0.0,0,0.0,6,0.0113421550095,0,0.0,5,0.00945179584121,1,2,2,1,3,1,0.00189035916824,1,0.00189035916824,2,0.00378071833648,527,0.996219281664,517,0.977315689981,MARS,Carteret,37031MARS
Carteret,728,675,0.927197802198,10,0.0137362637363,8,0.010989010989,3,0.00412087912088,1,0.00137362637363,31,0.0425824175824,29,18,18,29,47,19,0.0260989010989,29,0.0398351648352,16,0.021978021978,712,0.978021978022,666,0.914835164835,MCRK,Carteret,37031MCRK
Carteret,605,520,0.859504132231,68,0.112396694215,3,0.00495867768595,0,0.0,4,0.00661157024793,10,0.0165289256198,70,11,11,70,81,2,0.00330578512397,70,0.115702479339,13,0.0214876033058,592,0.978512396694,513,0.847933884298,MERR,Carteret,37031MERR
Carteret,3187,2662,0.835268277377,354,0.111076247254,10,0.00313774709758,47,0.0147474113586,67,0.0210229055538,47,0.0147474113586,382,21,15,376,397,28,0.00878569187324,382,0.119861939128,372,0.11672419203,2815,0.88327580797,2372,0.744273611547,MHD1,Carteret,37031MHD1
Carteret,3931,3094,0.787077079624,483,0.122869498855,26,0.00661409310608,72,0.0183159501399,129,0.032816077334,127,0.0323073009412,553,67,47,533,600,70,0.0178071737471,553,0.140676672602,204,0.0518951920631,3727,0.948104807937,3045,0.774612058001,MHD2,Carteret,37031MHD2
Carteret,3978,3568,0.896933132227,202,0.0507792860734,17,0.0042735042735,44,0.0110608345902,64,0.0160884866767,83,0.0208647561589,238,40,37,235,275,36,0.00904977375566,238,0.0598290598291,120,0.0301659125189,3858,0.969834087481,3515,0.883609854198,MHD3,Carteret,37031MHD3
Carteret,3050,2921,0.957704918033,21,0.00688524590164,7,0.00229508196721,64,0.0209836065574,13,0.00426229508197,24,0.00786885245902,32,14,13,31,45,11,0.00360655737705,32,0.0104918032787,52,0.0170491803279,2998,0.982950819672,2879,0.94393442623,MHD4,Carteret,37031MHD4
Carteret,5716,4749,0.830825752274,542,0.0948215535339,38,0.00664800559832,90,0.0157452764171,112,0.0195941217635,185,0.0323652904129,615,95,84,604,699,73,0.0127711686494,615,0.107592722183,279,0.0488103568929,5437,0.951189643107,4631,0.810181945416,NPT1,Carteret,37031NPT1
Carteret,4033,3587,0.889412348128,202,0.0500867840317,30,0.00743863129184,26,0.00644681378626,78,0.0193404413588,110,0.0272749814034,257,59,54,252,311,55,0.0136374907017,257,0.0637242747334,186,0.0461195140094,3847,0.953880485991,3502,0.868336226134,NPT2,Carteret,37031NPT2
Carteret,821,316,0.384896467722,455,0.554202192448,5,0.00609013398295,2,0.00243605359318,20,0.0243605359318,23,0.0280146163216,470,13,9,466,479,15,0.0182704019488,470,0.572472594397,31,0.0377588306943,790,0.962241169306,312,0.380024360536,NRIV,Carteret,37031NRIV
Carteret,2399,2354,0.981242184243,11,0.0045852438516,5,0.00208420175073,5,0.00208420175073,5,0.00208420175073,19,0.00791996665277,15,15,15,15,30,4,0.00166736140058,15,0.00625260525219,15,0.00625260525219,2384,0.993747394748,2343,0.976656940392,OTST,Carteret,37031OTST
Carteret,1571,1490,0.948440483768,11,0.00700190961171,7,0.004455760662,13,0.00827498408657,28,0.017823042648,22,0.0140038192234,12,13,13,12,25,1,0.000636537237428,12,0.00763844684914,62,0.0394653087206,1509,0.960534691279,1461,0.929980903883,PELE,Carteret,37031PELE
Carteret,1339,1289,0.962658700523,10,0.00746825989544,1,0.000746825989544,17,0.0126960418223,9,0.0067214339059,13,0.00970873786408,14,3,3,14,17,4,0.00298730395818,14,0.0104555638536,14,0.0104555638536,1325,0.989544436146,1283,0.958177744586,PKNL,Carteret,37031PKNL
Carteret,522,518,0.992337164751,3,0.00574712643678,0,0.0,0,0.0,0,0.0,1,0.00191570881226,4,0,0,4,4,1,0.00191570881226,4,0.00766283524904,3,0.00574712643678,519,0.994252873563,515,0.986590038314,SLVL,Carteret,37031SLVL
Carteret,333,325,0.975975975976,1,0.003003003003,0,0.0,1,0.003003003003,0,0.0,6,0.018018018018,6,0,0,6,6,5,0.015015015015,6,0.018018018018,7,0.021021021021,326,0.978978978979,323,0.96996996997,SMYR,Carteret,37031SMYR
Carteret,214,203,0.948598130841,0,0.0,0,0.0,0,0.0,8,0.0373831775701,3,0.0140186915888,0,3,3,0,3,0,0.0,0,0.0,10,0.0467289719626,204,0.953271028037,201,0.939252336449,STAC,Carteret,37031STAC
Carteret,1672,1550,0.927033492823,70,0.0418660287081,12,0.00717703349282,9,0.00538277511962,7,0.00418660287081,24,0.0143540669856,77,26,23,74,100,7,0.00418660287081,77,0.0460526315789,41,0.0245215311005,1631,0.9754784689,1519,0.908492822967,STEL,Carteret,37031STEL
Carteret,4991,4364,0.874373872971,319,0.0639150470848,32,0.00641154077339,48,0.00961731116009,87,0.0174313764777,141,0.0282508515328,395,69,60,386,455,76,0.0152274093368,395,0.0791424564216,256,0.0512923261871,4735,0.948707673813,4208,0.843117611701,WILD,Carteret,37031WILD
Carteret,394,392,0.994923857868,1,0.00253807106599,0,0.0,0,0.0,1,0.00253807106599,0,0.0,1,0,0,1,1,0,0.0,1,0.00253807106599,4,0.010152284264,390,0.989847715736,388,0.984771573604,WILL,Carteret,37031WILL
Carteret,1633,1419,0.86895284752,163,0.0998162890386,6,0.00367421922841,5,0.00306184935701,2,0.0012247397428,38,0.0232700551133,177,24,24,177,201,14,0.00857317819963,177,0.108389467238,25,0.0153092467851,1608,0.984690753215,1398,0.85609308022,WIRE,Carteret,37031WIRE
Caswell,1174,876,0.746166950596,236,0.201022146508,5,0.00425894378194,2,0.00170357751278,23,0.0195911413969,32,0.0272572402044,247,18,18,247,265,11,0.00936967632027,247,0.210391822828,57,0.0485519591141,1117,0.951448040886,848,0.722316865417,ANDE,Caswell,37033ANDE
Caswell,1363,824,0.604548789435,490,0.359501100514,5,0.00366837857667,1,0.000733675715334,28,0.0205429200293,15,0.01100513573,501,10,7,498,508,11,0.00807043286867,501,0.367571533382,45,0.03301540719,1318,0.96698459281,809,0.593543653705,HIGH,Caswell,37033HIGH
Caswell,886,526,0.593679458239,341,0.384875846501,1,0.00112866817156,4,0.00451467268623,3,0.00338600451467,11,0.0124153498871,345,8,4,341,349,4,0.00451467268623,345,0.389390519187,19,0.0214446952596,867,0.97855530474,512,0.577878103837,LEAS,Caswell,37033LEAS
Caswell,3031,1493,0.492576707357,1474,0.486308149126,5,0.00164962058726,0,0.0,22,0.00725833058397,37,0.0122071923458,1497,17,11,1491,1508,23,0.00758825470142,1497,0.493896403827,55,0.0181458264599,2976,0.98185417354,1468,0.484328604421,LOCU,Caswell,37033LOCU
Caswell,2895,1389,0.479792746114,1433,0.494991364421,11,0.00379965457686,15,0.00518134715026,14,0.00483592400691,33,0.0113989637306,1451,30,21,1442,1472,18,0.00621761658031,1451,0.501208981002,59,0.0203799654577,2836,0.979620034542,1358,0.46908462867,MILT,Caswell,37033MILT
Caswell,4537,3504,0.772316508706,844,0.186026008376,14,0.00308573947542,22,0.00484901917567,70,0.0154286973771,83,0.01829402689,895,46,34,883,929,51,0.011240908089,895,0.197266916465,170,0.0374696936302,4367,0.96253030637,3418,0.753361251929,PELH,Caswell,37033PELH
Caswell,1205,998,0.828215767635,160,0.132780082988,2,0.00165975103734,1,0.000829875518672,31,0.0257261410788,13,0.0107883817427,168,4,4,168,172,8,0.00663900414938,168,0.139419087137,38,0.0315352697095,1167,0.96846473029,994,0.82489626556,PROS,Caswell,37033PROS
Caswell,1127,835,0.740905057675,268,0.237799467613,8,0.00709849157054,3,0.00266193433895,2,0.00177462289264,11,0.00976042590949,271,12,12,271,283,3,0.00266193433895,271,0.240461401952,14,0.0124223602484,1113,0.987577639752,823,0.730257320319,PROVI,Caswell,37033PROVI
Caswell,3207,2356,0.734642968506,707,0.220455254132,5,0.00155908949174,0,0.0,83,0.0258808855628,56,0.0174618023075,737,19,16,734,753,30,0.00935453695042,737,0.229809791082,131,0.0408481446835,3076,0.959151855316,2323,0.724352977861,STON,Caswell,37033STON
Caswell,3102,1535,0.494842037395,1419,0.457446808511,19,0.00612508059317,15,0.00483558994197,49,0.0157962604771,65,0.0209542230819,1469,42,26,1453,1495,50,0.0161186331399,1469,0.473565441651,118,0.0380399742102,2984,0.96196002579,1484,0.478401031593,YAN2,Caswell,37033YAN2
Caswell,1192,483,0.405201342282,648,0.543624161074,10,0.00838926174497,1,0.000838926174497,25,0.0209731543624,25,0.0209731543624,672,19,11,664,683,24,0.0201342281879,672,0.563758389262,38,0.0318791946309,1154,0.968120805369,476,0.39932885906,YAN4,Caswell,37033YAN4
Catawba,4858,4521,0.930629888843,106,0.0218196788802,30,0.00617538081515,52,0.0107039934129,93,0.019143680527,56,0.0115273775216,121,54,54,121,175,15,0.00308769040758,121,0.0249073692878,153,0.0314944421573,4705,0.968505557843,4463,0.918690819267,01,Catawba,3703501
Catawba,3107,2924,0.941100740264,42,0.0135178628902,4,0.00128741551336,68,0.0218860637271,36,0.0115867396202,33,0.0106211779852,51,17,17,51,68,9,0.00289668490505,51,0.0164145477953,65,0.0209205020921,3042,0.979079497908,2894,0.931445123914,02,Catawba,3703502
Catawba,3671,3219,0.876872786707,221,0.060201579951,11,0.00299645873059,133,0.0362299101062,50,0.0136202669572,37,0.0100789975484,232,24,24,232,256,11,0.00299645873059,232,0.0631980386816,125,0.0340506673931,3546,0.965949332607,3148,0.857532007627,03,Catawba,3703503
Catawba,1172,795,0.678327645051,233,0.198805460751,1,0.000853242320819,93,0.0793515358362,27,0.0230375426621,23,0.0196245733788,250,11,4,243,254,17,0.0145051194539,250,0.213310580205,83,0.070819112628,1089,0.929180887372,739,0.630546075085,04,Catawba,3703504
Catawba,4899,4054,0.827515819555,506,0.103286384977,28,0.00571545213309,81,0.0165339865279,159,0.0324556031843,71,0.0144927536232,540,45,44,539,584,34,0.00694019187589,540,0.110226576852,286,0.0583792610737,4613,0.941620738926,3964,0.809144723413,05,Catawba,3703505
Catawba,2873,2566,0.893143056039,164,0.0570831883049,8,0.00278454577097,55,0.0191437521754,55,0.0191437521754,25,0.00870170553428,178,10,10,178,188,14,0.0048729550992,178,0.0619561434041,97,0.033762617473,2776,0.966237382527,2525,0.878872258963,06,Catawba,3703506
Catawba,4884,3527,0.722153972154,605,0.123873873874,9,0.00184275184275,214,0.0438165438165,389,0.0796478296478,140,0.028665028665,687,39,28,676,715,82,0.0167895167895,687,0.140663390663,828,0.169533169533,4056,0.830466830467,3127,0.640253890254,07,Catawba,3703507
Catawba,3456,3073,0.889178240741,125,0.0361689814815,6,0.00173611111111,129,0.0373263888889,61,0.017650462963,62,0.0179398148148,142,22,22,142,164,17,0.00491898148148,142,0.041087962963,150,0.0434027777778,3306,0.956597222222,3007,0.870081018519,08,Catawba,3703508
Catawba,3528,3251,0.921485260771,137,0.0388321995465,2,0.000566893424036,43,0.0121882086168,52,0.0147392290249,43,0.0121882086168,154,12,8,150,162,17,0.00481859410431,154,0.0436507936508,137,0.0388321995465,3391,0.961167800454,3187,0.903344671202,09,Catawba,3703509
Catawba,929,524,0.564047362756,286,0.307857911733,10,0.010764262648,10,0.010764262648,70,0.0753498385361,29,0.0312163616792,304,21,20,303,324,18,0.0193756727664,304,0.327233584499,120,0.129171151776,809,0.870828848224,483,0.519913885899,10,Catawba,3703510
Catawba,1904,1509,0.792542016807,258,0.135504201681,8,0.00420168067227,23,0.0120798319328,66,0.0346638655462,40,0.0210084033613,276,14,13,275,289,18,0.00945378151261,276,0.144957983193,213,0.111869747899,1691,0.888130252101,1373,0.721113445378,11,Catawba,3703511
Catawba,2676,1173,0.438340807175,1209,0.451793721973,4,0.00149476831091,87,0.0325112107623,130,0.0485799701046,73,0.0272795216741,1266,10,9,1265,1275,57,0.0213004484305,1266,0.473094170404,404,0.150971599402,2272,0.849028400598,923,0.344917787743,12,Catawba,3703512
Catawba,3071,1781,0.57994138717,630,0.20514490394,11,0.00358189514816,116,0.0377727124715,409,0.133181374145,124,0.0403777271247,730,28,19,721,749,100,0.0325626831651,730,0.237707587105,658,0.214262455226,2413,0.785737544774,1573,0.512211006187,13,Catawba,3703513
Catawba,2023,1887,0.932773109244,66,0.0326248146317,3,0.00148294611962,17,0.00840336134454,30,0.0148294611962,20,0.00988630746416,77,5,5,77,82,11,0.00543746910529,77,0.038062283737,69,0.0341077607514,1954,0.965892239249,1853,0.915966386555,14,Catawba,3703514
Catawba,1187,146,0.12299915754,949,0.79949452401,2,0.0016849199663,39,0.0328559393429,33,0.027801179444,18,0.0151642796967,966,5,2,963,968,17,0.0143218197136,966,0.813816343724,59,0.0497051390059,1128,0.950294860994,125,0.105307497894,15,Catawba,3703515
Catawba,4035,3122,0.773729863693,476,0.117967781908,28,0.00693928128872,94,0.0232961586121,188,0.0465923172243,127,0.0314745972739,553,50,42,545,595,77,0.019083023544,553,0.137050805452,545,0.135068153656,3490,0.864931846344,2811,0.696654275093,16,Catawba,3703516
Catawba,3180,2269,0.713522012579,373,0.117295597484,14,0.00440251572327,167,0.0525157232704,252,0.0792452830189,105,0.0330188679245,448,28,25,445,473,75,0.0235849056604,448,0.140880503145,420,0.132075471698,2760,0.867924528302,2128,0.669182389937,17,Catawba,3703517
Catawba,1779,1306,0.734120292299,254,0.142776840922,9,0.00505902192243,134,0.0753232152895,32,0.017987633502,44,0.0247329960652,283,21,21,283,304,29,0.0163012928612,283,0.159078133783,128,0.0719505340079,1651,0.928049465992,1216,0.683530073075,19,Catawba,3703519
Catawba,4816,4047,0.840323920266,430,0.0892857142857,22,0.00456810631229,63,0.0130813953488,180,0.0373754152824,74,0.015365448505,464,40,38,462,502,34,0.00705980066445,464,0.0963455149502,347,0.0720514950166,4469,0.927948504983,3903,0.81042358804,20,Catawba,3703520
Catawba,2469,2265,0.91737545565,112,0.0453624949372,12,0.0048602673147,16,0.0064803564196,40,0.016200891049,24,0.0097205346294,116,22,21,115,137,4,0.0016200891049,116,0.0469825840421,78,0.0315917375456,2391,0.968408262454,2236,0.90562980964,21,Catawba,3703521
Catawba,5419,4323,0.797748662115,425,0.0784277541982,17,0.00313711016793,320,0.0590514855139,213,0.0393061450452,121,0.02232884296,498,54,47,491,545,73,0.0134711201329,498,0.0918988743311,451,0.0832256873962,4968,0.916774312604,4112,0.758811588854,22,Catawba,3703522
Catawba,5222,4659,0.89218690157,260,0.0497893527384,26,0.00497893527384,127,0.0243201838376,45,0.00861738797396,105,0.0201072386059,333,49,47,331,380,73,0.0139793182689,333,0.0637686710073,138,0.0264266564535,5084,0.973573343547,4570,0.875143623133,23,Catawba,3703523
Catawba,5742,5146,0.896203413445,233,0.0405781957506,14,0.00243817485197,208,0.0362243120864,68,0.0118425635667,73,0.0127133402995,264,34,34,264,298,31,0.00539881574364,264,0.0459770114943,151,0.0262974573319,5591,0.973702542668,5063,0.88174851968,24,Catawba,3703524
Catawba,3907,2822,0.722293319683,508,0.130023035577,12,0.00307141028922,103,0.0263629383158,346,0.0885589966726,116,0.0296902994625,573,36,31,568,604,65,0.0166368057333,573,0.14665984131,737,0.18863578193,3170,0.81136421807,2469,0.631942667008,25,Catawba,3703525
Catawba,2263,2055,0.908086610694,100,0.0441891294741,7,0.00309323906319,35,0.015466195316,34,0.0150243040212,32,0.0141405214317,111,13,11,109,122,11,0.00486080424216,111,0.0490499337163,75,0.0331418471056,2188,0.966858152894,2023,0.893946089262,26,Catawba,3703526
Catawba,5973,5130,0.858864892014,204,0.0341536916123,15,0.00251130085384,417,0.0698141637368,127,0.0212623472292,80,0.0133936045538,245,35,31,241,276,41,0.00686422233384,245,0.0410179139461,251,0.0420224342876,5722,0.957977565712,5025,0.841285786037,27,Catawba,3703527
Catawba,6067,4334,0.714356354046,428,0.070545574419,26,0.00428547881985,242,0.0398879182463,893,0.147189714851,144,0.0237349596176,495,55,54,494,549,67,0.0110433492665,495,0.0815889236855,1440,0.237349596176,4627,0.762650403824,3850,0.634580517554,28,Catawba,3703528
Catawba,3828,3290,0.859456635319,104,0.0271682340648,9,0.00235109717868,98,0.0256008359457,260,0.067920585162,67,0.0175026123302,133,30,28,131,161,29,0.00757575757576,133,0.0347439916405,427,0.111546499478,3401,0.888453500522,3133,0.818443051202,29,Catawba,3703529
Catawba,5344,4241,0.793600299401,434,0.0812125748503,23,0.00430389221557,295,0.0552020958084,215,0.0402320359281,136,0.0254491017964,518,37,31,512,549,84,0.0157185628743,518,0.0969311377246,411,0.0769086826347,4933,0.923091317365,4097,0.766654191617,30,Catawba,3703530
Catawba,5408,4999,0.924371301775,263,0.0486316568047,9,0.00166420118343,43,0.00795118343195,38,0.00702662721893,56,0.0103550295858,275,25,25,275,300,12,0.00221893491124,275,0.050850591716,131,0.0242233727811,5277,0.975776627219,4928,0.91124260355,31,Catawba,3703531
Catawba,4598,3292,0.715963462375,608,0.132231404959,12,0.00260983036103,214,0.0465419747716,341,0.0741626794258,131,0.0284906481079,669,30,28,667,697,61,0.0132666376686,669,0.145498042627,583,0.126794258373,4015,0.873205741627,3105,0.675293605916,32,Catawba,3703532
Catawba,9658,8040,0.832470490785,357,0.0369641747774,34,0.00352039759785,652,0.067508800994,413,0.0427624767033,162,0.0167736591427,442,58,53,437,495,85,0.00880099399462,442,0.045765168772,799,0.0827293435494,8859,0.917270656451,7720,0.799337336923,33,Catawba,3703533
Catawba,6559,5758,0.877877725263,258,0.039335264522,11,0.00167708492148,322,0.0490928495197,123,0.0187528586675,87,0.0132642171063,308,28,21,301,329,50,0.00762311327946,308,0.0469583778015,260,0.0396401890532,6299,0.960359810947,5640,0.859887177923,34,Catawba,3703534
Catawba,4542,3340,0.735358872743,464,0.102157639806,17,0.00374284456187,289,0.0636283575517,352,0.0774988991634,80,0.0176133861735,508,37,32,503,540,44,0.00968736239542,508,0.111845002202,767,0.168868339938,3775,0.831131660062,2970,0.653896961691,35,Catawba,3703535
Catawba,2871,2546,0.88679902473,141,0.0491118077325,5,0.00174155346569,56,0.0195053988157,69,0.0240334378265,54,0.0188087774295,165,26,15,154,180,24,0.00835945663532,165,0.0574712643678,173,0.0602577499129,2698,0.939742250087,2453,0.854406130268,36,Catawba,3703536
Catawba,3955,2914,0.736788874842,495,0.125158027813,4,0.00101137800253,82,0.0207332490518,352,0.0890012642225,108,0.0273072060683,563,20,16,559,579,68,0.017193426043,563,0.142351453856,742,0.187610619469,3213,0.812389380531,2566,0.648798988622,37,Catawba,3703537
Catawba,3391,3094,0.91241521675,109,0.0321439103509,12,0.0035387791212,119,0.0350928929519,28,0.00825715128281,29,0.00855204954291,123,14,14,123,137,14,0.0041285756414,123,0.0362724859923,87,0.0256561486287,3304,0.974343851371,3037,0.895606015925,38,Catawba,3703538
Catawba,2660,2494,0.937593984962,36,0.0135338345865,2,0.000751879699248,75,0.0281954887218,15,0.00563909774436,38,0.0142857142857,56,2,2,56,58,20,0.00751879699248,56,0.0210526315789,83,0.0312030075188,2577,0.968796992481,2434,0.915037593985,39,Catawba,3703539
Catawba,2503,1927,0.769876148622,400,0.159808230124,6,0.00239712345186,56,0.0223731522173,77,0.0307630842988,37,0.0147822612865,412,14,13,411,425,12,0.00479424690372,412,0.164602477028,259,0.103475829005,2244,0.896524170995,1779,0.710747103476,40,Catawba,3703540
Catawba,3931,3788,0.963622487917,32,0.00814042228441,6,0.00152632917833,18,0.00457898753498,34,0.00864919867718,53,0.0134825744085,48,22,22,48,70,16,0.0040702111422,48,0.0122106334266,102,0.0259475960315,3829,0.974052403968,3736,0.950394301704,41,Catawba,3703541
Chatham,2492,2056,0.825040128411,323,0.129614767255,8,0.00321027287319,21,0.00842696629213,49,0.0196629213483,35,0.0140449438202,337,15,14,336,351,14,0.00561797752809,337,0.135232744783,97,0.0389245585875,2395,0.961075441413,2012,0.807383627608,15,Chatham,3703715
Chatham,3304,2525,0.764225181598,688,0.208232445521,15,0.00453995157385,7,0.0021186440678,21,0.00635593220339,48,0.0145278450363,711,25,24,710,735,23,0.0069612590799,711,0.2151937046,98,0.0296610169492,3206,0.970338983051,2467,0.746670702179,18,Chatham,3703718
Chatham,2545,1911,0.750884086444,469,0.184282907662,20,0.00785854616896,14,0.00550098231827,90,0.0353634577603,41,0.0161100196464,485,45,37,477,522,16,0.00628683693517,485,0.190569744597,150,0.0589390962672,2395,0.941060903733,1862,0.73163064833,20,Chatham,3703720
Chatham,1823,1733,0.950630828305,35,0.0191991223258,3,0.0016456390565,10,0.00548546352167,15,0.0082281952825,27,0.0148107515085,41,14,12,39,53,6,0.003291278113,41,0.0224904004388,66,0.036204059243,1757,0.963795940757,1692,0.928140427866,21,Chatham,3703721
Chatham,1094,1060,0.968921389397,12,0.0109689213894,2,0.0018281535649,1,0.00091407678245,13,0.0118829981718,6,0.0054844606947,15,2,2,15,17,3,0.00274223034735,15,0.0137111517367,33,0.0301645338208,1061,0.969835466179,1043,0.953382084095,24,Chatham,3703724
Chatham,2566,2161,0.842166796571,202,0.078721745908,19,0.00740452065472,8,0.00311769290725,147,0.0572876071707,29,0.0113016367888,210,30,30,210,240,8,0.00311769290725,210,0.0818394388153,226,0.0880748246298,2340,0.91192517537,2089,0.814107560405,3,Chatham,370373
Chatham,2130,1698,0.797183098592,308,0.144600938967,2,0.00093896713615,7,0.00328638497653,72,0.0338028169014,43,0.0201877934272,326,10,10,326,336,18,0.00845070422535,326,0.153051643192,116,0.0544600938967,2014,0.945539906103,1669,0.783568075117,30,Chatham,3703730
Chatham,2042,1817,0.889813907933,142,0.0695396669931,8,0.00391772771792,27,0.013222331048,25,0.0122428991185,23,0.011263467189,147,15,15,147,162,5,0.0024485798237,147,0.0719882468168,65,0.0318315377081,1977,0.968168462292,1778,0.870714985309,42,Chatham,3703742
Chatham,1222,996,0.815057283142,181,0.148117839607,8,0.00654664484452,2,0.00163666121113,28,0.0229132569558,7,0.00572831423895,181,15,15,181,196,0,0.0,181,0.148117839607,53,0.0433715220949,1169,0.956628477905,976,0.798690671031,45,Chatham,3703745
Chatham,1114,1007,0.9039497307,72,0.064631956912,6,0.00538599640934,10,0.00897666068223,11,0.00987432675045,8,0.00718132854578,75,10,10,75,85,3,0.00269299820467,75,0.0673249551167,18,0.016157989228,1096,0.983842010772,1004,0.901256732496,6,Chatham,370376
Chatham,2914,2491,0.854838709677,219,0.0751544269046,9,0.00308853809197,110,0.0377487989019,47,0.0161290322581,38,0.0130404941661,232,22,15,225,247,13,0.0044612216884,232,0.079615648593,89,0.0305422100206,2825,0.969457789979,2444,0.838709677419,75,Chatham,3703775
Chatham,4582,4252,0.92797904845,124,0.027062418158,13,0.00283718900044,64,0.0139676996945,82,0.0178961152335,47,0.0102575294631,143,28,24,139,167,19,0.00414666084679,143,0.0312090790048,160,0.0349192492361,4422,0.965080750764,4170,0.910082933217,78,Chatham,3703778
Chatham,5258,3024,0.575123621149,863,0.164130848231,52,0.00988969189806,47,0.00893875998479,1106,0.210346139216,166,0.0315709395207,939,105,87,921,1026,76,0.0144541650818,939,0.178585013313,1924,0.365918600228,3334,0.634081399772,2339,0.44484594903,85,Chatham,3703785
Chatham,2124,1804,0.84934086629,217,0.102165725047,14,0.00659133709981,15,0.00706214689266,32,0.015065913371,42,0.0197740112994,228,28,26,226,254,11,0.00517890772128,228,0.107344632768,131,0.0616760828625,1993,0.938323917137,1721,0.810263653484,9,Chatham,370379
Chatham,8290,4026,0.48564535585,1785,0.215319662244,110,0.0132689987937,30,0.00361881785283,2077,0.250542822678,262,0.0316043425814,1921,155,145,1911,2066,136,0.0164053075995,1921,0.231724969843,3349,0.403980699638,4941,0.596019300362,3004,0.362364294331,ESC114,Chatham,37037ESC114
Chatham,5464,4713,0.862554904832,428,0.0783308931186,16,0.00292825768668,91,0.016654465593,108,0.0197657393851,108,0.0197657393851,476,39,37,474,513,48,0.00878477306003,476,0.0871156661786,244,0.0446559297218,5220,0.955344070278,4583,0.838762811127,MCH110,Chatham,37037MCH110
Chatham,6428,5103,0.793870566273,569,0.0885189794648,13,0.00202240199129,157,0.0244243932794,460,0.0715619166148,126,0.0196017423771,631,32,22,621,653,62,0.0096453018046,631,0.0981642812694,928,0.144368388301,5500,0.855631611699,4673,0.726975731176,NWM117,Chatham,37037NWM117
Chatham,8113,5860,0.722297547147,1755,0.216319487243,26,0.00320473314434,106,0.0130654505115,236,0.0290891162332,130,0.0160236657217,1827,67,54,1814,1881,72,0.00887464563047,1827,0.225194132873,481,0.0592875631702,7632,0.94071243683,5659,0.697522494761,PIT113,Chatham,37037PIT113
Cherokee,2311,2105,0.910861099091,20,0.00865426222415,18,0.00778883600173,16,0.00692340977932,65,0.0281263522285,87,0.037646040675,33,89,86,30,119,13,0.00562527044569,33,0.0142795326698,126,0.0545218520121,2185,0.945478147988,2067,0.894418000865,ANNW,Cherokee,37039ANNW
Cherokee,2306,2117,0.918039895924,44,0.01908065915,20,0.00867302688638,3,0.00130095403296,28,0.0121422376409,94,0.040763226366,69,75,72,66,141,25,0.010841283608,69,0.029921942758,77,0.0333911535126,2229,0.966608846487,2088,0.905464006938,ANSW,Cherokee,37039ANSW
Cherokee,1342,1271,0.947093889717,1,0.000745156482861,37,0.0275707898659,4,0.00298062593145,2,0.00149031296572,27,0.0201192250373,3,63,62,2,65,2,0.00149031296572,3,0.00223546944858,27,0.0201192250373,1315,0.979880774963,1251,0.93219076006,BEAV,Cherokee,37039BEAV
Cherokee,1344,1287,0.957589285714,8,0.00595238095238,5,0.00372023809524,8,0.00595238095238,7,0.00520833333333,29,0.0215773809524,15,28,27,14,42,7,0.00520833333333,15,0.0111607142857,38,0.0282738095238,1306,0.971726190476,1256,0.934523809524,BELL,Cherokee,37039BELL
Cherokee,793,742,0.935687263556,4,0.00504413619168,10,0.0126103404792,11,0.0138713745271,8,0.0100882723834,18,0.0226986128625,9,22,22,9,31,5,0.0063051702396,9,0.0113493064313,20,0.0252206809584,773,0.974779319042,736,0.928121059269,BRAS,Cherokee,37039BRAS
Cherokee,940,903,0.960638297872,1,0.00106382978723,11,0.0117021276596,2,0.00212765957447,1,0.00106382978723,22,0.0234042553191,8,31,24,1,32,7,0.00744680851064,8,0.00851063829787,16,0.0170212765957,924,0.982978723404,890,0.946808510638,HANG,Cherokee,37039HANG
Cherokee,2290,2217,0.968122270742,5,0.00218340611354,28,0.0122270742358,2,0.000873362445415,3,0.00131004366812,35,0.0152838427948,7,60,60,7,67,2,0.000873362445415,7,0.00305676855895,30,0.0131004366812,2260,0.986899563319,2194,0.95807860262,HIWA,Cherokee,37039HIWA
Cherokee,1591,1534,0.964173475801,10,0.00628535512256,4,0.00251414204903,2,0.00125707102451,6,0.00377121307354,35,0.021998742929,14,26,26,14,40,4,0.00251414204903,14,0.00879949717159,28,0.0175989943432,1563,0.982401005657,1515,0.952231301069,HOTH,Cherokee,37039HOTH
Cherokee,1964,1845,0.939409368635,22,0.0112016293279,32,0.0162932790224,8,0.0040733197556,9,0.00458248472505,48,0.0244399185336,27,74,69,22,96,5,0.00254582484725,27,0.0137474541752,30,0.0152749490835,1934,0.984725050916,1837,0.93533604888,MARB,Cherokee,37039MARB
Cherokee,2871,2506,0.872866597005,161,0.0560780215953,78,0.0271682340648,22,0.00766283524904,27,0.00940438871473,77,0.0268199233716,201,109,108,200,309,40,0.0139324277255,201,0.0700104493208,66,0.0229885057471,2805,0.977011494253,2470,0.860327412052,MURN,Cherokee,37039MURN
Cherokee,3015,2806,0.930679933665,39,0.0129353233831,59,0.0195688225539,42,0.0139303482587,15,0.00497512437811,54,0.0179104477612,47,87,87,47,134,8,0.00265339966833,47,0.0155887230514,74,0.024543946932,2941,0.975456053068,2763,0.916417910448,MURS,Cherokee,37039MURS
Cherokee,3055,2905,0.950900163666,13,0.00425531914894,25,0.00818330605565,17,0.00556464811784,15,0.00490998363339,80,0.0261865793781,19,91,91,19,110,6,0.00196399345336,19,0.00621931260229,56,0.0183306055646,2999,0.981669394435,2872,0.940098199673,NOTL,Cherokee,37039NOTL
Cherokee,2978,2839,0.953324378778,17,0.00570852921424,35,0.0117528542646,4,0.00134318334453,28,0.00940228341169,55,0.0184687709872,38,67,62,33,100,21,0.00705171255876,38,0.012760241773,95,0.0319006044325,2883,0.968099395567,2781,0.933848220282,PCHT,Cherokee,37039PCHT
Cherokee,644,623,0.967391304348,5,0.00776397515528,1,0.00155279503106,0,0.0,1,0.00155279503106,14,0.0217391304348,8,10,10,8,18,3,0.00465838509317,8,0.0124223602484,5,0.00776397515528,639,0.992236024845,621,0.964285714286,TOPT,Cherokee,37039TOPT
Chowan,3253,1304,0.400860743929,1801,0.55364279127,3,0.000922225637873,16,0.00491853673532,92,0.0282815862281,37,0.0113741162004,1829,12,12,1829,1841,28,0.00860743928681,1829,0.562250230556,121,0.0371964340609,3132,0.962803565939,1287,0.395634798647,1,Chowan,370411
Chowan,4478,2478,0.55337204109,1866,0.416703885663,15,0.00334970969183,26,0.00580616346583,37,0.00826261723984,56,0.0125055828495,1890,33,26,1883,1916,24,0.00535953550692,1890,0.42206342117,85,0.0189816882537,4393,0.981018311746,2453,0.547789191603,2,Chowan,370412
Chowan,2338,2148,0.91873396065,100,0.0427715996578,12,0.00513259195894,3,0.00128314798973,49,0.0209580838323,26,0.011120615911,110,24,22,108,132,10,0.00427715996578,110,0.0470487596236,109,0.046621043627,2229,0.953378956373,2101,0.898631308811,3,Chowan,370413
Chowan,1306,688,0.526799387443,559,0.428024502297,7,0.00535987748851,3,0.00229709035222,20,0.0153139356815,29,0.0222052067381,576,14,9,571,585,17,0.0130168453292,576,0.441041347626,33,0.0252679938744,1273,0.974732006126,682,0.522205206738,4,Chowan,370414
Chowan,1333,1018,0.763690922731,245,0.183795948987,2,0.00150037509377,9,0.00675168792198,40,0.0300075018755,19,0.0142535633908,254,6,6,254,260,9,0.00675168792198,254,0.190547636909,73,0.0547636909227,1260,0.945236309077,996,0.747186796699,5,Chowan,370415
Chowan,2085,1538,0.737649880096,499,0.23932853717,4,0.00191846522782,2,0.000959232613909,28,0.0134292565947,14,0.00671462829736,505,10,10,505,515,6,0.00287769784173,505,0.242206235012,46,0.0220623501199,2039,0.97793764988,1521,0.729496402878,6,Chowan,370416
Clay,1055,1033,0.979146919431,3,0.00284360189573,4,0.00379146919431,1,0.000947867298578,5,0.00473933649289,9,0.0085308056872,5,7,7,5,12,2,0.00189573459716,5,0.00473933649289,23,0.0218009478673,1032,0.978199052133,1019,0.965876777251,BRAS,Clay,37043BRAS
Clay,1393,1338,0.960516870065,15,0.010768126346,3,0.0021536252692,0,0.0,6,0.00430725053841,31,0.0222541277818,24,25,25,24,49,9,0.00646087580761,24,0.0172290021536,33,0.0236898779612,1360,0.976310122039,1311,0.941134242642,HAY1,Clay,37043HAY1
Clay,1802,1732,0.96115427303,11,0.00610432852386,9,0.00499445061043,5,0.00277469478357,30,0.0166481687014,15,0.00832408435072,16,17,17,16,33,5,0.00277469478357,16,0.00887902330744,58,0.0321864594895,1744,0.967813540511,1707,0.947280799112,HAY2,Clay,37043HAY2
Clay,673,649,0.964338781575,3,0.00445765230312,5,0.0074294205052,0,0.0,8,0.0118870728083,8,0.0118870728083,3,11,11,3,14,0,0.0,3,0.00445765230312,13,0.0193164933135,660,0.980683506686,644,0.95690936107,HAYC,Clay,37043HAYC
Clay,1578,1541,0.976552598226,9,0.00570342205323,3,0.00190114068441,4,0.00253485424588,0,0.0,21,0.0133079847909,14,13,12,13,26,5,0.00316856780735,14,0.00887198986058,50,0.0316856780735,1528,0.968314321926,1495,0.947401774398,HIAW,Clay,37043HIAW
Clay,1513,1461,0.965631196299,5,0.00330469266358,3,0.00198281559815,9,0.00594844679445,16,0.0105750165235,19,0.0125578321216,8,12,12,8,20,3,0.00198281559815,8,0.00528750826173,29,0.0191672174488,1484,0.980832782551,1451,0.959021810972,SHCR,Clay,37043SHCR
Clay,850,821,0.965882352941,11,0.0129411764706,1,0.00117647058824,1,0.00117647058824,1,0.00117647058824,15,0.0176470588235,15,11,11,15,26,4,0.00470588235294,15,0.0176470588235,15,0.0176470588235,835,0.982352941176,811,0.954117647059,SWEE,Clay,37043SWEE
Clay,764,739,0.967277486911,1,0.00130890052356,1,0.00130890052356,1,0.00130890052356,14,0.0183246073298,8,0.0104712041885,5,3,3,5,8,4,0.00523560209424,5,0.0065445026178,20,0.0261780104712,744,0.973821989529,737,0.964659685864,TUSQ,Clay,37043TUSQ
Clay,959,917,0.956204379562,6,0.00625651720542,3,0.00312825860271,5,0.00521376433785,1,0.00104275286757,27,0.0281543274244,16,9,9,16,25,10,0.0104275286757,16,0.0166840458811,17,0.0177267987487,942,0.982273201251,905,0.943691345151,WARN,Clay,37043WARN
Cleveland,2599,2221,0.854559445941,260,0.100038476337,7,0.00269334359369,44,0.0169295883032,25,0.00961908426318,42,0.0161600615621,282,22,19,279,301,22,0.0084647941516,282,0.108503270489,82,0.0315505963832,2517,0.968449403617,2167,0.833782223932,BETHWR,Cleveland,37045BETHWR
Cleveland,6475,5500,0.849420849421,789,0.121853281853,9,0.00138996138996,33,0.00509652509653,46,0.00710424710425,98,0.0151351351351,855,30,23,848,878,66,0.0101930501931,855,0.132046332046,134,0.020694980695,6341,0.979305019305,5425,0.837837837838,BSPGS,Cleveland,37045BSPGS
Cleveland,1799,1770,0.983879933296,4,0.00222345747638,5,0.00277932184547,7,0.00389105058366,4,0.00222345747638,9,0.00500277932185,11,6,6,11,17,7,0.00389105058366,11,0.00611450806003,18,0.0100055586437,1781,0.989994441356,1759,0.977765425236,CASAR,Cleveland,37045CASAR
Cleveland,2380,2235,0.939075630252,98,0.0411764705882,6,0.00252100840336,7,0.00294117647059,14,0.00588235294118,20,0.00840336134454,112,13,9,108,121,14,0.00588235294118,112,0.0470588235294,31,0.013025210084,2349,0.986974789916,2216,0.931092436975,FALSTN,Cleveland,37045FALSTN
Cleveland,5080,4101,0.807283464567,674,0.132677165354,17,0.00334645669291,110,0.0216535433071,71,0.0139763779528,107,0.021062992126,732,35,34,731,766,58,0.0114173228346,732,0.144094488189,163,0.0320866141732,4917,0.967913385827,4030,0.793307086614,GROVER,Cleveland,37045GROVER
Cleveland,1082,1007,0.930683918669,51,0.047134935305,3,0.00277264325323,1,0.000924214417745,10,0.00924214417745,10,0.00924214417745,58,8,6,56,64,7,0.00646950092421,58,0.0536044362292,18,0.0166358595194,1064,0.983364140481,999,0.923290203327,H-SPGS,Cleveland,37045H-SPGS
Cleveland,1198,504,0.420701168614,656,0.547579298831,2,0.0016694490818,15,0.0125208681135,8,0.00667779632721,13,0.0108514190317,667,6,4,665,671,11,0.00918196994992,667,0.556761268781,16,0.0133555926544,1182,0.986644407346,499,0.41652754591,KINGST,Cleveland,37045KINGST
Cleveland,3777,2892,0.765687053217,760,0.201217897802,7,0.00185332274292,30,0.00794281175536,19,0.00503044744506,69,0.0182684670373,810,27,17,800,827,50,0.0132380195923,810,0.214455917395,43,0.0113846968494,3734,0.988615303151,2873,0.760656605772,KM1,Cleveland,37045KM1
Cleveland,3379,2522,0.746374667061,770,0.227878070435,4,0.00118378218408,26,0.00769458419651,18,0.00532701982835,39,0.0115418762948,797,9,8,796,805,27,0.00799052974253,797,0.235868600178,52,0.015389168393,3327,0.984610831607,2487,0.736016572951,KM2,Cleveland,37045KM2
Cleveland,3886,3018,0.776634071024,595,0.153113741637,8,0.00205867215646,157,0.0404014410705,43,0.011065362841,65,0.0167267112712,627,15,13,625,640,32,0.00823468862584,627,0.161348430262,108,0.0277920741122,3778,0.972207925888,2967,0.763510036027,KM3,Cleveland,37045KM3
Cleveland,2157,1522,0.705609643023,543,0.25173852573,9,0.00417246175243,5,0.00231803430691,29,0.0134445989801,49,0.0227167362077,573,28,22,567,595,30,0.0139082058414,573,0.265646731572,59,0.0273528048215,2098,0.972647195178,1500,0.695410292072,KM4,Cleveland,37045KM4
Cleveland,4571,3944,0.862830890396,435,0.0951651717349,6,0.00131262305841,14,0.00306278713629,92,0.0201268868956,80,0.0175016407788,484,29,24,479,508,49,0.010719754977,484,0.105884926712,240,0.0525049223365,4331,0.947495077664,3811,0.833734412601,LATT,Cleveland,37045LATT
Cleveland,2589,1711,0.660872923909,794,0.306682116647,4,0.00154499806875,1,0.000386249517188,48,0.018539976825,31,0.0119737350328,805,22,18,801,823,11,0.00424874468907,805,0.310930861336,70,0.0270374662032,2519,0.972962533797,1697,0.655465430668,LAWNDL,Cleveland,37045LAWNDL
Cleveland,2215,1963,0.886230248307,210,0.0948081264108,4,0.00180586907449,4,0.00180586907449,23,0.0103837471783,11,0.00496613995485,217,7,6,216,223,7,0.00316027088036,217,0.0979683972912,35,0.0158013544018,2180,0.984198645598,1952,0.881264108352,MRB-YO,Cleveland,37045MRB-YO
Cleveland,3206,3052,0.951965065502,74,0.0230817217717,10,0.00311915159077,6,0.00187149095446,43,0.0134123518403,21,0.00655021834061,83,13,12,82,95,9,0.00280723643169,83,0.0258889582034,130,0.04054897068,3076,0.95945102932,2971,0.926699937617,MULLS,Cleveland,37045MULLS
Cleveland,5040,4499,0.892658730159,296,0.0587301587302,7,0.00138888888889,49,0.00972222222222,83,0.0164682539683,106,0.0210317460317,347,31,28,344,375,51,0.010119047619,347,0.0688492063492,158,0.0313492063492,4882,0.968650793651,4444,0.881746031746,OAKGR,Cleveland,37045OAKGR
Cleveland,3513,3269,0.930543694848,154,0.0438371762027,6,0.00170794192997,11,0.00313122687162,47,0.0133788784515,26,0.00740108169656,165,13,11,163,176,11,0.00313122687162,165,0.0469684030743,110,0.0313122687162,3403,0.968687731284,3209,0.913464275548,POLKVL,Cleveland,37045POLKVL
Cleveland,5908,4464,0.755585646581,1265,0.214116452268,12,0.00203114421124,12,0.00203114421124,60,0.0101557210562,95,0.0160798916723,1307,43,42,1306,1349,42,0.00710900473934,1307,0.221225457007,132,0.0223425863236,5776,0.977657413676,4409,0.746276235613,RIPPY,Cleveland,37045RIPPY
Cleveland,2798,1306,0.466761972838,1399,0.5,9,0.00321658327377,8,0.00285918513224,35,0.0125089349535,41,0.0146533238027,1425,18,15,1422,1440,26,0.00929235167977,1425,0.50929235168,60,0.0214438884918,2738,0.978556111508,1287,0.459971408149,S1,Cleveland,37045S1
Cleveland,4285,2896,0.675845974329,1252,0.292182030338,14,0.00326721120187,36,0.00840140023337,38,0.00886814469078,49,0.0114352392065,1281,27,21,1275,1302,29,0.00676779463244,1281,0.298949824971,122,0.028471411902,4163,0.971528588098,2820,0.658109684947,S2,Cleveland,37045S2
Cleveland,2904,1555,0.535468319559,1244,0.428374655647,11,0.00378787878788,24,0.00826446280992,20,0.0068870523416,50,0.017217630854,1279,27,20,1272,1299,35,0.0120523415978,1279,0.440426997245,99,0.0340909090909,2805,0.965909090909,1481,0.509986225895,S3,Cleveland,37045S3
Cleveland,3320,1710,0.515060240964,1517,0.456927710843,8,0.00240963855422,6,0.00180722891566,24,0.00722891566265,55,0.0165662650602,1549,34,23,1538,1572,32,0.00963855421687,1549,0.46656626506,116,0.0349397590361,3204,0.965060240964,1649,0.496686746988,S4,Cleveland,37045S4
Cleveland,3396,2212,0.651354534747,1081,0.318315665489,7,0.00206124852768,23,0.0067726737338,42,0.0123674911661,31,0.00912838633687,1105,9,9,1105,1114,24,0.00706713780919,1105,0.325382803298,107,0.031507656066,3289,0.968492343934,2149,0.632803297998,S5,Cleveland,37045S5
Cleveland,4743,2907,0.612903225806,1626,0.342820999367,13,0.00274088129876,21,0.00442757748261,65,0.0137044064938,111,0.0234029095509,1702,40,32,1694,1734,76,0.0160236137466,1702,0.358844613114,163,0.0343664347459,4580,0.965633565254,2836,0.597933797175,S6,Cleveland,37045S6
Cleveland,3801,2494,0.656143120232,1127,0.29650092081,12,0.00315706393054,54,0.0142067876875,49,0.0128913443831,65,0.0171007629571,1179,20,16,1175,1195,52,0.0136806103657,1179,0.310181531176,139,0.0365693238621,3662,0.963430676138,2434,0.640357800579,S7,Cleveland,37045S7
Cleveland,3299,2132,0.646256441346,997,0.302212791755,10,0.0030312215823,24,0.00727493179751,70,0.0212185510761,66,0.0200060624432,1036,30,24,1030,1060,39,0.011821764171,1036,0.314034555926,141,0.0427402243104,3158,0.95725977569,2084,0.631706577751,S8,Cleveland,37045S8
Cleveland,3846,3117,0.810452418097,645,0.167706708268,8,0.00208008320333,9,0.00234009360374,11,0.00286011440458,56,0.0145605824233,683,34,19,668,702,38,0.00988039521581,683,0.177587103484,52,0.0135205408216,3794,0.986479459178,3091,0.803692147686,SHANGI,Cleveland,37045SHANGI
Cleveland,4832,3600,0.745033112583,1016,0.210264900662,14,0.00289735099338,43,0.00889900662252,94,0.0194536423841,65,0.013451986755,1049,33,29,1045,1078,33,0.00682947019868,1049,0.217094370861,158,0.0326986754967,4674,0.967301324503,3547,0.734064569536,WACO,Cleveland,37045WACO
Columbus,2729,1759,0.644558446317,735,0.269329424698,84,0.0307805056797,20,0.00732869182851,87,0.031879809454,44,0.0161231220227,757,114,102,745,859,22,0.00806156101136,757,0.277390985709,123,0.0450714547453,2606,0.954928545255,1740,0.63759618908,P01,Columbus,37047P01
Columbus,1611,467,0.289882060832,662,0.410924891372,409,0.253879577902,3,0.00186219739292,16,0.00993171942893,54,0.0335195530726,691,448,427,670,1118,29,0.0180012414649,691,0.428926132837,52,0.032278088144,1559,0.967721911856,441,0.27374301676,P02,Columbus,37047P02
Columbus,1048,697,0.665076335878,150,0.143129770992,8,0.00763358778626,6,0.00572519083969,160,0.152671755725,27,0.0257633587786,151,23,23,151,174,1,0.000954198473282,151,0.144083969466,187,0.178435114504,861,0.821564885496,676,0.645038167939,P03,Columbus,37047P03
Columbus,727,344,0.473177441541,293,0.403026134801,2,0.00275103163686,0,0.0,71,0.0976616231087,17,0.0233837689133,304,2,2,304,306,11,0.0151306740028,304,0.418156808803,85,0.116918844567,642,0.883081155433,344,0.473177441541,P04,Columbus,37047P04
Columbus,651,509,0.781874039939,68,0.1044546851,0,0.0,0,0.0,72,0.110599078341,2,0.00307219662058,68,1,1,68,69,0,0.0,68,0.1044546851,86,0.132104454685,565,0.867895545315,495,0.760368663594,P05,Columbus,37047P05
Columbus,1461,1072,0.733744010951,292,0.199863107461,24,0.0164271047228,1,0.000684462696783,42,0.0287474332649,30,0.0205338809035,307,36,32,303,339,15,0.0102669404517,307,0.210130047912,72,0.0492813141684,1389,0.950718685832,1043,0.713894592745,P06,Columbus,37047P06
Columbus,4861,2590,0.532812178564,2052,0.422135363094,100,0.0205718987863,8,0.0016457519029,64,0.0131660152232,47,0.00966879242954,2078,125,119,2072,2197,26,0.00534869368443,2078,0.427484056778,141,0.0290063772886,4720,0.970993622711,2548,0.524171981074,P07,Columbus,37047P07
Columbus,691,636,0.920405209841,18,0.0260492040521,10,0.0144717800289,0,0.0,20,0.0289435600579,7,0.0101302460203,20,14,14,20,34,2,0.00289435600579,20,0.0289435600579,33,0.0477568740955,658,0.952243125904,624,0.903039073806,P08,Columbus,37047P08
Columbus,1772,939,0.529909706546,737,0.415914221219,6,0.00338600451467,0,0.0,68,0.038374717833,22,0.0124153498871,748,15,13,746,761,11,0.00620767494357,748,0.422121896163,78,0.0440180586907,1694,0.955981941309,931,0.52539503386,P09,Columbus,37047P09
Columbus,1339,1260,0.941000746826,20,0.0149365197909,12,0.00896191187453,1,0.000746825989544,39,0.0291262135922,7,0.00522778192681,21,15,15,21,36,1,0.000746825989544,21,0.0156833457804,56,0.0418222554145,1283,0.958177744586,1245,0.929798356983,P10,Columbus,37047P10
Columbus,2034,1298,0.638151425762,570,0.280235988201,44,0.0216322517207,11,0.00540806293019,89,0.0437561455261,22,0.0108161258604,581,50,48,579,629,11,0.00540806293019,581,0.285644051131,130,0.0639134709931,1904,0.936086529007,1262,0.620452310718,P11,Columbus,37047P11
Columbus,334,328,0.982035928144,3,0.00898203592814,1,0.00299401197605,0,0.0,0,0.0,2,0.0059880239521,3,2,2,3,5,0,0.0,3,0.00898203592814,0,0.0,334,1.0,328,0.982035928144,P12,Columbus,37047P12
Columbus,1147,908,0.791630340017,64,0.0557977332171,5,0.00435919790759,0,0.0,158,0.13775065388,12,0.0104620749782,65,9,9,65,74,1,0.000871839581517,65,0.0566695727986,217,0.189189189189,930,0.810810810811,859,0.748910200523,P13,Columbus,37047P13
Columbus,4809,2830,0.588479933458,1615,0.335828654606,75,0.0155957579538,9,0.00187149095446,203,0.0422125181951,77,0.0160116448326,1658,124,100,1634,1758,43,0.00894156789353,1658,0.344770222499,329,0.0684133915575,4480,0.931586608443,2747,0.571220627989,P14,Columbus,37047P14
Columbus,3258,1965,0.603130755064,1210,0.37139349294,39,0.01197053407,1,0.000306936771025,14,0.00429711479435,29,0.00890116635973,1230,51,46,1225,1276,20,0.0061387354205,1230,0.377532228361,32,0.00982197667281,3226,0.990178023327,1953,0.599447513812,P15,Columbus,37047P15
Columbus,2175,1166,0.536091954023,323,0.148505747126,610,0.280459770115,1,0.000459770114943,31,0.0142528735632,44,0.0202298850575,340,647,636,329,976,17,0.00781609195402,340,0.15632183908,49,0.0225287356322,2126,0.977471264368,1161,0.533793103448,P16,Columbus,37047P16
Columbus,1778,692,0.389201349831,831,0.467379077615,119,0.0669291338583,2,0.00112485939258,71,0.0399325084364,63,0.0354330708661,877,171,133,839,1010,46,0.0258717660292,877,0.493250843645,105,0.0590551181102,1673,0.94094488189,656,0.368953880765,P17,Columbus,37047P17
Columbus,843,520,0.61684460261,272,0.32265717675,21,0.0249110320285,0,0.0,19,0.0225385527877,11,0.0130486358244,277,29,26,274,303,5,0.00593119810202,277,0.328588374852,28,0.0332147093713,815,0.966785290629,511,0.606168446026,P18,Columbus,37047P18
Columbus,3743,2224,0.594175794817,1357,0.362543414373,42,0.0112209457654,34,0.00908362276249,42,0.0112209457654,44,0.0117552765162,1390,54,45,1381,1435,33,0.00881645738712,1390,0.371359871761,85,0.0227090569062,3658,0.977290943094,2197,0.586962329682,P19,Columbus,37047P19
Columbus,1632,629,0.385416666667,852,0.522058823529,26,0.015931372549,10,0.00612745098039,67,0.0410539215686,48,0.0294117647059,883,61,41,863,924,31,0.0189950980392,883,0.541053921569,94,0.0575980392157,1538,0.942401960784,610,0.373774509804,P20,Columbus,37047P20
Columbus,1502,1059,0.705059920107,341,0.227030625832,22,0.0146471371505,8,0.00532623169108,47,0.0312916111851,25,0.0166444740346,357,38,25,344,382,16,0.0106524633822,357,0.237683089214,53,0.0352862849534,1449,0.964713715047,1056,0.703062583222,P21,Columbus,37047P21
Columbus,3388,2345,0.692148760331,772,0.227863046045,38,0.0112160566706,16,0.0047225501771,158,0.0466351829988,59,0.017414403778,798,67,59,790,857,26,0.00767414403778,798,0.235537190083,257,0.0758559622196,3131,0.92414403778,2275,0.671487603306,P22,Columbus,37047P22
Columbus,2964,1750,0.590418353576,1081,0.364709851552,45,0.0151821862348,16,0.00539811066127,24,0.0080971659919,48,0.0161943319838,1115,74,58,1099,1173,34,0.0114709851552,1115,0.376180836707,64,0.0215924426451,2900,0.978407557355,1719,0.57995951417,P23,Columbus,37047P23
Columbus,3018,2589,0.857852882704,324,0.107355864811,14,0.00463883366468,4,0.00132538104705,55,0.018223989397,32,0.0106030483764,333,24,22,331,355,9,0.00298210735586,333,0.110337972167,110,0.0364479787939,2908,0.963552021206,2546,0.843605036448,P24,Columbus,37047P24
Columbus,2077,1916,0.922484352431,107,0.0515166104959,15,0.00722195474242,2,0.000962927298989,15,0.00722195474242,22,0.0105922002889,112,24,24,112,136,5,0.00240731824747,112,0.0539239287434,34,0.0163697640828,2043,0.983630235917,1904,0.916706788637,P25,Columbus,37047P25
Columbus,6506,3243,0.49846295727,2964,0.455579465109,74,0.0113741162004,28,0.00430371964341,118,0.0181371042115,79,0.0121426375653,2998,121,104,2981,3102,34,0.00522594528128,2998,0.46080541039,162,0.0249000922226,6344,0.975099907777,3197,0.491392560713,P26,Columbus,37047P26
Craven,4155,3991,0.960529482551,80,0.0192539109507,8,0.00192539109507,24,0.0057761732852,9,0.00216606498195,43,0.010348977136,90,18,18,90,108,10,0.00240673886883,90,0.0216606498195,59,0.0141997593261,4096,0.985800240674,3943,0.948977135981,03,Craven,3704903
Craven,1122,753,0.671122994652,319,0.28431372549,11,0.00980392156863,13,0.0115864527629,1,0.000891265597148,25,0.0222816399287,340,23,12,329,352,21,0.0187165775401,340,0.30303030303,33,0.0294117647059,1089,0.970588235294,729,0.649732620321,04,Craven,3704904
Craven,3119,2752,0.882334081436,269,0.0862455915357,12,0.00384738698301,33,0.0105803142033,11,0.00352677140109,42,0.0134658544405,294,25,20,289,314,25,0.00801538954793,294,0.0942609810837,80,0.0256492465534,3039,0.974350753447,2696,0.864379608849,05,Craven,3704905
Craven,1808,1009,0.558075221239,710,0.392699115044,7,0.00387168141593,26,0.0143805309735,23,0.0127212389381,33,0.0182522123894,724,21,18,721,742,14,0.00774336283186,724,0.400442477876,71,0.0392699115044,1737,0.960730088496,977,0.540376106195,06,Craven,3704906
Craven,3396,2116,0.62308598351,1140,0.335689045936,18,0.00530035335689,9,0.00265017667845,56,0.0164899882214,57,0.0167844522968,1170,35,31,1166,1201,30,0.00883392226148,1170,0.344522968198,116,0.0341578327444,3280,0.965842167256,2072,0.610129564193,07,Craven,3704907
Craven,1257,780,0.620525059666,420,0.334128878282,2,0.00159108989658,5,0.00397772474145,20,0.0159108989658,30,0.0238663484487,430,8,8,430,438,10,0.0079554494829,430,0.342084327765,41,0.0326173428799,1216,0.96738265712,775,0.616547334924,08,Craven,3704908
Craven,782,416,0.531969309463,353,0.451406649616,3,0.00383631713555,4,0.00511508951407,0,0.0,6,0.0076726342711,356,5,5,356,361,3,0.00383631713555,356,0.455242966752,4,0.00511508951407,778,0.994884910486,414,0.529411764706,09,Craven,3704909
Craven,1423,916,0.643710470836,386,0.271257905833,4,0.00281096275474,9,0.00632466619817,93,0.0653548840478,15,0.0105411103303,394,7,5,392,399,8,0.00562192550949,394,0.276879831342,139,0.0976809557273,1284,0.902319044273,878,0.617006324666,10,Craven,3704910
Craven,4402,3787,0.86029077692,363,0.0824625170377,23,0.00522489777374,27,0.00613357564743,111,0.025215810995,91,0.0206724216265,395,57,51,389,446,32,0.00726942298955,395,0.0897319400273,232,0.0527033166742,4170,0.947296683326,3696,0.839618355293,11,Craven,3704911
Craven,717,660,0.92050209205,31,0.0432357043236,5,0.00697350069735,4,0.00557880055788,10,0.0139470013947,7,0.00976290097629,34,8,8,34,42,3,0.00418410041841,34,0.047419804742,33,0.0460251046025,684,0.953974895397,642,0.89539748954,12,Craven,3704912
Craven,1073,907,0.845293569432,123,0.114631873253,9,0.00838769804287,2,0.00186393289842,18,0.0167753960857,14,0.0130475302889,130,13,13,130,143,7,0.00652376514445,130,0.121155638397,27,0.0251630941286,1046,0.974836905871,899,0.837837837838,13,Craven,3704913
Craven,6118,3739,0.611147433802,2037,0.33295194508,50,0.00817260542661,14,0.00228832951945,129,0.0210853220007,149,0.0243543641713,2131,104,75,2102,2206,94,0.015364498202,2131,0.348316443282,275,0.0449493298464,5843,0.955050670154,3621,0.591860084995,14,Craven,3704914
Craven,1465,1018,0.694880546075,386,0.263481228669,6,0.00409556313993,3,0.00204778156997,28,0.0191126279863,24,0.0163822525597,394,16,16,394,410,8,0.00546075085324,394,0.268941979522,90,0.061433447099,1375,0.938566552901,962,0.656655290102,15,Craven,3704915
Craven,5449,4547,0.834465039457,576,0.10570746926,20,0.00367039823821,56,0.010277115067,96,0.0176179115434,154,0.0282620664342,636,69,55,622,691,60,0.0110111947146,636,0.116718663975,278,0.0510185355111,5171,0.948981464489,4410,0.809322811525,16,Craven,3704916
Craven,2967,2504,0.843950117964,243,0.0819009100101,10,0.00337040781935,79,0.0266262217728,36,0.0121334681496,95,0.0320188742838,283,39,26,270,309,40,0.0134816312774,283,0.0953825412875,178,0.0599932591844,2789,0.940006740816,2379,0.801820020222,17,Craven,3704917
Craven,8442,5332,0.631603885335,2043,0.242004264392,61,0.00722577588249,315,0.0373134328358,263,0.0311537550344,428,0.0506988865198,2278,122,97,2253,2375,235,0.0278370054489,2278,0.269841269841,757,0.0896706941483,7685,0.910329305852,4971,0.588841506752,18,Craven,3704918
Craven,3836,2177,0.567518248175,1434,0.373826903024,18,0.00469238790407,38,0.00990615224192,35,0.00912408759124,134,0.0349322210636,1513,62,41,1492,1554,79,0.0205943691345,1513,0.394421272158,137,0.0357142857143,3699,0.964285714286,2096,0.546402502607,19,Craven,3704919
Craven,3576,3354,0.937919463087,140,0.0391498881432,4,0.00111856823266,21,0.00587248322148,21,0.00587248322148,36,0.010067114094,160,7,7,160,167,20,0.00559284116331,160,0.0447427293065,74,0.0206935123043,3502,0.979306487696,3308,0.925055928412,20,Craven,3704920
Craven,3093,2745,0.887487875849,263,0.0850307145167,1,0.000323310701584,23,0.00743614613644,2,0.000646621403168,59,0.0190753313935,289,12,11,288,300,26,0.00840607824119,289,0.0934367927578,46,0.0148722922729,3047,0.985127707727,2711,0.876495311995,21,Craven,3704921
Craven,13989,10491,0.749946386446,1795,0.128315104725,109,0.00779183644292,409,0.0292372578454,596,0.042604903853,589,0.042104510687,2060,217,187,2030,2247,265,0.0189434555722,2060,0.147258560297,1760,0.125813138895,12229,0.874186861105,9557,0.683179641147,22,Craven,3704922
Craven,5655,4576,0.809195402299,708,0.125198938992,23,0.00406719717065,124,0.0219274977896,109,0.0192749778957,115,0.0203359858532,753,48,35,740,788,45,0.0079575596817,753,0.133156498674,316,0.0558797524315,5339,0.944120247569,4402,0.77842617153,23,Craven,3704923
Craven,3294,1531,0.464784456588,1567,0.475713418336,7,0.00212507589557,91,0.0276259866424,40,0.0121432908318,58,0.0176077717061,1601,23,12,1590,1613,34,0.010321797207,1601,0.486035215543,103,0.0312689738919,3191,0.968731026108,1494,0.453551912568,N1,Craven,37049N1
Craven,3648,1050,0.287828947368,2435,0.667489035088,14,0.00383771929825,31,0.00849780701754,43,0.0117872807018,75,0.0205592105263,2493,37,18,2474,2511,58,0.015899122807,2493,0.683388157895,101,0.0276864035088,3547,0.972313596491,1016,0.27850877193,N2,Craven,37049N2
Craven,2862,1978,0.691125087352,634,0.221523410203,14,0.00489168413697,130,0.0454227812718,37,0.012928022362,69,0.0241090146751,670,35,30,665,700,36,0.0125786163522,670,0.234102026555,114,0.0398322851153,2748,0.960167714885,1920,0.670859538784,N3,Craven,37049N3
Craven,6831,3604,0.527594788464,2219,0.32484262919,35,0.00512370077587,259,0.0379153857415,438,0.0641194554238,276,0.040404040404,2344,91,75,2328,2419,125,0.0182989313424,2344,0.343141560533,871,0.127506953594,5960,0.872493046406,3299,0.482945395989,N4,Craven,37049N4
Craven,3192,1357,0.425125313283,1530,0.479323308271,16,0.00501253132832,171,0.0535714285714,67,0.0209899749373,51,0.015977443609,1559,35,24,1548,1583,29,0.00908521303258,1559,0.488408521303,134,0.0419799498747,3058,0.958020050125,1310,0.410401002506,N5,Craven,37049N5
Craven,5834,4351,0.745800479945,989,0.169523483031,14,0.00239972574563,314,0.0538224202948,69,0.0118272197463,97,0.0166266712376,1041,39,30,1032,1071,52,0.00891326705519,1041,0.178436750086,203,0.0347960233116,5631,0.965203976688,4248,0.728145354817,N6,Craven,37049N6
Cumberland,5358,2152,0.401642403882,2522,0.47069802165,55,0.0102650242628,138,0.0257558790594,186,0.0347144456887,305,0.0569242254573,2683,129,92,2646,2775,161,0.0300485255692,2683,0.500746547219,619,0.115528182158,4739,0.884471817842,1886,0.351997013811,AH49,Cumberland,37051AH49
Cumberland,5963,4453,0.746771759182,1011,0.169545530773,245,0.0410867013248,34,0.00570182793896,52,0.00872044273017,168,0.0281737380513,1081,344,315,1052,1396,70,0.0117390575214,1081,0.181284588294,227,0.0380680865336,5736,0.961931913466,4327,0.725641455643,AL51,Cumberland,37051AL51
Cumberland,3227,713,0.220948249148,2335,0.723582274558,59,0.018283235203,45,0.013944840409,13,0.0040285094515,62,0.0192128912302,2380,79,66,2367,2446,45,0.013944840409,2380,0.737527114967,86,0.0266501394484,3141,0.973349860552,665,0.206073752711,CC01,Cumberland,37051CC01
Cumberland,2453,787,0.320831634733,1280,0.521810028536,28,0.0114145943742,63,0.025682837342,177,0.0721565430086,118,0.0481043620057,1367,59,37,1345,1404,87,0.0354667753771,1367,0.557276803914,386,0.157358336731,2067,0.842641663269,637,0.259682022014,CC03,Cumberland,37051CC03
Cumberland,1535,1153,0.751140065147,284,0.185016286645,8,0.00521172638436,23,0.014983713355,17,0.0110749185668,50,0.0325732899023,311,31,21,301,332,27,0.0175895765472,311,0.202605863192,79,0.0514657980456,1456,0.948534201954,1105,0.71986970684,CC04,Cumberland,37051CC04
Cumberland,3241,515,0.158901573588,2542,0.784325825363,17,0.00524529466214,17,0.00524529466214,57,0.0175871644554,93,0.0286948472694,2611,50,21,2582,2632,69,0.0212897253934,2611,0.805615550756,152,0.0468991052144,3089,0.953100894786,475,0.146559703795,CC05,Cumberland,37051CC05
Cumberland,1823,1284,0.704333516182,392,0.215030170049,18,0.009873834339,32,0.0175534832693,28,0.0153592978607,69,0.0378496982995,429,34,27,422,456,37,0.0202962150302,429,0.23532638508,103,0.0565002742732,1720,0.943499725727,1232,0.675809105869,CC06,Cumberland,37051CC06
Cumberland,1610,1360,0.844720496894,157,0.0975155279503,19,0.011801242236,16,0.00993788819876,19,0.011801242236,39,0.0242236024845,184,28,23,179,207,27,0.0167701863354,184,0.114285714286,69,0.0428571428571,1541,0.957142857143,1319,0.819254658385,CC07,Cumberland,37051CC07
Cumberland,1617,1265,0.78231292517,292,0.180581323438,10,0.00618429189858,27,0.0166975881262,5,0.00309214594929,18,0.0111317254174,304,16,13,301,317,12,0.00742115027829,304,0.188002473717,52,0.0321583178726,1565,0.967841682127,1223,0.756338899196,CC08,Cumberland,37051CC08
Cumberland,1857,829,0.446418955304,894,0.481421647819,11,0.00592353257943,49,0.0263866451265,28,0.0150780829295,46,0.0247711362412,930,29,14,915,944,36,0.0193861066236,930,0.500807754443,91,0.0490037695207,1766,0.950996230479,780,0.420032310178,CC10,Cumberland,37051CC10
Cumberland,2148,1938,0.902234636872,102,0.0474860335196,11,0.00512104283054,54,0.0251396648045,13,0.006052141527,30,0.0139664804469,109,20,18,107,127,7,0.00325884543762,109,0.0507448789572,99,0.0460893854749,2049,0.953910614525,1865,0.868249534451,CC12,Cumberland,37051CC12
Cumberland,3306,523,0.158197217181,2669,0.807320024198,11,0.00332728372656,6,0.00181488203267,25,0.00756200846945,72,0.021778584392,2730,42,13,2701,2743,61,0.0184513006655,2730,0.825771324864,76,0.0229885057471,3230,0.977011494253,498,0.150635208711,CC13,Cumberland,37051CC13
Cumberland,4263,2712,0.636171710063,978,0.229415904293,37,0.00867933380249,224,0.0525451559934,124,0.0290874970678,188,0.0441003987802,1079,90,57,1046,1136,101,0.0236922355149,1079,0.253108139808,366,0.0858550316678,3897,0.914144968332,2545,0.596997419658,CC14,Cumberland,37051CC14
Cumberland,3761,2690,0.715235309758,714,0.189843126828,30,0.00797660196756,155,0.0412124434991,58,0.0154214304706,114,0.0303110874767,774,55,42,761,816,60,0.0159532039351,774,0.205796330763,188,0.0499867056634,3573,0.950013294337,2594,0.689710183462,CC15,Cumberland,37051CC15
Cumberland,2415,95,0.0393374741201,2220,0.919254658385,16,0.00662525879917,2,0.000828157349896,18,0.00745341614907,64,0.0265010351967,2276,53,21,2244,2297,56,0.0231884057971,2276,0.942443064182,53,0.0219461697723,2362,0.978053830228,76,0.0314699792961,CC16,Cumberland,37051CC16
Cumberland,3822,616,0.161172161172,2957,0.77367870225,21,0.00549450549451,55,0.0143903715332,63,0.0164835164835,110,0.0287807430665,3049,59,33,3023,3082,92,0.0240711669283,3049,0.797749869178,191,0.0499738356881,3631,0.950026164312,548,0.143380429095,CC17,Cumberland,37051CC17
Cumberland,2280,1599,0.701315789474,443,0.194298245614,26,0.0114035087719,89,0.0390350877193,32,0.0140350877193,91,0.0399122807018,491,60,41,472,532,48,0.0210526315789,491,0.215350877193,114,0.05,2166,0.95,1553,0.681140350877,CC18,Cumberland,37051CC18
Cumberland,1595,61,0.0382445141066,1421,0.890909090909,24,0.0150470219436,7,0.00438871473354,8,0.00501567398119,74,0.046394984326,1485,56,26,1455,1511,64,0.0401253918495,1485,0.931034482759,52,0.0326018808777,1543,0.967398119122,53,0.0332288401254,CC19,Cumberland,37051CC19
Cumberland,5570,2014,0.36157989228,2929,0.525852782765,55,0.00987432675045,121,0.021723518851,138,0.0247755834829,313,0.0561938958707,3150,153,96,3093,3246,221,0.0396768402154,3150,0.56552962298,458,0.0822262118492,5112,0.917773788151,1846,0.331418312388,CC21,Cumberland,37051CC21
Cumberland,2501,1447,0.578568572571,685,0.273890443822,33,0.0131947221112,117,0.046781287485,84,0.0335865653739,135,0.0539784086365,756,63,43,736,799,71,0.0283886445422,756,0.302279088365,329,0.131547381048,2172,0.868452618952,1281,0.512195121951,CC24,Cumberland,37051CC24
Cumberland,3314,1752,0.528666264333,1031,0.311104405552,16,0.004828002414,189,0.0570307785154,145,0.0437537718769,181,0.0546167773084,1140,48,29,1121,1169,109,0.0328907664454,1140,0.343995171998,402,0.121303560652,2912,0.878696439348,1571,0.474049487025,CC25,Cumberland,37051CC25
Cumberland,5813,2457,0.422673318424,2519,0.433339067607,33,0.00567693101669,290,0.0498881816618,180,0.0309650782728,334,0.0574574230174,2682,136,78,2624,2760,163,0.0280405986582,2682,0.461379666265,689,0.1185274385,5124,0.8814725615,2143,0.368656459659,CC26,Cumberland,37051CC26
Cumberland,8113,3176,0.391470479477,3652,0.450141747812,83,0.0102304942685,325,0.0400591643042,386,0.0475779612967,491,0.0605201528411,3953,189,130,3894,4083,301,0.037100949094,3953,0.487242696906,1088,0.134105756194,7025,0.865894243806,2754,0.339455195365,CC27,Cumberland,37051CC27
Cumberland,4276,1866,0.436389148737,1738,0.406454630496,39,0.00912067352666,123,0.0287652011225,269,0.0629092609916,241,0.0563610851263,1892,84,55,1863,1947,154,0.0360149672591,1892,0.442469597755,622,0.145463049579,3654,0.854536950421,1610,0.376520112254,CC29,Cumberland,37051CC29
Cumberland,3613,1785,0.494049266538,1242,0.343758649322,78,0.0215887074453,76,0.0210351508442,216,0.0597841129255,216,0.0597841129255,1357,159,125,1323,1482,115,0.0318295045668,1357,0.375588153889,427,0.118184334348,3186,0.881815665652,1653,0.457514530861,CC31,Cumberland,37051CC31
Cumberland,2481,741,0.298669891173,1327,0.534864973801,13,0.00523982265216,127,0.0511890366788,129,0.0519951632406,144,0.0580411124547,1421,50,27,1398,1448,94,0.0378879484079,1421,0.572752922209,309,0.124546553809,2172,0.875453446191,654,0.263603385732,CC32,Cumberland,37051CC32
Cumberland,3601,1596,0.443210219384,1554,0.431546792558,17,0.00472091085809,177,0.0491530130519,88,0.0244376562066,169,0.0469314079422,1641,72,45,1614,1686,87,0.0241599555679,1641,0.455706748126,364,0.101083032491,3237,0.898916967509,1395,0.387392391002,CC33,Cumberland,37051CC33
Cumberland,2946,1897,0.643923964698,480,0.162932790224,25,0.00848608282417,379,0.128649015614,62,0.0210454854039,103,0.0349626612356,524,57,44,511,568,44,0.0149355057705,524,0.177868295995,196,0.0665308893415,2750,0.933469110659,1805,0.612695179905,CC34,Cumberland,37051CC34
Cumberland,9091,3278,0.360576394236,4600,0.505994940051,63,0.00692993070069,259,0.0284897151028,307,0.0337696623034,584,0.0642393576064,4999,199,107,4907,5106,399,0.0438895611044,4999,0.549884501155,1249,0.137388626114,7842,0.862611373886,2726,0.29985700143,CL57,Cumberland,37051CL57
Cumberland,3234,1959,0.605751391466,877,0.271181199753,52,0.0160791589363,68,0.0210265924552,88,0.0272108843537,190,0.0587507730365,990,113,87,964,1077,113,0.034941249227,990,0.30612244898,334,0.103277674706,2900,0.896722325294,1763,0.54514533086,CU02,Cumberland,37051CU02
Cumberland,3484,2585,0.74196326062,712,0.204362801378,55,0.0157864523536,36,0.0103329506315,47,0.0134902411022,49,0.014064293915,730,77,70,723,800,18,0.00516647531573,730,0.209529276693,115,0.0330080367394,3369,0.966991963261,2533,0.727037887486,EO61-1,Cumberland,37051EO61-1
Cumberland,2691,1702,0.632478632479,811,0.301374953549,64,0.0237829803047,14,0.00520252694166,33,0.0122630992196,67,0.0248978075065,845,112,89,822,934,34,0.0126347082869,845,0.314009661836,83,0.0308435525827,2608,0.969156447417,1670,0.620587142326,EO61-2,Cumberland,37051EO61-2
Cumberland,9054,4694,0.518444886238,3364,0.371548486857,384,0.0424121935056,142,0.0156836757234,145,0.0160150209852,325,0.035895736691,3556,532,471,3495,4027,192,0.0212060967528,3556,0.392754583609,454,0.0501435829468,8600,0.949856417053,4510,0.49812237685,G1,Cumberland,37051G1
Cumberland,14454,9652,0.667773626678,3012,0.208385222084,349,0.0241455652415,418,0.0289193302892,344,0.023799640238,679,0.0469766154698,3279,571,511,3219,3790,267,0.0184723951847,3279,0.226857617269,1218,0.0842673308427,13236,0.915732669157,8999,0.622595821226,G10,Cumberland,37051G10
Cumberland,31242,18274,0.584917738941,7840,0.250944241726,373,0.0119390563984,999,0.0319761859036,1638,0.052429421932,2118,0.0677933550989,8984,813,656,8827,9640,1144,0.0366173740478,8984,0.287561615774,5050,0.161641380193,26192,0.838358619807,15956,0.510722745023,G11,Cumberland,37051G11
Cumberland,34282,16314,0.475876553293,14570,0.425004375474,282,0.00822589113821,808,0.0235692199988,829,0.0241817863602,1479,0.0431421737355,15455,702,478,15231,15933,885,0.0258152966571,15455,0.450819672131,2634,0.0768333236101,31648,0.92316667639,15108,0.440697742255,G2,Cumberland,37051G2
Cumberland,15224,7732,0.507882291119,5658,0.371650026274,484,0.0317919075145,224,0.0147136100893,509,0.0334340514976,617,0.040528113505,6028,716,618,5930,6646,370,0.0243037309511,6028,0.395953757225,1361,0.0893983184446,13863,0.910601681555,7150,0.469653179191,G3,Cumberland,37051G3
Cumberland,8999,4790,0.532281364596,2920,0.324480497833,252,0.0280031114568,154,0.017113012557,402,0.0446716301811,481,0.0534503833759,3185,409,337,3113,3522,265,0.0294477164129,3185,0.353928214246,1044,0.116012890321,7955,0.883987109679,4375,0.486165129459,G4,Cumberland,37051G4
Cumberland,20447,6843,0.334670122756,11100,0.542866924243,177,0.00865652662982,624,0.0305179243899,659,0.0322296669438,1044,0.0510588350369,11772,507,289,11554,12061,672,0.0328654570353,11772,0.575732381278,1980,0.0968357216218,18467,0.903164278378,6100,0.298332273683,G5,Cumberland,37051G5
Cumberland,10457,7799,0.745816199675,1872,0.179018839055,305,0.0291670651238,61,0.00583341302477,175,0.0167352013006,245,0.0234292818208,1965,449,409,1925,2374,93,0.00889356411973,1965,0.187912403175,364,0.0348092187052,10093,0.965190781295,7669,0.733384335852,G6,Cumberland,37051G6
Cumberland,3604,2729,0.757214206437,647,0.179522752497,55,0.0152608213097,28,0.00776914539401,71,0.0197003329634,74,0.0205327413984,663,90,87,660,750,16,0.00443951165372,663,0.183962264151,177,0.0491120976693,3427,0.950887902331,2664,0.739178690344,G7,Cumberland,37051G7
Cumberland,18788,10555,0.561794762614,5630,0.299659357036,365,0.0194272940175,541,0.0287949755163,708,0.0376836278476,989,0.0526399829679,6142,643,541,6040,6683,512,0.0272514370875,6142,0.326910794124,2199,0.117042793272,16589,0.882957206728,9562,0.508941877794,G8,Cumberland,37051G8
Cumberland,16413,10009,0.609821482971,4469,0.272284164991,531,0.0323524035825,253,0.0154146103698,389,0.023700725035,762,0.0464266130506,4885,786,707,4806,5592,416,0.0253457625053,4885,0.297629927496,1345,0.0819472369463,15068,0.918052763054,9324,0.568086273076,G9,Cumberland,37051G9
Cumberland,4809,3542,0.7365356623,919,0.191100020794,54,0.0112289457268,79,0.0164275317114,83,0.0172593054689,132,0.0274485339988,991,99,82,974,1073,72,0.0149719276357,991,0.20607194843,252,0.0524017467249,4557,0.947598253275,3427,0.712622166771,LI65,Cumberland,37051LI65
Cumberland,6347,2225,0.350559319363,3173,0.499921222625,41,0.0064597447613,234,0.0368678115645,327,0.0515204033402,347,0.0546714983457,3414,117,64,3361,3478,241,0.0379706948164,3414,0.537891917441,910,0.143374822751,5437,0.856625177249,1844,0.290530959508,LR63,Cumberland,37051LR63
Cumberland,4275,1499,0.350643274854,2076,0.485614035088,46,0.0107602339181,117,0.0273684210526,259,0.0605847953216,278,0.0650292397661,2258,111,68,2215,2326,182,0.0425730994152,2258,0.528187134503,639,0.149473684211,3636,0.850526315789,1287,0.301052631579,MB62,Cumberland,37051MB62
Cumberland,4679,2101,0.449027569994,1769,0.378072237658,57,0.0121820901902,277,0.0592006839068,202,0.0431716178671,273,0.0583458003847,1927,112,89,1904,2016,158,0.0337678991237,1927,0.411840136781,637,0.136140200898,4042,0.863859799102,1801,0.384911305835,MR02,Cumberland,37051MR02
Cumberland,3355,2306,0.687332339791,728,0.216989567809,113,0.0336810730253,19,0.00566318926975,108,0.0321907600596,81,0.0241430700447,763,146,140,757,903,35,0.0104321907601,763,0.227421758569,258,0.0769001490313,3097,0.923099850969,2188,0.6521609538,SH77,Cumberland,37051SH77
Currituck,92,92,1.0,0,0.0,0,0.0,0,0.0,0,0.0,0,0.0,0,0,0,0,0,0,0.0,0,0.0,0,0.0,92,1.0,92,1.0,CB,Currituck,37053CB
Currituck,4548,4227,0.929419525066,134,0.0294635004398,22,0.00483729111697,23,0.00505716798593,43,0.009454705365,99,0.0217678100264,162,54,51,159,213,28,0.00615655233069,162,0.0356200527704,142,0.0312225153914,4406,0.968777484609,4140,0.910290237467,CH,Currituck,37053CH
Currituck,309,303,0.980582524272,1,0.00323624595469,3,0.00970873786408,0,0.0,0,0.0,2,0.00647249190939,1,4,4,1,5,0,0.0,1,0.00323624595469,2,0.00647249190939,307,0.993527508091,302,0.977346278317,CI,Currituck,37053CI
Currituck,1277,1023,0.801096319499,177,0.138606108066,7,0.00548159749413,7,0.00548159749413,34,0.0266249021143,29,0.0227094753328,191,22,18,187,209,14,0.0109631949883,191,0.149569303054,70,0.0548159749413,1207,0.945184025059,996,0.779953014879,CJ,Currituck,37053CJ
Currituck,461,454,0.984815618221,0,0.0,0,0.0,2,0.00433839479393,0,0.0,5,0.0108459869848,4,0,0,4,4,4,0.00867678958785,4,0.00867678958785,3,0.00650759219089,458,0.993492407809,451,0.97830802603,GW,Currituck,37053GW
Currituck,1383,1161,0.839479392625,164,0.118582791034,7,0.00506146059291,10,0.00723065798988,25,0.0180766449747,16,0.0115690527838,169,17,14,166,183,5,0.00361532899494,169,0.122198120029,44,0.0318148951555,1339,0.968185104845,1143,0.826464208243,IR,Currituck,37053IR
Currituck,1545,1498,0.969579288026,4,0.00258899676375,4,0.00258899676375,15,0.00970873786408,0,0.0,24,0.0155339805825,7,14,14,7,21,3,0.00194174757282,7,0.00453074433657,22,0.0142394822006,1523,0.985760517799,1481,0.95857605178,KI,Currituck,37053KI
Currituck,6418,5675,0.884231847928,455,0.0708943596136,33,0.00514178871923,73,0.011374259894,51,0.0079464007479,131,0.0204113430975,512,72,64,504,576,57,0.00888127142412,512,0.0797756310377,228,0.0355250856965,6190,0.964474914304,5547,0.864287940168,MY,Currituck,37053MY
Currituck,4872,4452,0.913793103448,238,0.0488505747126,25,0.00513136288998,22,0.00451559934319,53,0.0108784893268,82,0.0168308702791,280,51,42,271,322,42,0.00862068965517,280,0.0574712643678,123,0.0252463054187,4749,0.974753694581,4395,0.902093596059,PB,Currituck,37053PB
Currituck,2192,1951,0.890054744526,178,0.081204379562,5,0.00228102189781,3,0.00136861313869,16,0.00729927007299,39,0.0177919708029,195,17,17,195,212,17,0.00775547445255,195,0.0889598540146,62,0.0282846715328,2130,0.971715328467,1904,0.868613138686,PP,Currituck,37053PP
Currituck,450,432,0.96,10,0.0222222222222,1,0.00222222222222,4,0.00888888888889,1,0.00222222222222,2,0.00444444444444,10,3,3,10,13,0,0.0,10,0.0222222222222,8,0.0177777777778,442,0.982222222222,425,0.944444444444,WH,Currituck,37053WH
Dare,777,762,0.980694980695,1,0.001287001287,1,0.001287001287,1,0.001287001287,6,0.00772200772201,6,0.00772200772201,2,4,4,2,6,1,0.001287001287,2,0.002574002574,58,0.0746460746461,719,0.925353925354,712,0.916344916345,AVON,Dare,37055AVON
Dare,1526,1448,0.948885976409,8,0.00524246395806,2,0.00131061598952,0,0.0,45,0.0294888597641,23,0.0150720838794,16,12,11,15,27,8,0.00524246395806,16,0.0104849279161,160,0.104849279161,1366,0.895150720839,1336,0.875491480996,BUX,Dare,37055BUX
Dare,624,599,0.959935897436,5,0.00801282051282,2,0.00320512820513,4,0.00641025641026,4,0.00641025641026,10,0.0160256410256,5,9,9,5,14,0,0.0,5,0.00801282051282,17,0.0272435897436,607,0.972756410256,586,0.939102564103,CHCA,Dare,37055CHCA
Dare,4179,3991,0.955013161043,24,0.00574300071788,15,0.00358937544867,31,0.00741804259392,46,0.0110074180426,72,0.0172290021536,50,35,34,49,84,26,0.00622158411103,50,0.0119645848289,193,0.0461832974396,3986,0.95381670256,3859,0.923426657095,COL,Dare,37055COL
Dare,369,355,0.962059620596,0,0.0,1,0.00271002710027,4,0.0108401084011,6,0.0162601626016,3,0.00813008130081,0,1,1,0,1,0,0.0,0,0.0,10,0.0271002710027,359,0.972899728997,351,0.951219512195,DUCK,Dare,37055DUCK
Dare,161,136,0.844720496894,1,0.00621118012422,0,0.0,0,0.0,23,0.142857142857,1,0.00621118012422,1,1,1,1,2,0,0.0,1,0.00621118012422,24,0.149068322981,137,0.850931677019,135,0.83850931677,EL,Dare,37055EL
Dare,891,879,0.986531986532,0,0.0,2,0.00224466891134,1,0.00112233445567,6,0.00673400673401,3,0.003367003367,1,4,4,1,5,1,0.00112233445567,1,0.00112233445567,61,0.0684624017957,830,0.931537598204,824,0.92480359147,FRCO,Dare,37055FRCO
Dare,504,495,0.982142857143,1,0.00198412698413,0,0.0,0,0.0,0,0.0,8,0.015873015873,1,0,0,1,1,0,0.0,1,0.00198412698413,14,0.0277777777778,490,0.972222222222,487,0.96626984127,HAT,Dare,37055HAT
Dare,6683,6000,0.897800389047,82,0.0122699386503,35,0.00523716893611,97,0.0145144396229,326,0.0487804878049,143,0.0213975759389,120,88,88,120,208,38,0.00568606913063,120,0.0179560077809,608,0.0909771060901,6075,0.90902289391,5755,0.861140206494,KDH,Dare,37055KDH
Dare,3272,3151,0.963019559902,35,0.0106968215159,5,0.00152811735941,29,0.0088630806846,16,0.00488997555012,36,0.0110024449878,46,23,23,46,69,11,0.00336185819071,46,0.0140586797066,96,0.0293398533007,3176,0.970660146699,3078,0.940709046455,KTHK,Dare,37055KTHK
Dare,6112,5066,0.828861256545,614,0.100458115183,33,0.00539921465969,18,0.00294502617801,198,0.0323952879581,183,0.0299410994764,724,88,70,706,794,110,0.017997382199,724,0.118455497382,656,0.107329842932,5456,0.892670157068,4671,0.764234293194,MATO,Dare,37055MATO
Dare,858,765,0.891608391608,6,0.00699300699301,7,0.00815850815851,4,0.004662004662,58,0.0675990675991,18,0.020979020979,16,12,12,16,28,10,0.011655011655,16,0.018648018648,102,0.118881118881,756,0.881118881119,722,0.841491841492,MH,Dare,37055MH
Dare,2789,2639,0.94621728218,44,0.0157762638939,15,0.005378271782,11,0.00394406597347,39,0.0139835066332,41,0.0147006095375,60,38,32,54,92,16,0.00573682323413,60,0.021513087128,89,0.0319110792399,2700,0.96808892076,2592,0.92936536393,NGHD,Dare,37055NGHD
Dare,3306,3228,0.976406533575,10,0.00302480338778,3,0.000907441016334,22,0.00665456745312,5,0.00151240169389,38,0.0114942528736,26,11,9,24,35,16,0.00483968542045,26,0.00786448880823,50,0.0151240169389,3256,0.984875983061,3189,0.964609800363,SOSH,Dare,37055SOSH
Dare,227,224,0.986784140969,0,0.0,0,0.0,0,0.0,0,0.0,3,0.0132158590308,0,3,3,0,3,0,0.0,0,0.0,0,0.0,227,1.0,224,0.986784140969,STPT,Dare,37055STPT
Dare,1642,1575,0.959196102314,3,0.00182704019488,4,0.00243605359318,3,0.00182704019488,32,0.0194884287454,25,0.0152253349574,11,15,14,10,25,8,0.00487210718636,11,0.00669914738124,72,0.0438489646772,1570,0.956151035323,1540,0.937880633374,WAN,Dare,37055WAN
Davidson,8261,6793,0.82229754267,866,0.104829923738,34,0.00411572448856,198,0.0239680426099,210,0.0254206512529,160,0.0193681152403,925,88,78,915,1003,59,0.00714199249486,925,0.111971916233,475,0.0574990921196,7786,0.94250090788,6563,0.794455877012,02,Davidson,3705702
Davidson,6715,6165,0.918093819806,307,0.0457185405808,27,0.00402084884587,61,0.00908413998511,62,0.00923306031273,93,0.0138495904691,340,50,47,337,387,33,0.00491437081162,340,0.0506329113924,177,0.0263588979896,6538,0.97364110201,6062,0.902755026061,04,Davidson,3705704
Davidson,4753,4432,0.932463707132,77,0.0162002945508,21,0.00441826215022,28,0.00589101620029,138,0.02903429413,57,0.0119924258363,98,41,41,98,139,21,0.00441826215022,98,0.020618556701,232,0.0488112770882,4521,0.951188722912,4346,0.91436987166,06,Davidson,3705706
Davidson,1596,1425,0.892857142857,74,0.046365914787,6,0.00375939849624,28,0.0175438596491,27,0.0169172932331,36,0.0225563909774,92,16,16,92,108,18,0.0112781954887,92,0.0576441102757,71,0.0444862155388,1525,0.955513784461,1390,0.870927318296,08,Davidson,3705708
Davidson,3778,3319,0.878507146638,227,0.0600847008999,10,0.00264690312335,77,0.0203811540498,90,0.0238221281101,55,0.0145579671784,240,37,34,237,274,13,0.00344097406035,240,0.0635256749603,165,0.0436739015352,3613,0.956326098465,3258,0.862361037586,10,Davidson,3705710
Davidson,1441,1417,0.983344899375,1,0.000693962526024,2,0.00138792505205,0,0.0,5,0.00346981263012,16,0.0111034004164,5,12,12,5,17,4,0.00277585010409,5,0.00346981263012,17,0.0117973629424,1424,0.988202637058,1406,0.975711311589,12,Davidson,3705712
Davidson,2845,2794,0.982073813708,6,0.00210896309315,9,0.00316344463972,10,0.00351493848858,12,0.00421792618629,14,0.00492091388401,8,18,18,8,26,2,0.000702987697715,8,0.00281195079086,35,0.01230228471,2810,0.98769771529,2773,0.974692442882,14,Davidson,3705714
Davidson,4642,4354,0.93795777682,70,0.0150797070228,21,0.00452391210685,24,0.00517018526497,120,0.0258509263249,53,0.0114174924601,91,48,44,87,135,21,0.00452391210685,91,0.0196036191297,236,0.0508401551056,4406,0.949159844894,4265,0.918785006463,16,Davidson,3705716
Davidson,2642,2584,0.978046934141,13,0.00492051476154,10,0.00378501135503,8,0.00302800908403,14,0.00529901589705,13,0.00492051476154,17,14,14,17,31,4,0.00151400454201,17,0.00643451930356,32,0.0121120363361,2610,0.987887963664,2565,0.970855412566,18,Davidson,3705718
Davidson,3902,3782,0.969246540236,32,0.00820092260379,16,0.0041004613019,8,0.00205023065095,29,0.00743208610969,35,0.0089697590979,44,28,28,44,72,12,0.00307534597642,44,0.0112762685802,60,0.0153767298821,3842,0.984623270118,3760,0.963608405946,20,Davidson,3705720
Davidson,1794,1555,0.866778149387,76,0.0423634336678,5,0.00278706800446,53,0.0295429208473,81,0.0451505016722,24,0.0133779264214,83,15,12,80,95,7,0.00390189520624,83,0.046265328874,92,0.0512820512821,1702,0.948717948718,1543,0.860089186176,22,Davidson,3705722
Davidson,2206,1802,0.816863100635,104,0.0471441523119,19,0.00861287398005,156,0.0707162284678,94,0.0426110607434,31,0.0140525838622,118,24,24,118,142,14,0.00634632819583,118,0.0534904805077,149,0.0675430643699,2057,0.93245693563,1750,0.793291024479,24,Davidson,3705724
Davidson,1168,1043,0.892979452055,69,0.0590753424658,9,0.00770547945205,13,0.0111301369863,25,0.021404109589,9,0.00770547945205,74,11,11,74,85,5,0.00428082191781,74,0.0633561643836,35,0.0299657534247,1133,0.970034246575,1034,0.885273972603,26,Davidson,3705726
Davidson,3601,3169,0.880033324077,210,0.0583171341294,20,0.00555401277423,75,0.0208275479034,67,0.0186059427937,60,0.0166620383227,237,39,37,235,274,27,0.00749791724521,237,0.0658150513746,149,0.041377395168,3452,0.958622604832,3112,0.86420438767,28,Davidson,3705728
Davidson,3631,1197,0.329661250344,1768,0.486918204351,26,0.0071605618287,84,0.0231341228312,429,0.118149270174,127,0.0349765904709,1843,66,56,1833,1899,75,0.0206554668135,1843,0.507573671165,713,0.196364637841,2918,0.803635362159,980,0.269898099697,30,Davidson,3705730
Davidson,2693,1615,0.599702933531,599,0.222428518381,19,0.00705532862978,24,0.00891199405867,362,0.134422577052,74,0.0274786483476,637,39,38,636,675,38,0.0141106572596,637,0.236539175641,583,0.216487189009,2110,0.783512810991,1409,0.523208317861,32,Davidson,3705732
Davidson,3051,1879,0.615863651262,478,0.156669944281,25,0.00819403474271,269,0.0881678138315,312,0.102261553589,88,0.0288430022943,527,46,40,521,567,49,0.0160603080957,527,0.172730252376,426,0.139626352016,2625,0.860373647984,1762,0.577515568666,34,Davidson,3705734
Davidson,2296,1448,0.630662020906,493,0.214721254355,12,0.00522648083624,61,0.0265679442509,234,0.101916376307,48,0.0209059233449,527,25,23,525,550,34,0.0148083623693,527,0.229529616725,299,0.130226480836,1997,0.869773519164,1392,0.606271777003,36,Davidson,3705736
Davidson,3089,1124,0.363871803173,1291,0.417934606669,24,0.00776950469408,54,0.0174813855617,511,0.165425704111,85,0.0275169957915,1365,39,28,1354,1393,74,0.0239559728067,1365,0.441890579476,734,0.237617351894,2355,0.762382648106,923,0.29880220136,38,Davidson,3705738
Davidson,3117,2258,0.724414501123,640,0.205325633622,9,0.00288739172281,31,0.00994546037857,139,0.0445941610523,40,0.0128328521014,658,17,17,658,675,18,0.00577478344562,658,0.211100417068,259,0.0830927173564,2858,0.916907282644,2145,0.688161693936,40,Davidson,3705740
Davidson,3909,3779,0.966743412638,24,0.00613967766692,18,0.00460475825019,13,0.00332565873625,39,0.00997697620875,36,0.00920951650038,37,25,24,36,61,13,0.00332565873625,37,0.00946533640317,81,0.0207214121259,3828,0.979278587874,3743,0.957533896137,42,Davidson,3705742
Davidson,5038,4363,0.866018261215,563,0.11175069472,9,0.0017864231838,24,0.00476379515681,32,0.00635172687574,47,0.00932909884875,576,31,27,572,603,13,0.00258038904327,576,0.114331083763,82,0.0162763001191,4956,0.983723699881,4324,0.858277094085,44,Davidson,3705744
Davidson,3708,3424,0.923408845739,147,0.039644012945,11,0.0029665587918,30,0.00809061488673,56,0.0151024811219,40,0.0107874865156,166,27,21,160,187,19,0.00512405609493,166,0.0447680690399,145,0.0391046386192,3563,0.960895361381,3343,0.901564185545,46,Davidson,3705746
Davidson,3794,3570,0.940959409594,87,0.0229309435952,25,0.0065893516078,18,0.00474433315762,57,0.0150237216658,37,0.00975224037955,92,43,43,92,135,5,0.00131787032156,92,0.0242488139167,92,0.0242488139167,3702,0.975751186083,3537,0.932261465472,48,Davidson,3705748
Davidson,5088,4888,0.960691823899,57,0.0112028301887,23,0.00452044025157,33,0.0064858490566,35,0.00687893081761,52,0.0102201257862,66,52,52,66,118,9,0.00176886792453,66,0.0129716981132,89,0.0174921383648,4999,0.982507861635,4835,0.950275157233,50,Davidson,3705750
Davidson,6164,5945,0.964471122648,67,0.0108695652174,18,0.00292018170019,49,0.0079493835172,46,0.00746268656716,39,0.00632706035042,83,29,29,83,112,16,0.00259571706684,83,0.0134652822842,140,0.0227125243348,6024,0.977287475665,5861,0.950843608047,52,Davidson,3705752
Davidson,2964,2903,0.979419703104,6,0.00202429149798,4,0.00134952766532,9,0.00303643724696,11,0.00371120107962,31,0.0104588394062,19,11,9,17,28,13,0.00438596491228,19,0.00641025641026,35,0.0118083670715,2929,0.988191632928,2888,0.974358974359,54,Davidson,3705754
Davidson,1817,1773,0.975784259769,1,0.000550357732526,6,0.00330214639516,5,0.00275178866263,9,0.00495321959274,23,0.0126582278481,6,23,18,1,24,5,0.00275178866263,6,0.00330214639516,32,0.0176114474408,1785,0.982388552559,1754,0.965327462851,56,Davidson,3705756
Davidson,4533,4230,0.933156849768,180,0.0397088021178,11,0.00242664901831,26,0.00573571586146,40,0.0088241782484,46,0.0101478049857,195,29,28,194,223,15,0.00330906684315,195,0.043017868961,90,0.0198544010589,4443,0.980145598941,4182,0.92256783587,58,Davidson,3705758
Davidson,7281,5506,0.756214805659,943,0.129515176487,53,0.00727921988738,105,0.0144210960033,502,0.0689465732729,172,0.0236231286911,1014,102,92,1004,1106,71,0.00975140777366,1014,0.13926658426,988,0.135695646202,6293,0.864304353798,5097,0.700041203131,60,Davidson,3705760
Davidson,3187,1338,0.419830561657,1198,0.375902102291,8,0.00251019767807,49,0.0153749607782,512,0.160652651396,82,0.0257295262002,1244,37,29,1236,1273,46,0.0144336366489,1244,0.390335738939,740,0.232193285221,2447,0.767806714779,1138,0.357075619705,62,Davidson,3705762
Davidson,3170,1175,0.370662460568,1585,0.5,23,0.00725552050473,15,0.00473186119874,303,0.0955835962145,69,0.0217665615142,1629,35,30,1624,1659,44,0.013880126183,1629,0.513880126183,488,0.153943217666,2682,0.846056782334,1029,0.324605678233,64,Davidson,3705764
Davidson,3512,2524,0.71867881549,511,0.145501138952,39,0.0111047835991,32,0.00911161731207,314,0.0894077448747,92,0.0261958997722,561,65,61,557,622,50,0.0142369020501,561,0.159738041002,603,0.171697038724,2909,0.828302961276,2283,0.650056947608,66,Davidson,3705766
Davidson,3908,2608,0.667349027636,739,0.189099283521,37,0.00946775844422,36,0.00921187308086,392,0.100307062436,96,0.0245649948823,772,64,62,770,834,33,0.00844421699079,772,0.197543500512,699,0.178863868987,3209,0.821136131013,2354,0.602354145343,68,Davidson,3705768
Davidson,3308,3012,0.910519951632,133,0.0402055622733,13,0.00392986698912,35,0.0105804111245,77,0.023276904474,38,0.0114873035067,139,28,28,139,167,6,0.00181378476421,139,0.0420193470375,139,0.0420193470375,3169,0.957980652963,2963,0.895707376058,70,Davidson,3705770
Davidson,3615,3415,0.944674965422,75,0.0207468879668,18,0.00497925311203,24,0.00663900414938,51,0.0141078838174,32,0.0088520055325,86,30,27,83,113,11,0.0030428769018,86,0.0237897648686,127,0.0351313969571,3488,0.964868603043,3347,0.925864453665,72,Davidson,3705772
Davidson,5707,5381,0.94287716839,111,0.0194497984931,32,0.00560714911512,21,0.0036796916068,110,0.0192745750832,52,0.00911161731207,128,61,56,123,184,17,0.00297879796741,128,0.0224285964605,198,0.0346942351498,5509,0.96530576485,5310,0.930436306291,74,Davidson,3705774
Davidson,4371,4127,0.944177533745,68,0.0155570807596,32,0.00732097918097,29,0.00663463738275,66,0.0150995195607,49,0.0112102493709,89,51,49,87,138,21,0.00480439258751,89,0.0203614733471,165,0.0377487989019,4206,0.962251201098,4040,0.924273621597,76,Davidson,3705776
Davidson,5112,4750,0.929186228482,143,0.0279733959311,31,0.0060641627543,30,0.00586854460094,89,0.0174100156495,69,0.0134976525822,168,58,55,165,223,25,0.00489045383412,168,0.0328638497653,184,0.0359937402191,4928,0.964006259781,4668,0.913145539906,78,Davidson,3705778
Davidson,5602,5341,0.953409496608,50,0.0089253837915,20,0.0035701535166,49,0.00874687611567,72,0.0128525526598,70,0.0124955373081,76,43,41,74,117,26,0.00464119957158,76,0.0135665833631,131,0.0233845055337,5471,0.976615494466,5292,0.944662620493,80,Davidson,3705780
Davidson,3906,3655,0.935739887353,83,0.021249359959,13,0.00332821300563,90,0.0230414746544,29,0.00742447516641,36,0.00921658986175,94,23,23,94,117,11,0.00281618023554,94,0.0240655401946,69,0.0176651305684,3837,0.982334869432,3616,0.925755248336,82,Davidson,3705782
Davidson,5963,5497,0.921851417072,249,0.0417575046118,26,0.00436022136508,37,0.00620493040416,68,0.0114036558779,86,0.0144222706691,287,46,43,284,330,38,0.00637263122589,287,0.0481301358377,152,0.0254905249036,5811,0.974509475096,5444,0.91296327352,84,Davidson,3705784
Davie,1421,1176,0.827586206897,185,0.130190007037,3,0.00211118930331,1,0.000703729767769,38,0.0267417311752,18,0.0126671358198,196,9,8,195,204,11,0.00774102744546,196,0.137931034483,58,0.0408163265306,1363,0.959183673469,1163,0.818437719916,01,Davie,3705901
Davie,1810,1581,0.873480662983,81,0.0447513812155,6,0.00331491712707,5,0.00276243093923,112,0.0618784530387,25,0.0138121546961,91,18,16,89,107,10,0.00552486187845,91,0.0502762430939,171,0.0944751381215,1639,0.905524861878,1523,0.841436464088,02,Davie,3705902
Davie,3764,3415,0.907279489904,129,0.0342720510096,17,0.00451647183847,3,0.000797024442083,143,0.037991498406,57,0.0151434643996,162,35,32,159,194,33,0.00876726886291,162,0.0430393198725,260,0.0690754516472,3504,0.930924548353,3314,0.880446333688,03,Davie,3705903
Davie,3418,2662,0.778818022235,327,0.0956699824459,18,0.00526623756583,12,0.00351082504389,303,0.0886483323581,96,0.0280866003511,378,39,38,377,416,51,0.0149210064365,378,0.110590988882,400,0.117027501463,3018,0.882972498537,2599,0.760386190755,04,Davie,3705904
Davie,3292,3005,0.912818955043,135,0.0410085054678,2,0.000607533414338,16,0.0048602673147,79,0.0239975698663,55,0.0167071688943,150,25,25,150,175,15,0.00455650060753,150,0.0455650060753,125,0.0379708383961,3167,0.962029161604,2971,0.902490886999,05,Davie,3705905
Davie,2281,2079,0.911442349847,118,0.0517316966243,12,0.00526085050416,14,0.00613765892153,25,0.010960105217,33,0.0144673388865,132,20,20,132,152,14,0.00613765892153,132,0.0578693555458,49,0.0214818062253,2232,0.978518193775,2064,0.904866286716,06,Davie,3705906
Davie,2644,2274,0.860060514372,227,0.0858547655068,2,0.000756429652042,9,0.00340393343419,99,0.0374432677761,33,0.0124810892587,251,6,6,251,257,24,0.00907715582451,251,0.0949319213313,150,0.0567322239032,2494,0.943267776097,2223,0.840771558245,07,Davie,3705907
Davie,3165,2154,0.680568720379,548,0.173143759874,31,0.00979462875197,28,0.0088467614534,269,0.0849921011058,135,0.042654028436,627,71,63,619,690,79,0.0249605055292,627,0.198104265403,469,0.148183254344,2696,0.851816745656,2001,0.632227488152,08,Davie,3705908
Davie,3408,2773,0.81367370892,362,0.106220657277,2,0.000586854460094,16,0.00469483568075,180,0.0528169014085,75,0.0220070422535,405,25,17,397,422,43,0.012617370892,405,0.118838028169,330,0.0968309859155,3078,0.903169014085,2645,0.776115023474,09,Davie,3705909
Davie,2898,2769,0.955486542443,49,0.0169082125604,22,0.00759144237405,13,0.00448585231194,11,0.00379572118703,34,0.0117322291235,61,39,39,61,100,12,0.00414078674948,61,0.0210489993099,44,0.0151828847481,2854,0.984817115252,2745,0.947204968944,10,Davie,3705910
Davie,2409,2296,0.953092569531,37,0.0153590701536,3,0.00124533001245,8,0.00332088003321,50,0.0207555002076,15,0.00622665006227,46,4,4,46,50,9,0.00373599003736,46,0.019095060191,81,0.0336239103362,2328,0.966376089664,2269,0.941884599419,11,Davie,3705911
Davie,4640,4298,0.926293103448,177,0.0381465517241,16,0.00344827586207,45,0.00969827586207,49,0.0105603448276,55,0.0118534482759,204,25,22,201,226,27,0.00581896551724,204,0.0439655172414,148,0.0318965517241,4492,0.968103448276,4209,0.907112068966,12,Davie,3705912
Davie,3377,3172,0.939295232455,97,0.0287237192775,3,0.00088836245188,63,0.0186556114895,8,0.00236896653835,34,0.010068107788,101,9,9,101,110,4,0.00118448326917,101,0.0299082025466,55,0.0162866449511,3322,0.983713355049,3132,0.927450399763,13,Davie,3705913
Davie,2713,2446,0.901584961297,121,0.0446000737191,12,0.00442314780686,12,0.00442314780686,92,0.0339107998526,30,0.0110578695171,136,19,19,136,155,15,0.00552893475857,136,0.0501290084777,156,0.0575009214891,2557,0.942499078511,2399,0.884260965721,14,Davie,3705914
Duplin,3880,2166,0.55824742268,215,0.055412371134,20,0.00515463917526,6,0.00154639175258,1389,0.357989690722,84,0.0216494845361,233,46,45,232,278,18,0.00463917525773,233,0.0600515463918,1942,0.500515463918,1938,0.499484536082,1713,0.441494845361,ALBE,Duplin,37061ALBE
Duplin,4650,3873,0.832903225806,495,0.106451612903,27,0.0058064516129,9,0.00193548387097,182,0.0391397849462,64,0.0137634408602,522,41,38,519,560,27,0.0058064516129,522,0.112258064516,275,0.0591397849462,4375,0.940860215054,3802,0.817634408602,BEUL,Duplin,37061BEUL
Duplin,1576,1019,0.646573604061,272,0.172588832487,13,0.00824873096447,11,0.00697969543147,234,0.14847715736,27,0.0171319796954,287,19,18,286,305,15,0.00951776649746,287,0.182106598985,306,0.194162436548,1270,0.805837563452,974,0.618020304569,CALY,Duplin,37061CALY
Duplin,1236,1073,0.868122977346,59,0.0477346278317,10,0.00809061488673,1,0.000809061488673,71,0.0574433656958,22,0.0177993527508,70,16,14,68,84,11,0.0088996763754,70,0.0566343042071,114,0.0922330097087,1122,0.907766990291,1044,0.844660194175,CFRK,Duplin,37061CFRK
Duplin,2293,887,0.386829481029,1103,0.481029219363,6,0.00261665939817,8,0.00348887919756,248,0.108155255124,41,0.0178805058875,1129,15,8,1122,1137,26,0.0113388573921,1129,0.492368076755,350,0.152638464893,1943,0.847361535107,808,0.352376798953,CHAR,Duplin,37061CHAR
Duplin,1396,1067,0.764326647564,260,0.186246418338,2,0.00143266475645,2,0.00143266475645,46,0.0329512893983,19,0.0136103151862,273,5,4,272,277,13,0.00931232091691,273,0.195558739255,81,0.0580229226361,1315,0.941977077364,1046,0.749283667622,CHIN,Duplin,37061CHIN
Duplin,2014,1730,0.858987090367,219,0.108738828203,4,0.00198609731877,1,0.000496524329692,47,0.0233366434955,13,0.006454816286,222,14,13,221,235,3,0.00148957298908,222,0.110228401192,85,0.0422045680238,1929,0.957795431976,1695,0.841608738828,CYRK,Duplin,37061CYRK
Duplin,3110,1463,0.470418006431,904,0.290675241158,11,0.00353697749196,8,0.00257234726688,659,0.211897106109,65,0.0209003215434,932,26,20,926,952,28,0.00900321543408,932,0.299678456592,808,0.259807073955,2302,0.740192926045,1353,0.435048231511,FAIS,Duplin,37061FAIS
Duplin,1716,1178,0.68648018648,87,0.0506993006993,4,0.002331002331,7,0.00407925407925,396,0.230769230769,44,0.025641025641,97,6,5,96,102,10,0.00582750582751,97,0.0565268065268,571,0.332750582751,1145,0.667249417249,1047,0.61013986014,GLIS,Duplin,37061GLIS
Duplin,2221,1421,0.63980189104,557,0.250787933363,9,0.0040522287258,11,0.0049527239982,182,0.0819450697884,41,0.0184601530842,566,30,28,564,594,9,0.0040522287258,566,0.254840162089,235,0.105808194507,1986,0.894191805493,1398,0.629446195407,HALL,Duplin,37061HALL
Duplin,5634,2694,0.478168264111,2172,0.385516506922,44,0.00780972665957,21,0.00372736954207,626,0.111111111111,77,0.0136670216542,2197,85,78,2190,2275,25,0.00443734469294,2197,0.389953851615,821,0.145722399716,4813,0.854277600284,2553,0.453141640043,KENA,Duplin,37061KENA
Duplin,855,675,0.789473684211,112,0.130994152047,5,0.00584795321637,0,0.0,35,0.0409356725146,28,0.0327485380117,119,22,22,119,141,7,0.00818713450292,119,0.13918128655,99,0.115789473684,756,0.884210526316,632,0.73918128655,LOCK,Duplin,37061LOCK
Duplin,3110,1126,0.362057877814,927,0.29807073955,12,0.00385852090032,6,0.00192926045016,985,0.316720257235,54,0.0173633440514,956,34,23,945,979,29,0.00932475884244,956,0.307395498392,1240,0.398713826367,1870,0.601286173633,897,0.288424437299,MAGN,Duplin,37061MAGN
Duplin,1621,851,0.524984577421,563,0.347316471314,5,0.00308451573103,4,0.00246761258482,176,0.108574953732,22,0.0135718692165,577,13,10,574,587,14,0.00863664404688,577,0.355953115361,227,0.140037014189,1394,0.859962985811,806,0.497223935842,ROCK,Duplin,37061ROCK
Duplin,3377,1703,0.504293751851,1080,0.319810482677,17,0.00503405389399,14,0.00414569144211,515,0.152502220906,48,0.0142137992301,1097,39,32,1090,1129,17,0.00503405389399,1097,0.324844536571,700,0.207284572105,2677,0.792715427895,1559,0.46165235416,ROSE,Duplin,37061ROSE
Duplin,2062,1530,0.741998060136,322,0.156159068865,11,0.00533462657614,3,0.00145489815713,173,0.0838991270611,23,0.0111542192047,335,18,15,332,350,13,0.00630455868089,335,0.162463627546,239,0.115906886518,1823,0.884093113482,1471,0.713385063046,SMCA,Duplin,37061SMCA
Duplin,7587,4022,0.530117305918,2303,0.303545538421,21,0.00276789244761,31,0.00408593647028,1111,0.146434690919,99,0.0130486358244,2336,50,43,2329,2379,33,0.00434954527481,2336,0.307895083696,1502,0.197970212205,6085,0.802029787795,3713,0.489389745618,WALL,Duplin,37061WALL
Duplin,6041,2233,0.369640787949,2901,0.48021850687,24,0.00397285217679,29,0.00480052971362,767,0.12696573415,87,0.0144015891409,2950,57,38,2931,2988,49,0.00811123986095,2950,0.488329746731,1057,0.174971031286,4984,0.825028968714,2006,0.332064227777,WARS,Duplin,37061WARS
Duplin,4126,2738,0.663596703829,222,0.0538051381483,22,0.0053320407174,48,0.0116335433834,1014,0.245758603975,82,0.0198739699467,236,44,42,234,278,14,0.00339311682016,236,0.0571982549685,1407,0.341008240427,2719,0.658991759573,2442,0.591856519632,WOLF,Duplin,37061WOLF
Durham,2482,1050,0.423045930701,791,0.318694601128,29,0.0116841257051,34,0.013698630137,512,0.206285253828,66,0.0265914585012,832,51,37,818,869,41,0.0165189363417,832,0.33521353747,912,0.36744560838,1570,0.63255439162,706,0.284448025786,01,Durham,3706301
Durham,4941,2559,0.517911353977,1240,0.250961343858,10,0.0020238818053,524,0.106051406598,498,0.100789313904,110,0.0222626998583,1283,31,19,1271,1302,43,0.0087026917628,1283,0.25966403562,790,0.159886662619,4151,0.840113337381,2289,0.463266545234,02,Durham,3706302
Durham,2303,1795,0.779418150239,162,0.0703430308294,5,0.00217108119844,120,0.0521059487625,155,0.0673035171515,66,0.0286582718194,185,16,10,179,195,23,0.00998697351281,185,0.0803300043422,295,0.128093790708,2008,0.871906209292,1674,0.726877985237,03,Durham,3706303
Durham,1793,1499,0.836029001673,120,0.0669269380926,9,0.00501952035694,66,0.0368098159509,53,0.0295593976576,46,0.0256553262688,139,13,12,138,151,19,0.010596765198,139,0.0775237032906,85,0.0474065811489,1708,0.952593418851,1467,0.818181818182,04,Durham,3706304
Durham,10049,3978,0.395860284605,2641,0.262812220121,68,0.00676684247189,2055,0.204497959996,1039,0.103393372475,268,0.0266693203304,2714,99,87,2702,2801,73,0.00726440441835,2714,0.27007662454,1912,0.190267688327,8137,0.809732311673,3344,0.332769429794,05,Durham,3706305
Durham,3385,1653,0.488330871492,676,0.199704579025,27,0.00797636632201,104,0.0307237813885,855,0.25258493353,70,0.0206794682422,699,34,33,698,732,23,0.00679468242245,699,0.206499261448,1389,0.410339734121,1996,0.589660265879,1203,0.355391432792,06,Durham,3706306
Durham,2609,1859,0.712533537754,398,0.152548869299,4,0.00153315446531,118,0.0452280567267,138,0.0528938290533,92,0.0352625527022,437,25,14,426,451,39,0.0149482560368,437,0.167497125335,260,0.0996550402453,2349,0.900344959755,1771,0.678804139517,07,Durham,3706307
Durham,2747,841,0.306152165999,1554,0.56570804514,22,0.00800873680379,40,0.0145613396432,207,0.0753549326538,83,0.0302147797597,1608,60,32,1580,1640,54,0.0196578085184,1608,0.585365853659,347,0.126319621405,2400,0.873680378595,754,0.274481252275,08,Durham,3706308
Durham,3198,1793,0.560662914321,1158,0.362101313321,8,0.00250156347717,69,0.0215759849906,113,0.0353345841151,57,0.0178236397749,1195,28,8,1175,1203,37,0.0115697310819,1195,0.373671044403,215,0.067229518449,2983,0.932770481551,1712,0.535334584115,09,Durham,3706309
Durham,2049,190,0.0927281600781,1680,0.819912152269,11,0.00536847242557,5,0.0024402147389,134,0.0653977550024,29,0.0141532454856,1705,25,13,1693,1718,25,0.0122010736945,1705,0.832113225964,221,0.107857491459,1828,0.892142508541,130,0.0634455832113,10,Durham,3706310
Durham,835,52,0.0622754491018,735,0.880239520958,1,0.00119760479042,5,0.0059880239521,26,0.0311377245509,16,0.0191616766467,747,7,1,741,748,12,0.014371257485,747,0.894610778443,57,0.0682634730539,778,0.931736526946,23,0.0275449101796,12,Durham,3706312
Durham,2145,53,0.0247086247086,1913,0.891841491841,7,0.0032634032634,3,0.0013986013986,121,0.0564102564103,48,0.0223776223776,1955,22,7,1940,1962,42,0.0195804195804,1955,0.911421911422,173,0.0806526806527,1972,0.919347319347,26,0.0121212121212,13,Durham,3706313
Durham,3506,551,0.157159155733,2183,0.622646891044,29,0.00827153451226,11,0.0031374786081,652,0.185966913862,80,0.0228180262407,2229,58,40,2211,2269,46,0.0131203650884,2229,0.635767256132,919,0.26212207644,2587,0.73787792356,362,0.103251568739,14,Durham,3706314
Durham,2671,512,0.191688506177,1623,0.607637588918,27,0.010108573568,4,0.00149756645451,422,0.157993260951,83,0.0310745039311,1661,44,33,1650,1694,38,0.0142268813179,1661,0.621864470236,764,0.286035192812,1907,0.713964807188,257,0.0962186447024,15,Durham,3706315
Durham,2808,1736,0.618233618234,763,0.271723646724,13,0.00462962962963,145,0.0516381766382,68,0.0242165242165,83,0.0295584045584,811,28,18,801,829,48,0.017094017094,811,0.288817663818,135,0.0480769230769,2673,0.951923076923,1686,0.600427350427,16,Durham,3706316
Durham,4448,577,0.129721223022,3119,0.701214028777,27,0.00607014388489,20,0.0044964028777,600,0.134892086331,105,0.0236061151079,3186,69,48,3165,3234,67,0.0150629496403,3186,0.716276978417,907,0.203911870504,3541,0.796088129496,349,0.0784622302158,17,Durham,3706317
Durham,5173,1102,0.213029190025,2554,0.493717378697,63,0.0121786197564,28,0.00541271989175,1283,0.248018557897,143,0.0276435337328,2615,99,75,2591,2690,61,0.011791996907,2615,0.505509375604,2255,0.43591726271,2918,0.56408273729,311,0.0601198530833,18,Durham,3706318
Durham,4671,1270,0.271890387497,2660,0.569471205309,15,0.00321130378934,24,0.00513808606294,540,0.115606936416,162,0.0346820809249,2756,63,31,2724,2787,96,0.0205523442518,2756,0.590023549561,940,0.201241704132,3731,0.798758295868,962,0.205951616356,19,Durham,3706319
Durham,3109,1700,0.546799614024,714,0.22965583789,23,0.00739787713091,44,0.0141524605983,548,0.176262463815,80,0.0257317465423,746,46,34,734,780,32,0.0102926986169,746,0.239948536507,857,0.275651334834,2252,0.724348665166,1431,0.460276616275,20,Durham,3706320
Durham,2567,1443,0.56213478769,657,0.255940786911,10,0.00389559797429,43,0.0167510712894,354,0.13790416829,60,0.0233735878457,694,25,20,689,714,37,0.0144137125049,694,0.270354499416,476,0.185430463576,2091,0.814569536424,1341,0.522399688352,21,Durham,3706321
Durham,7535,1246,0.165361645654,5359,0.711214333112,26,0.00345056403451,74,0.00982083609821,646,0.0857332448573,184,0.0244193762442,5466,90,39,5415,5505,107,0.014200398142,5466,0.725414731254,993,0.131785003318,6542,0.868214996682,1027,0.136297279363,22,Durham,3706322
Durham,8140,1822,0.223832923833,5392,0.662407862408,35,0.00429975429975,218,0.0267813267813,444,0.0545454545455,229,0.0281326781327,5565,107,50,5508,5615,173,0.0212530712531,5565,0.683660933661,732,0.0899262899263,7408,0.910073710074,1657,0.203562653563,23,Durham,3706323
Durham,5003,2982,0.596042374575,1400,0.27983210074,27,0.00539676194283,133,0.0265840495703,349,0.0697581451129,112,0.0223865680592,1460,50,38,1448,1498,60,0.0119928043174,1460,0.291824905057,593,0.11852888267,4410,0.88147111733,2809,0.561463122127,24,Durham,3706324
Durham,4074,3291,0.807805596465,499,0.122484045164,14,0.00343642611684,73,0.0179185076092,106,0.0260186548846,91,0.0223367697595,547,48,28,527,575,48,0.0117820324006,547,0.134266077565,215,0.0527736867943,3859,0.947226313206,3213,0.788659793814,25,Durham,3706325
Durham,1817,1490,0.820033021464,247,0.135938359934,7,0.00385250412768,6,0.00330214639516,23,0.0126582278481,44,0.0242157402312,257,12,10,255,267,10,0.00550357732526,257,0.141441937259,66,0.0363236103467,1751,0.963676389653,1469,0.808475509081,26,Durham,3706326
Durham,3392,2814,0.829599056604,301,0.0887382075472,5,0.00147405660377,118,0.0347877358491,98,0.028891509434,56,0.0165094339623,319,22,17,314,336,18,0.00530660377358,319,0.0940448113208,176,0.0518867924528,3216,0.948113207547,2740,0.807783018868,27,Durham,3706327
Durham,4317,3471,0.804030576789,616,0.14269168404,19,0.00440120454019,67,0.0155200370628,75,0.0173731758165,69,0.0159833217512,660,44,29,645,689,44,0.0101922631457,660,0.152883947186,124,0.0287236506833,4193,0.971276349317,3427,0.793838313644,28,Durham,3706328
Durham,6145,2986,0.485923515053,2304,0.374938974776,32,0.00520748576078,26,0.00423108218063,651,0.105939788446,146,0.0237591537836,2379,66,44,2357,2423,75,0.0122050447518,2379,0.387144019528,1042,0.169568755085,5103,0.830431244915,2675,0.435313262815,29,Durham,3706329
Durham,8257,3629,0.439505873804,3246,0.393120988252,64,0.00775099915223,222,0.0268862783093,925,0.112026159622,171,0.0207097008599,3342,97,79,3324,3421,96,0.0116264987284,3342,0.404747486981,1439,0.174276371564,6818,0.825723628436,3213,0.389124379315,30-1,Durham,3706330-1
Durham,9369,2467,0.263315188387,6022,0.642758031807,34,0.00362898921977,123,0.0131284021774,526,0.0561425979293,197,0.0210267904792,6167,97,55,6125,6222,145,0.0154765716725,6167,0.65823460348,861,0.0918988152418,8508,0.908101184758,2233,0.238339203757,30-2,Durham,3706330-2
Durham,5353,2615,0.488511115262,1964,0.366897067065,57,0.0106482346348,132,0.0246590696806,448,0.0836913880067,137,0.0255931253503,2046,107,78,2017,2124,82,0.0153185129834,2046,0.382215580049,763,0.142536895199,4590,0.857463104801,2396,0.447599476929,31,Durham,3706331
Durham,3213,2645,0.823218176159,336,0.104575163399,7,0.00217864923747,94,0.0292561469032,82,0.025521319639,49,0.0152505446623,352,17,15,350,367,16,0.00497976968565,352,0.109554933084,188,0.0585122938064,3025,0.941487706194,2556,0.795518207283,32,Durham,3706332
Durham,8481,3544,0.41787525056,3442,0.405848366938,38,0.00448060370239,858,0.101167315175,345,0.0406791651928,254,0.0299492984318,3597,105,57,3549,3654,155,0.0182761466808,3597,0.424124513619,754,0.0889046103054,7727,0.911095389695,3235,0.381440867822,33,Durham,3706333
Durham,11492,3133,0.272624434389,6496,0.565262791507,32,0.00278454577097,608,0.0529063696485,898,0.0781413156979,325,0.0282805429864,6692,120,50,6622,6742,196,0.0170553428472,6692,0.582318134354,1560,0.135746606335,9932,0.864253393665,2628,0.228680821441,34,Durham,3706334
Durham,9834,5721,0.581757169005,2770,0.281675818589,58,0.00589790522676,746,0.0758592637787,266,0.0270490136262,273,0.0277608297743,2894,129,95,2860,2989,124,0.0126093146227,2894,0.294285133211,667,0.0678259101078,9167,0.932174089892,5382,0.547284929835,35,Durham,3706335
Durham,5174,2151,0.415732508697,1473,0.28469269424,31,0.00599149594124,225,0.0434866640897,1049,0.202744491689,245,0.0473521453421,1556,84,61,1533,1617,83,0.0160417471975,1556,0.300734441438,1668,0.322381136451,3506,0.677618863549,1693,0.327212988017,36,Durham,3706336
Durham,6429,4830,0.751283247783,913,0.142012754705,51,0.0079328044797,215,0.0334422149634,275,0.042774926116,145,0.0225540519521,975,81,63,957,1038,62,0.00964380152434,975,0.15165655623,637,0.0990822834033,5792,0.900917716597,4578,0.712085860943,37,Durham,3706337
Durham,9238,4706,0.509417622862,2240,0.242476726564,65,0.00703615501191,839,0.0908205239229,1032,0.111712491881,356,0.0385364797575,2414,180,112,2346,2526,174,0.0188352457242,2414,0.261311972288,2106,0.227971422386,7132,0.772028577614,3850,0.416756873782,38,Durham,3706338
Durham,3723,2866,0.76980929358,620,0.166532366371,14,0.0037604082729,114,0.030620467365,52,0.0139672307279,57,0.0153102336825,649,35,20,634,669,29,0.00778941713672,649,0.174321783508,134,0.0359924791835,3589,0.964007520817,2784,0.747784045125,39,Durham,3706339
Durham,2585,1273,0.492456479691,887,0.343133462282,20,0.00773694390716,56,0.02166344294,265,0.10251450677,84,0.0324951644101,934,55,33,912,967,47,0.0181818181818,934,0.361315280464,456,0.176402321083,2129,0.823597678917,1118,0.43249516441,40,Durham,3706340
Durham,1703,46,0.0270111567821,1552,0.911332941867,12,0.00704638872578,6,0.00352319436289,68,0.0399295361127,19,0.0111567821491,1570,22,12,1560,1582,18,0.0105695830887,1570,0.921902524956,92,0.0540223135643,1611,0.945977686436,33,0.0193775689959,41,Durham,3706341
Durham,1648,65,0.0394417475728,1415,0.858616504854,11,0.00667475728155,0,0.0,134,0.0813106796117,23,0.0139563106796,1435,25,12,1422,1447,20,0.0121359223301,1435,0.870752427184,178,0.108009708738,1470,0.891990291262,24,0.0145631067961,42,Durham,3706342
Durham,7345,5856,0.797277059224,533,0.0725663716814,21,0.00285908781484,709,0.0965282505106,73,0.00993873383254,153,0.0208304969367,588,54,41,575,629,55,0.0074880871341,588,0.0800544588155,316,0.0430224642614,7029,0.956977535739,5629,0.766371681416,43,Durham,3706343
Durham,7653,5555,0.725859140206,1487,0.194302887756,20,0.00261335424017,297,0.0388083104665,146,0.0190774859532,148,0.0193388213772,1538,58,43,1523,1581,51,0.00666405331243,1538,0.200966941069,304,0.0397229844505,7349,0.960277015549,5426,0.709003005357,44,Durham,3706344
Durham,6717,4714,0.701801399434,1412,0.21021289266,21,0.00312639571237,216,0.0321572130415,199,0.0296263212744,155,0.023075777877,1495,60,48,1483,1543,83,0.0123567068632,1495,0.222569599524,356,0.052999851124,6361,0.947000148876,4578,0.681554265297,45,Durham,3706345
Durham,6673,2217,0.332234377342,2647,0.396673160498,20,0.00299715270493,193,0.0289225236026,1384,0.207402967181,212,0.0317698186723,2761,78,52,2735,2813,114,0.0170837704181,2761,0.413756930916,1865,0.279484489735,4808,0.720515510265,1860,0.278735201559,46,Durham,3706346
Durham,2589,156,0.0602549246813,2099,0.810737736578,23,0.00888373889533,2,0.000772499034376,256,0.0988798764002,53,0.020471224411,2133,41,25,2117,2158,34,0.0131324835844,2133,0.823870220162,370,0.14291232136,2219,0.85708767864,93,0.0359212050985,47,Durham,3706347
Durham,2306,1406,0.609713790113,678,0.294015611448,6,0.00260190806592,101,0.0437987857762,45,0.0195143104944,70,0.0303555941023,728,28,13,713,741,50,0.021682567216,728,0.315698178664,148,0.0641803989592,2158,0.935819601041,1325,0.574588031223,48,Durham,3706348
Durham,4761,3004,0.630959882378,1052,0.220961982777,14,0.00294055870615,342,0.0718336483932,216,0.0453686200378,133,0.0279353077085,1102,39,32,1095,1134,50,0.0105019953791,1102,0.231463978156,394,0.0827557235875,4367,0.917244276413,2861,0.600924175593,50,Durham,3706350
Durham,5848,4075,0.696819425445,1050,0.179548563611,18,0.0030779753762,444,0.0759233926129,101,0.0172708618331,160,0.0273597811218,1123,54,33,1102,1156,73,0.0124829001368,1123,0.192031463748,299,0.0511285909713,5549,0.948871409029,3904,0.667578659371,51,Durham,3706351
Durham,5978,827,0.138340582134,4010,0.670792907327,46,0.00769488123118,46,0.00769488123118,903,0.151053864169,146,0.0244228839077,4116,98,57,4075,4173,106,0.0177316828371,4116,0.688524590164,1256,0.210103713617,4722,0.789896286383,584,0.0976915356306,52,Durham,3706352
Durham,4417,2757,0.624179307222,916,0.207380575051,17,0.00384876613086,525,0.118858954041,66,0.014942268508,136,0.0307901290469,960,46,31,945,991,44,0.00996151233869,960,0.21734208739,195,0.044147611501,4222,0.955852388499,2652,0.600407516414,53-1,Durham,3706353-1
Durham,4556,3500,0.768217734855,542,0.118964003512,11,0.00241439859526,312,0.0684811237928,71,0.0155838454785,120,0.0263388937665,597,29,22,590,619,55,0.0120719929763,597,0.131035996488,205,0.0449956101844,4351,0.955004389816,3382,0.742317822651,53-2,Durham,3706353-2
Durham,9293,4058,0.436672764446,3732,0.401592596578,20,0.00215215753793,838,0.0901754008393,349,0.0375551490369,296,0.0318519315614,3895,73,41,3863,3936,163,0.0175400839341,3895,0.419132680512,741,0.0797374367804,8552,0.92026256322,3777,0.406434951038,54,Durham,3706354
Durham,5040,143,0.028373015873,4584,0.909523809524,35,0.00694444444444,10,0.00198412698413,210,0.0416666666667,58,0.0115079365079,4633,54,36,4615,4669,49,0.00972222222222,4633,0.919246031746,275,0.0545634920635,4765,0.945436507937,88,0.0174603174603,55,Durham,3706355
Edgecombe,3800,454,0.119473684211,3249,0.855,2,0.000526315789474,2,0.000526315789474,79,0.0207894736842,14,0.00368421052632,3257,8,6,3255,3263,8,0.00210526315789,3257,0.857105263158,87,0.0228947368421,3713,0.977105263158,445,0.117105263158,0101,Edgecombe,370650101
Edgecombe,4598,2224,0.483688560244,2226,0.48412353197,14,0.00304480208786,13,0.00282731622445,61,0.0132666376686,60,0.0130491518051,2257,37,28,2248,2285,31,0.00674206176599,2257,0.490865593736,138,0.0300130491518,4460,0.969986950848,2175,0.473031752936,0102,Edgecombe,370650102
Edgecombe,3794,1968,0.518713758566,1526,0.40221402214,6,0.00158144438587,31,0.00817079599367,238,0.0627306273063,25,0.0065893516078,1538,12,9,1535,1547,12,0.00316288877174,1538,0.405376910912,371,0.0977859778598,3423,0.90221402214,1857,0.489457037428,0103,Edgecombe,370650103
Edgecombe,2997,1523,0.508174841508,1390,0.463797130464,2,0.000667334000667,18,0.00600600600601,48,0.016016016016,16,0.00533867200534,1399,3,2,1398,1401,9,0.003003003003,1399,0.466800133467,99,0.033033033033,2898,0.966966966967,1493,0.498164831498,0104,Edgecombe,370650104
Edgecombe,1906,934,0.490031479538,900,0.472193074502,3,0.00157397691501,3,0.00157397691501,51,0.0267576075551,15,0.00786988457503,910,8,7,909,917,10,0.00524658971668,910,0.477439664218,72,0.0377754459601,1834,0.96222455404,913,0.479013641133,0201,Edgecombe,370650201
Edgecombe,737,395,0.535956580733,299,0.405698778833,1,0.00135685210312,0,0.0,31,0.0420624151967,11,0.0149253731343,307,4,2,305,309,8,0.010854816825,307,0.416553595658,41,0.055630936228,696,0.944369063772,384,0.521031207598,0301,Edgecombe,370650301
Edgecombe,910,416,0.457142857143,463,0.508791208791,4,0.0043956043956,5,0.00549450549451,22,0.0241758241758,0,0.0,463,4,4,463,467,0,0.0,463,0.508791208791,34,0.0373626373626,876,0.962637362637,403,0.442857142857,0401,Edgecombe,370650401
Edgecombe,1282,595,0.464118564743,435,0.339313572543,3,0.00234009360374,2,0.0015600624025,222,0.173166926677,25,0.0195007800312,451,10,7,448,458,16,0.01248049922,451,0.351794071763,274,0.213728549142,1008,0.786271450858,546,0.425897035881,0501,Edgecombe,370650501
Edgecombe,1560,464,0.297435897436,1014,0.65,13,0.00833333333333,1,0.000641025641026,34,0.0217948717949,34,0.0217948717949,1040,32,18,1026,1058,26,0.0166666666667,1040,0.666666666667,62,0.0397435897436,1498,0.960256410256,455,0.291666666667,0601,Edgecombe,370650601
Edgecombe,3524,1060,0.300794551646,2271,0.644438138479,22,0.00624290578888,10,0.00283768444949,143,0.0405788876277,18,0.00510783200908,2281,27,26,2280,2307,10,0.00283768444949,2281,0.647275822928,177,0.050227014756,3347,0.949772985244,1031,0.292565266742,0701,Edgecombe,370650701
Edgecombe,2554,1583,0.619812059514,782,0.306186374315,15,0.00587314017228,1,0.000391542678152,133,0.0520751761942,40,0.0156617071261,800,27,22,795,822,18,0.00704776820673,800,0.313234142522,195,0.0763508222396,2359,0.92364917776,1549,0.606499608457,0801,Edgecombe,370650801
Edgecombe,1807,1392,0.770337576093,359,0.198671831765,0,0.0,13,0.00719424460432,20,0.011068068622,23,0.0127282789153,372,5,3,370,375,13,0.00719424460432,372,0.20586607637,44,0.0243497509685,1763,0.975650249032,1374,0.760376314333,0901,Edgecombe,370650901
Edgecombe,3303,1676,0.507417499243,1559,0.471995155919,8,0.00242204056918,6,0.00181653042688,38,0.0115046927036,16,0.00484408113836,1572,9,9,1572,1581,13,0.00393581592492,1572,0.475930971844,71,0.0214956100515,3232,0.978504389949,1647,0.49863760218,1001,Edgecombe,370651001
Edgecombe,1931,1169,0.605385810461,634,0.328327291559,18,0.00932159502848,1,0.000517866390471,79,0.0409114448472,30,0.0155359917141,648,35,27,640,675,14,0.0072501294666,648,0.335577421025,157,0.081305023304,1774,0.918694976696,1105,0.572242361471,1101,Edgecombe,370651101
Edgecombe,5666,258,0.0455347687963,5307,0.936639604659,21,0.0037063183904,3,0.000529474055771,19,0.00335333568655,58,0.0102364984116,5359,53,25,5331,5384,52,0.00917755030004,5359,0.945817154959,60,0.0105894811154,5606,0.989410518885,247,0.0435933639252,1201,Edgecombe,370651201
Edgecombe,3326,197,0.0592303066747,3062,0.920625375827,12,0.00360793746242,2,0.000601322910403,4,0.00120264582081,49,0.0147324113049,3103,25,15,3093,3118,41,0.0123271196633,3103,0.93295249549,30,0.00901984365604,3296,0.990980156344,189,0.0568250150331,1202,Edgecombe,370651202
Edgecombe,4623,2408,0.520873891413,2107,0.455764654986,7,0.00151416828899,8,0.00173047804456,52,0.0112481072896,41,0.00886869997837,2132,26,17,2123,2149,25,0.00540774388925,2132,0.461172398875,105,0.0227125243348,4518,0.977287475665,2364,0.511356262167,1203,Edgecombe,370651203
Edgecombe,2460,103,0.0418699186992,2304,0.936585365854,12,0.00487804878049,1,0.000406504065041,6,0.00243902439024,34,0.0138211382114,2335,24,12,2323,2347,31,0.0126016260163,2335,0.94918699187,16,0.00650406504065,2444,0.993495934959,103,0.0418699186992,1204,Edgecombe,370651204
Edgecombe,1822,44,0.0241492864984,1743,0.956641053787,3,0.00164654226125,1,0.000548847420417,15,0.00823271130626,16,0.00878155872667,1758,12,4,1750,1762,15,0.00823271130626,1758,0.964873765093,17,0.00933040614709,1805,0.990669593853,44,0.0241492864984,1205,Edgecombe,370651205
Edgecombe,2134,1629,0.7633552015,453,0.212277413308,2,0.000937207122774,6,0.00281162136832,20,0.00937207122774,24,0.0112464854733,471,8,5,468,476,18,0.00843486410497,471,0.220712277413,32,0.0149953139644,2102,0.985004686036,1620,0.759137769447,1301,Edgecombe,370651301
Edgecombe,1818,1431,0.787128712871,352,0.193619361936,1,0.000550055005501,1,0.000550055005501,11,0.00605060506051,22,0.012101210121,353,16,15,352,368,1,0.000550055005501,353,0.194169416942,22,0.012101210121,1796,0.987898789879,1416,0.778877887789,1401,Edgecombe,370651401
Forsyth,6279,4838,0.770504857461,912,0.14524605829,27,0.00430004777831,163,0.0259595476987,223,0.0355152094283,116,0.0184742793438,979,63,42,958,1021,67,0.0106704889314,979,0.155916547221,465,0.0740563784042,5814,0.925943621596,4611,0.734352603918,011,Forsyth,37067011
Forsyth,3884,3445,0.886972193615,187,0.0481462409887,23,0.00592173017508,42,0.0108135942327,134,0.0345005149331,53,0.0136457260556,202,40,39,201,241,15,0.00386199794027,202,0.0520082389289,258,0.0664263645726,3626,0.933573635427,3358,0.864572605561,012,Forsyth,37067012
Forsyth,5209,4156,0.797849875216,759,0.145709349203,19,0.00364753311576,94,0.0180456901517,95,0.0182376655788,86,0.0165098867345,801,38,32,795,833,42,0.0080629679401,801,0.153772317143,233,0.0447302745249,4976,0.955269725475,4037,0.775004799386,013,Forsyth,37067013
Forsyth,3034,2626,0.865524060646,207,0.0682267633487,13,0.00428477257746,59,0.0194462755438,84,0.0276862228082,45,0.0148319050758,220,33,28,215,248,13,0.00428477257746,220,0.0725115359262,121,0.0398813447594,2913,0.960118655241,2587,0.852669742914,014,Forsyth,37067014
Forsyth,2439,2084,0.854448544485,222,0.0910209102091,3,0.00123001230012,44,0.0180401804018,40,0.0164001640016,46,0.0188601886019,241,16,7,232,248,19,0.00779007790078,241,0.0988109881099,110,0.0451004510045,2329,0.954899548995,2032,0.833128331283,015,Forsyth,37067015
Forsyth,4711,4336,0.920399066016,234,0.0496709828062,18,0.00382084483125,17,0.00360857567395,51,0.0108257270219,55,0.011674803651,255,39,35,251,290,21,0.00445765230312,255,0.0541286351093,132,0.0280195287625,4579,0.971980471238,4283,0.909148800679,021,Forsyth,37067021
Forsyth,2756,1984,0.719883889695,621,0.225326560232,8,0.00290275761974,7,0.00253991291727,102,0.0370101596517,34,0.0123367198839,644,18,16,642,660,23,0.00834542815675,644,0.233671988389,161,0.0584179970972,2595,0.941582002903,1935,0.702104499274,031,Forsyth,37067031
Forsyth,3265,2662,0.815313935681,462,0.141500765697,10,0.00306278713629,32,0.00980091883614,60,0.0183767228178,39,0.0119448698315,486,21,17,482,503,24,0.00735068912711,486,0.148851454824,122,0.0373660030628,3143,0.962633996937,2598,0.795712098009,032,Forsyth,37067032
Forsyth,4131,2192,0.530622125393,1313,0.317840716534,32,0.0077463083999,45,0.0108932461874,479,0.115952553861,70,0.0169450496248,1357,51,41,1347,1398,44,0.0106511740499,1357,0.328491890583,721,0.174534011135,3410,0.825465988865,1988,0.481239409344,033,Forsyth,37067033
Forsyth,3332,2493,0.748199279712,493,0.147959183673,9,0.00270108043217,18,0.00540216086435,240,0.0720288115246,79,0.0237094837935,540,21,16,535,556,47,0.0141056422569,540,0.16206482593,426,0.127851140456,2906,0.872148859544,2344,0.703481392557,034,Forsyth,37067034
Forsyth,4714,2842,0.602885023335,1064,0.22571064913,38,0.00806109461179,60,0.0127280441239,574,0.121764955452,136,0.0288502333475,1135,57,46,1124,1181,71,0.0150615188799,1135,0.24077216801,958,0.203224437845,3756,0.796775562155,2560,0.543063215952,042,Forsyth,37067042
Forsyth,5964,3031,0.508215962441,1238,0.20757880617,42,0.00704225352113,23,0.00385647216633,1511,0.253353454058,119,0.0199530516432,1292,59,55,1288,1347,54,0.00905432595573,1292,0.216633132126,2219,0.3720657277,3745,0.6279342723,2492,0.417840375587,043,Forsyth,37067043
Forsyth,3862,3334,0.863283272916,272,0.0704298291041,8,0.00207146556189,89,0.023045054376,110,0.0284826514759,49,0.0126877265665,292,20,15,287,307,20,0.00517866390471,292,0.0756084930088,299,0.0774210253755,3563,0.922578974625,3167,0.820041429311,051,Forsyth,37067051
Forsyth,1489,1385,0.930154466085,44,0.0295500335796,1,0.000671591672263,24,0.0161182001343,11,0.0073875083949,24,0.0161182001343,51,10,8,49,59,7,0.00470114170584,51,0.0342511752854,24,0.0161182001343,1465,0.983881799866,1370,0.920080591001,052,Forsyth,37067052
Forsyth,2450,2182,0.890612244898,157,0.0640816326531,5,0.00204081632653,55,0.0224489795918,22,0.00897959183673,29,0.0118367346939,176,6,5,175,181,19,0.00775510204082,176,0.0718367346939,84,0.0342857142857,2366,0.965714285714,2124,0.86693877551,053,Forsyth,37067053
Forsyth,3206,2954,0.921397379913,144,0.044915782907,4,0.00124766063631,63,0.0196506550218,20,0.00623830318153,21,0.00655021834061,152,9,8,151,160,8,0.00249532127261,152,0.0474111041797,74,0.0230817217717,3132,0.976918278228,2904,0.905801621959,054,Forsyth,37067054
Forsyth,3873,3312,0.855151045701,208,0.0537051381358,8,0.00206558223599,262,0.0676478182288,26,0.00671314226698,57,0.0147172734314,251,16,12,247,263,43,0.0111025045185,251,0.0648076426543,151,0.0389878647044,3722,0.961012135296,3199,0.825974696618,055,Forsyth,37067055
Forsyth,3755,2704,0.720106524634,367,0.0977363515313,39,0.0103861517976,53,0.0141145139814,478,0.127296937417,114,0.0303595206391,409,68,61,402,470,42,0.0111850865513,409,0.108921438083,868,0.231158455393,2887,0.768841544607,2419,0.644207723036,061,Forsyth,37067061
Forsyth,2435,2133,0.875975359343,202,0.0829568788501,4,0.00164271047228,32,0.0131416837782,35,0.0143737166324,29,0.011909650924,209,9,9,209,218,7,0.00287474332649,209,0.0858316221766,96,0.0394250513347,2339,0.960574948665,2078,0.853388090349,062,Forsyth,37067062
Forsyth,5332,4313,0.808889722431,691,0.129594898725,23,0.0043135783946,54,0.010127531883,149,0.0279444861215,102,0.0191297824456,760,61,42,741,802,69,0.0129407351838,760,0.142535633908,253,0.0474493623406,5079,0.952550637659,4232,0.793698424606,063,Forsyth,37067063
Forsyth,1938,1543,0.796181630547,169,0.0872033023736,13,0.00670794633643,8,0.00412796697626,163,0.0841073271414,42,0.0216718266254,185,28,27,184,212,16,0.00825593395253,185,0.0954592363261,275,0.141898864809,1663,0.858101135191,1453,0.749742002064,064,Forsyth,37067064
Forsyth,4897,4029,0.822748621605,520,0.106187461711,11,0.00224627322851,138,0.0281805186849,120,0.0245047988564,79,0.0161323259138,563,23,20,560,583,43,0.00878088625689,563,0.114968347968,240,0.0490095977129,4657,0.950990402287,3940,0.80457422912,065,Forsyth,37067065
Forsyth,4138,3266,0.78927017883,305,0.0737071048816,8,0.00193330111165,61,0.0147414209763,391,0.0944900918318,107,0.0258579023683,349,38,31,342,380,44,0.0106331561141,349,0.0843402609957,804,0.194296761721,3334,0.805703238279,2919,0.705413243113,066,Forsyth,37067066
Forsyth,3205,2361,0.736661466459,533,0.166302652106,7,0.00218408736349,44,0.013728549142,161,0.0502340093604,99,0.0308892355694,581,28,20,573,601,48,0.014976599064,581,0.18127925117,312,0.0973478939158,2893,0.902652106084,2233,0.696723868955,067,Forsyth,37067067
Forsyth,3233,2904,0.898236931642,225,0.069594803588,15,0.00463965357253,17,0.00525827404887,21,0.00649551500155,51,0.0157748221466,257,25,21,253,278,32,0.0098979276214,257,0.0794927312094,98,0.0303124033406,3135,0.969687596659,2835,0.876894525209,068,Forsyth,37067068
Forsyth,4679,4114,0.879247702501,278,0.0594144047873,5,0.00106860440265,138,0.0294934815131,49,0.010472323146,95,0.0203034836504,338,21,14,331,352,60,0.0128232528318,338,0.0722376576191,180,0.0384697584954,4499,0.961530241505,3990,0.852746313315,071,Forsyth,37067071
Forsyth,8360,6494,0.776794258373,677,0.080980861244,32,0.00382775119617,300,0.0358851674641,701,0.0838516746411,156,0.0186602870813,758,56,49,751,807,81,0.00968899521531,758,0.0906698564593,1086,0.12990430622,7274,0.87009569378,6174,0.738516746411,072,Forsyth,37067072
Forsyth,3565,3357,0.941654978962,114,0.0319775596073,12,0.00336605890603,30,0.00841514726508,19,0.00532959326788,33,0.00925666199158,125,26,23,122,148,11,0.00308555399719,125,0.0350631136045,85,0.0238429172511,3480,0.976157082749,3295,0.924263674614,073,Forsyth,37067073
Forsyth,4141,3359,0.811156725429,420,0.101424776624,10,0.0024148756339,205,0.049504950495,54,0.0130403284231,93,0.0224583433953,459,34,21,446,480,39,0.00941801497223,459,0.110842791596,179,0.0432262738469,3962,0.956773726153,3266,0.788698382033,074,Forsyth,37067074
Forsyth,859,801,0.932479627474,25,0.0291036088475,3,0.0034924330617,11,0.0128055878929,5,0.0058207217695,14,0.0162980209546,35,10,7,32,42,10,0.011641443539,35,0.0407450523865,20,0.023282887078,839,0.976717112922,791,0.920838183935,075,Forsyth,37067075
Forsyth,5284,2731,0.51684330053,1763,0.333648750946,46,0.00870552611658,84,0.0158970476911,531,0.100492051476,129,0.02441332324,1839,83,78,1834,1917,76,0.0143830431491,1839,0.348031794095,787,0.148940196821,4497,0.851059803179,2548,0.482210446631,081,Forsyth,37067081
Forsyth,5448,3227,0.592327459618,1940,0.356093979442,21,0.00385462555066,40,0.00734214390602,141,0.0258810572687,79,0.0145007342144,1984,34,27,1977,2011,44,0.00807635829662,1984,0.364170337739,280,0.0513950073421,5168,0.948604992658,3125,0.573604992658,082,Forsyth,37067082
Forsyth,3611,1676,0.464137358073,1524,0.422043755192,22,0.0060924951537,24,0.00664635834949,276,0.0764331210191,89,0.0246469122127,1593,49,30,1574,1623,69,0.0191082802548,1593,0.441152035447,375,0.103849349211,3236,0.896150650789,1603,0.443921351426,083,Forsyth,37067083
Forsyth,3100,2704,0.872258064516,299,0.0964516129032,19,0.00612903225806,13,0.0041935483871,38,0.0122580645161,27,0.00870967741935,306,31,31,306,337,7,0.00225806451613,306,0.0987096774194,79,0.0254838709677,3021,0.974516129032,2671,0.861612903226,091,Forsyth,37067091
Forsyth,2366,2194,0.927303465765,100,0.0422654268808,8,0.00338123415046,13,0.00549450549451,26,0.010989010989,25,0.0105663567202,105,19,19,105,124,5,0.00211327134404,105,0.0443786982249,62,0.0262045646661,2304,0.973795435334,2169,0.916737109045,092,Forsyth,37067092
Forsyth,3763,2094,0.556470900877,783,0.208078660643,15,0.00398618123837,23,0.00611214456551,738,0.196120116928,110,0.0292319957481,826,42,36,820,862,43,0.0114270528833,826,0.219505713526,992,0.263619452564,2771,0.736380547436,1894,0.503321817699,101,Forsyth,37067101
Forsyth,2582,2308,0.893880712626,164,0.0635166537568,19,0.00735863671572,3,0.00116189000775,56,0.0216886134779,32,0.012393493416,177,33,33,177,210,13,0.00503485670023,177,0.068551510457,95,0.0367931835786,2487,0.963206816421,2278,0.882261812548,111,Forsyth,37067111
Forsyth,4517,3648,0.80761567412,675,0.149435466017,35,0.00774850564534,17,0.00376355988488,75,0.0166039406686,67,0.0148328536639,711,64,54,701,765,36,0.00796989152092,711,0.157405357538,192,0.0425060881116,4325,0.957493911888,3552,0.786362630064,112,Forsyth,37067112
Forsyth,6860,4320,0.629737609329,1861,0.271282798834,14,0.00204081632653,271,0.0395043731778,233,0.0339650145773,161,0.0234693877551,1928,42,36,1922,1964,67,0.0097667638484,1928,0.281049562682,538,0.0784256559767,6322,0.921574344023,4067,0.592857142857,122,Forsyth,37067122
Forsyth,3643,2673,0.733735931924,615,0.168816909141,8,0.00219599231403,139,0.0381553664562,112,0.0307438923964,96,0.0263519077683,660,36,23,647,683,45,0.0123524567664,660,0.181169365907,228,0.0625857809498,3415,0.93741421905,2594,0.712050507823,123,Forsyth,37067123
Forsyth,3927,3322,0.84593837535,408,0.103896103896,7,0.0017825311943,77,0.0196078431373,32,0.00814871403107,81,0.0206264323911,442,31,27,438,469,34,0.00865800865801,442,0.112554112554,124,0.0315762668704,3803,0.96842373313,3244,0.826075884899,131,Forsyth,37067131
Forsyth,4345,3714,0.854775604143,425,0.0978135788262,20,0.00460299194476,81,0.0186421173763,45,0.0103567318757,60,0.0138089758343,441,33,30,438,471,16,0.00368239355581,441,0.101495972382,115,0.0264672036824,4230,0.973532796318,3656,0.841426927503,132,Forsyth,37067132
Forsyth,6344,5756,0.907313997478,247,0.0389344262295,30,0.0047288776797,127,0.0200189155107,97,0.015290037831,87,0.0137137452711,264,55,51,260,315,17,0.00267969735183,264,0.0416141235813,223,0.0351513240858,6121,0.964848675914,5657,0.891708701135,133,Forsyth,37067133
Forsyth,7208,2399,0.33282463929,3799,0.52705327414,31,0.00430077691454,146,0.0202552719201,651,0.0903163152053,182,0.0252497225305,3935,90,43,3888,3978,136,0.0188679245283,3935,0.545921198668,1153,0.159961154273,6055,0.840038845727,2013,0.279273029967,201,Forsyth,37067201
Forsyth,2569,65,0.025301673803,2286,0.889840404827,10,0.00389256520047,11,0.00428182172051,137,0.0533281432464,60,0.0233553912028,2330,29,15,2316,2345,44,0.0171272868821,2330,0.906967691709,244,0.0949785908914,2325,0.905021409109,22,0.00856364344103,203,Forsyth,37067203
Forsyth,2521,410,0.162633875446,1667,0.661245537485,21,0.00833002776676,43,0.0170567235224,309,0.122570408568,71,0.0281634272114,1722,49,22,1695,1744,55,0.0218167393891,1722,0.683062276874,424,0.168187227291,2097,0.831812772709,355,0.140817136057,204,Forsyth,37067204
Forsyth,1201,64,0.0532889258951,1032,0.859283930058,2,0.00166527893422,0,0.0,69,0.0574521232306,34,0.0283097418818,1060,15,4,1049,1064,28,0.0233139050791,1060,0.882597835137,93,0.0774354704413,1108,0.922564529559,47,0.0391340549542,205,Forsyth,37067205
Forsyth,2757,553,0.20058034095,1705,0.618425825172,15,0.00544069640914,7,0.0025389916576,415,0.150525933986,62,0.0224882118244,1745,37,27,1735,1772,40,0.0145085237577,1745,0.63293434893,661,0.239753355096,2096,0.760246644904,360,0.130576713819,206,Forsyth,37067206
Forsyth,4755,1446,0.304100946372,2012,0.423133543638,31,0.00651945320715,92,0.0193480546793,1016,0.213669821241,158,0.0332281808623,2111,53,41,2099,2152,99,0.0208201892744,2111,0.443953732913,1503,0.316088328076,3252,0.683911671924,1077,0.226498422713,207,Forsyth,37067207
Forsyth,1677,62,0.0369707811568,1472,0.877757901014,8,0.00477042337507,2,0.00119260584377,103,0.0614192009541,30,0.0178890876565,1498,11,8,1495,1506,26,0.015503875969,1498,0.893261776983,198,0.118067978533,1479,0.881932021467,17,0.010137149672,301,Forsyth,37067301
Forsyth,1930,181,0.0937823834197,1366,0.707772020725,13,0.00673575129534,8,0.00414507772021,321,0.166321243523,41,0.0212435233161,1392,24,14,1382,1406,26,0.0134715025907,1392,0.721243523316,445,0.230569948187,1485,0.769430051813,113,0.0585492227979,302,Forsyth,37067302
Forsyth,1516,45,0.0296833773087,1289,0.850263852243,3,0.00197889182058,0,0.0,139,0.0916886543536,40,0.0263852242744,1321,12,3,1312,1324,32,0.0211081794195,1321,0.871372031662,170,0.112137203166,1346,0.887862796834,22,0.0145118733509,303,Forsyth,37067303
Forsyth,2603,68,0.0261237034191,2375,0.912408759124,6,0.00230503265463,10,0.00384172109105,90,0.0345754898194,54,0.0207452938917,2427,40,8,2395,2435,52,0.0199769496735,2427,0.932385708798,136,0.0522474068383,2467,0.947752593162,40,0.0153668843642,304,Forsyth,37067304
Forsyth,1876,104,0.0554371002132,1658,0.883795309168,1,0.000533049040512,5,0.00266524520256,56,0.0298507462687,52,0.0277185501066,1704,24,6,1686,1710,46,0.0245202558635,1704,0.908315565032,71,0.0378464818763,1805,0.962153518124,98,0.0522388059701,305,Forsyth,37067305
Forsyth,3498,891,0.254716981132,1662,0.47512864494,39,0.0111492281304,9,0.00257289879931,793,0.226700971984,104,0.0297312750143,1734,65,54,1723,1788,72,0.0205831903945,1734,0.495711835334,1145,0.327329902802,2353,0.672670097198,637,0.182104059463,306,Forsyth,37067306
Forsyth,3534,589,0.166666666667,2114,0.598189020939,24,0.00679117147708,12,0.00339558573854,715,0.202320316921,80,0.0226372382569,2164,49,33,2148,2197,50,0.0141482739106,2164,0.61233729485,1049,0.296830786644,2485,0.703169213356,383,0.108375778155,401,Forsyth,37067401
Forsyth,2138,66,0.0308699719364,1897,0.887277829747,3,0.00140318054256,0,0.0,138,0.0645463049579,34,0.0159027128157,1925,10,4,1919,1929,28,0.0130963517306,1925,0.900374181478,164,0.0767072029935,1974,0.923292797007,51,0.0238540692236,402,Forsyth,37067402
Forsyth,2891,281,0.0971982013144,2331,0.806295399516,16,0.00553441715669,10,0.00345901072293,205,0.0709097198201,48,0.0166032514701,2370,38,19,2351,2389,39,0.0134901418194,2370,0.819785541335,303,0.104808024905,2588,0.895191975095,234,0.0809408509166,403,Forsyth,37067403
Forsyth,3546,792,0.223350253807,2525,0.712069937958,5,0.00141003948111,31,0.00874224478285,100,0.0282007896221,93,0.0262267343486,2601,51,14,2564,2615,76,0.0214326001128,2601,0.733502538071,250,0.0705019740553,3296,0.929498025945,670,0.188945290468,404,Forsyth,37067404
Forsyth,4027,209,0.051899677179,3305,0.820710206109,10,0.00248323814254,4,0.000993295257015,354,0.0879066302458,145,0.0360069530668,3422,51,12,3383,3434,117,0.0290538862677,3422,0.849764092376,550,0.13657809784,3477,0.86342190216,113,0.0280605910107,405,Forsyth,37067405
Forsyth,3080,514,0.166883116883,2100,0.681818181818,11,0.00357142857143,5,0.00162337662338,387,0.125649350649,63,0.0204545454545,2152,18,14,2148,2166,52,0.0168831168831,2152,0.698701298701,532,0.172727272727,2548,0.827272727273,419,0.136038961039,501,Forsyth,37067501
Forsyth,2719,302,0.111070246414,1697,0.624126517102,16,0.00588451636631,23,0.00845899227657,635,0.233541743288,46,0.0169179845531,1737,24,18,1731,1755,40,0.0147112909158,1737,0.638837808018,837,0.307833762413,1882,0.692166237587,176,0.0647296800294,502,Forsyth,37067502
Forsyth,2888,1185,0.410318559557,1040,0.360110803324,28,0.00969529085873,30,0.0103878116343,493,0.170706371191,112,0.0387811634349,1104,54,46,1096,1150,64,0.0221606648199,1104,0.382271468144,722,0.25,2166,0.75,1053,0.364612188366,503,Forsyth,37067503
Forsyth,2807,807,0.287495546847,1349,0.480584253652,37,0.0131813323833,3,0.00106875667973,490,0.174563591022,121,0.0431065194157,1422,73,66,1415,1488,73,0.0260064125401,1422,0.506590666192,864,0.307801923762,1943,0.692198076238,552,0.19665122907,504,Forsyth,37067504
Forsyth,4156,999,0.240375360924,1818,0.437439846006,8,0.00192492781521,18,0.00433108758422,1173,0.282242540905,140,0.0336862367661,1913,37,19,1895,1932,95,0.0228585178056,1913,0.460298363811,1522,0.366217516843,2634,0.633782483157,818,0.196823869105,505,Forsyth,37067505
Forsyth,2769,1531,0.55290718671,683,0.246659443843,20,0.00722282412423,16,0.00577825929939,458,0.165402672445,61,0.0220296135789,705,42,39,702,744,22,0.00794510653666,705,0.254604550379,676,0.244131455399,2093,0.755868544601,1371,0.495124593716,506,Forsyth,37067506
Forsyth,8080,3819,0.472648514851,2992,0.370297029703,54,0.00668316831683,76,0.00940594059406,873,0.108044554455,266,0.0329207920792,3141,121,88,3108,3229,149,0.0184405940594,3141,0.388737623762,1557,0.192698019802,6523,0.807301980198,3305,0.409034653465,507,Forsyth,37067507
Forsyth,2588,1527,0.590030911901,659,0.254636785162,21,0.008114374034,74,0.0285935085008,237,0.0915765069552,70,0.0270479134467,699,38,26,687,725,40,0.015455950541,699,0.270092735703,337,0.130216383308,2251,0.869783616692,1442,0.557187017002,601,Forsyth,37067601
Forsyth,5762,3343,0.580180492884,1781,0.309094064561,32,0.00555362721277,131,0.0227351614023,300,0.0520652551198,175,0.0303713988199,1872,75,58,1855,1930,91,0.0157931273863,1872,0.324887191947,614,0.106560222145,5148,0.893439777855,3104,0.538701839639,602,Forsyth,37067602
Forsyth,3149,1770,0.562083201016,765,0.242934264846,13,0.00412829469673,48,0.0152429342648,480,0.152429342648,73,0.0231819625278,803,33,27,797,830,38,0.0120673229597,803,0.255001587806,692,0.219752302318,2457,0.780247697682,1620,0.514449031439,603,Forsyth,37067603
Forsyth,4232,1479,0.349480151229,1006,0.237712665406,27,0.00637996219282,63,0.0148865784499,1502,0.354914933837,155,0.0366257088847,1063,50,42,1055,1105,57,0.0134688090737,1063,0.25118147448,2153,0.508742911153,2079,0.491257088847,1048,0.24763705104,604,Forsyth,37067604
Forsyth,5456,2540,0.465542521994,2057,0.377016129032,19,0.00348240469208,127,0.0232771260997,569,0.104288856305,144,0.0263929618768,2151,43,26,2134,2177,94,0.0172287390029,2151,0.394244868035,907,0.166239002933,4549,0.833760997067,2288,0.41935483871,605,Forsyth,37067605
Forsyth,3065,1483,0.483849918434,882,0.287765089723,8,0.0026101141925,31,0.0101141924959,567,0.184991843393,94,0.0306688417618,946,33,15,928,961,64,0.02088091354,946,0.308646003263,747,0.243719412724,2318,0.756280587276,1339,0.436867862969,606,Forsyth,37067606
Forsyth,3012,2130,0.707171314741,632,0.209827357238,14,0.00464807436919,65,0.0215803452855,120,0.0398406374502,51,0.0169322709163,659,26,19,652,678,27,0.00896414342629,659,0.218791500664,223,0.074037184595,2789,0.925962815405,2043,0.67828685259,607,Forsyth,37067607
Forsyth,1783,1357,0.761076836792,308,0.172742568704,10,0.00560852495794,41,0.0229949523275,36,0.0201906898486,31,0.0173864273696,324,17,13,320,337,16,0.0089736399327,324,0.181716208637,79,0.0443073471677,1704,0.955692652832,1317,0.73864273696,701,Forsyth,37067701
Forsyth,2084,1631,0.782629558541,215,0.103166986564,5,0.00239923224568,152,0.0729366602687,35,0.0167946257198,46,0.0220729366603,232,12,10,230,242,17,0.00815738963532,232,0.1113243762,83,0.0398272552783,2001,0.960172744722,1592,0.763915547025,702,Forsyth,37067702
Forsyth,1572,1387,0.882315521628,56,0.0356234096692,2,0.00127226463104,54,0.0343511450382,44,0.027989821883,29,0.0184478371501,69,11,5,63,74,13,0.00826972010178,69,0.043893129771,107,0.0680661577608,1465,0.931933842239,1330,0.846055979644,703,Forsyth,37067703
Forsyth,2314,1839,0.794727744166,346,0.149524632671,9,0.00388936905791,37,0.0159896283492,44,0.019014693172,39,0.0168539325843,364,20,17,361,381,18,0.00777873811582,364,0.157303370787,91,0.0393258426966,2223,0.960674157303,1795,0.775713050994,704,Forsyth,37067704
Forsyth,3147,1989,0.632030505243,811,0.257705751509,7,0.00222434064188,124,0.0394026056562,154,0.0489354941214,62,0.0197013028281,852,22,12,842,864,41,0.0130282809024,852,0.270734032412,294,0.093422306959,2853,0.906577693041,1870,0.594216714331,705,Forsyth,37067705
Forsyth,1955,1330,0.680306905371,466,0.238363171355,13,0.00664961636829,18,0.00920716112532,63,0.0322250639386,65,0.0332480818414,504,24,15,495,519,38,0.0194373401535,504,0.257800511509,169,0.0864450127877,1786,0.913554987212,1266,0.647570332481,706,Forsyth,37067706
Forsyth,2054,1356,0.66017526777,479,0.233203505355,5,0.00243427458617,41,0.0199610516066,102,0.0496592015579,71,0.0345666991237,520,28,16,508,536,41,0.0199610516066,520,0.253164556962,210,0.102239532619,1844,0.897760467381,1268,0.617332035054,707,Forsyth,37067707
Forsyth,5555,3434,0.618181818182,1448,0.260666066607,14,0.0025202520252,188,0.0338433843384,305,0.0549054905491,166,0.0298829882988,1536,55,33,1514,1569,88,0.0158415841584,1536,0.276507650765,634,0.114131413141,4921,0.885868586859,3159,0.568676867687,708,Forsyth,37067708
Forsyth,3504,2276,0.649543378995,863,0.246289954338,7,0.00199771689498,197,0.0562214611872,66,0.0188356164384,95,0.0271118721461,901,35,24,890,925,38,0.0108447488584,901,0.257134703196,225,0.0642123287671,3279,0.935787671233,2152,0.614155251142,709,Forsyth,37067709
Forsyth,1410,1212,0.859574468085,97,0.0687943262411,12,0.00851063829787,38,0.0269503546099,19,0.013475177305,32,0.022695035461,111,22,17,106,128,14,0.00992907801418,111,0.0787234042553,52,0.0368794326241,1358,0.963120567376,1183,0.839007092199,801,Forsyth,37067801
Forsyth,1813,1773,0.977937120794,19,0.0104798676227,0,0.0,14,0.00772200772201,1,0.000551571980143,6,0.00330943188086,22,0,0,22,22,3,0.00165471594043,22,0.0121345835632,33,0.0182018753447,1780,0.981798124655,1745,0.96249310535,802,Forsyth,37067802
Forsyth,1954,1913,0.979017400205,10,0.00511770726714,0,0.0,8,0.00409416581372,5,0.00255885363357,18,0.00921187308086,13,1,0,12,13,3,0.00153531218014,13,0.00665301944729,16,0.00818833162743,1938,0.991811668373,1898,0.971340839304,803,Forsyth,37067803
Forsyth,1450,1365,0.941379310345,55,0.0379310344828,7,0.0048275862069,7,0.0048275862069,3,0.00206896551724,13,0.00896551724138,59,12,12,59,71,4,0.00275862068966,59,0.0406896551724,30,0.0206896551724,1420,0.979310344828,1337,0.922068965517,804,Forsyth,37067804
Forsyth,2666,2504,0.939234808702,69,0.0258814703676,1,0.000375093773443,42,0.0157539384846,14,0.00525131282821,36,0.013503375844,91,8,3,86,94,22,0.00825206301575,91,0.0341335333833,54,0.0202550637659,2612,0.979744936234,2465,0.924606151538,805,Forsyth,37067805
Forsyth,2317,2015,0.869659041864,185,0.0798446266724,5,0.00215796288304,40,0.0172637030643,27,0.0116529995684,45,0.0194216659473,208,15,9,202,217,23,0.00992662926198,208,0.0897712559344,103,0.0444540353906,2214,0.955545964609,1958,0.845058264998,806,Forsyth,37067806
Forsyth,2431,1970,0.810366104484,208,0.0855614973262,1,0.00041135335253,195,0.0802139037433,18,0.00740436034554,39,0.0160427807487,223,10,8,221,231,15,0.00617030028795,223,0.0917317976142,92,0.0378445084327,2339,0.962155491567,1896,0.779925956397,807,Forsyth,37067807
Forsyth,5761,3010,0.52247873633,1744,0.302725221316,14,0.00243013365735,454,0.0788057628884,368,0.0638777989932,171,0.0296823468148,1836,62,40,1814,1876,92,0.0159694497483,1836,0.318694671064,787,0.136608227738,4974,0.863391772262,2671,0.463634785627,808,Forsyth,37067808
Forsyth,3085,2838,0.919935170178,106,0.0343598055105,11,0.00356564019449,82,0.0265802269044,9,0.00291734197731,39,0.012641815235,122,16,13,119,135,16,0.00518638573744,122,0.039546191248,74,0.0239870340357,3011,0.976012965964,2796,0.906320907618,809,Forsyth,37067809
Forsyth,2018,1857,0.920218037661,110,0.0545094152626,0,0.0,20,0.00991080277502,5,0.00247770069376,26,0.0128840436075,122,11,5,116,127,12,0.00594648166501,122,0.0604558969277,39,0.0193260654113,1979,0.980673934589,1825,0.904360753221,901,Forsyth,37067901
Forsyth,2165,1352,0.624480369515,596,0.275288683603,10,0.00461893764434,36,0.0166281755196,115,0.0531177829099,56,0.0258660508083,623,23,17,617,640,27,0.0124711316397,623,0.287759815242,185,0.0854503464203,1980,0.91454965358,1290,0.59584295612,902,Forsyth,37067902
Forsyth,4205,3206,0.76242568371,702,0.16694411415,6,0.00142687277051,169,0.0401902497027,32,0.00760998810939,90,0.0214030915577,739,21,14,732,753,37,0.00879904875149,739,0.175743162901,135,0.0321046373365,4070,0.967895362663,3114,0.740546967895,903,Forsyth,37067903
Forsyth,4244,1396,0.328934967012,1778,0.418944392083,22,0.00518378887842,35,0.00824693685203,883,0.208058435438,130,0.0306314797361,1849,54,30,1825,1879,71,0.0167295004713,1849,0.435673892554,1303,0.307021677663,2941,0.692978322337,1083,0.255183788878,904,Forsyth,37067904
Forsyth,4382,3048,0.695572797809,895,0.204244637152,12,0.00273847558193,237,0.054084892743,87,0.019853947969,103,0.0235052487449,960,31,24,953,984,65,0.0148334094021,960,0.219078046554,198,0.0451848471018,4184,0.954815152898,2969,0.677544500228,905,Forsyth,37067905
Forsyth,4068,3031,0.745083579154,758,0.186332350049,5,0.00122910521141,77,0.0189282202557,99,0.0243362831858,98,0.0240904621436,813,21,16,808,829,55,0.0135201573255,813,0.199852507375,259,0.0636676499508,3809,0.936332350049,2884,0.708947885939,906,Forsyth,37067906
Forsyth,2485,1864,0.750100603622,404,0.162575452716,3,0.00120724346076,71,0.0285714285714,96,0.0386317907445,47,0.0189134808853,430,18,11,423,441,26,0.01046277666,430,0.173038229376,198,0.0796780684105,2287,0.92032193159,1776,0.714688128773,907,Forsyth,37067907
Forsyth,3512,3050,0.868451025057,270,0.0768792710706,5,0.00142369020501,113,0.0321753986333,32,0.00911161731207,42,0.0119589977221,285,13,11,283,296,15,0.00427107061503,285,0.0811503416856,92,0.0261958997722,3420,0.973804100228,2990,0.851366742597,908,Forsyth,37067908
Forsyth,1801,1259,0.699056079956,406,0.225430316491,11,0.00610771793448,28,0.0155469183787,82,0.0455302609661,15,0.00832870627429,415,12,12,415,427,9,0.00499722376458,415,0.230427540255,147,0.0816213214881,1654,0.918378678512,1203,0.667962243198,909,Forsyth,37067909
Franklin,3227,1523,0.471955376511,1537,0.476293771305,9,0.00278896808181,29,0.00898667493028,73,0.0226216299969,56,0.0173535791757,1573,32,14,1555,1587,36,0.0111558723272,1573,0.487449643632,147,0.0455531453362,3080,0.954446854664,1469,0.45522156802,01,Franklin,3706901
Franklin,2295,1008,0.439215686275,1025,0.446623093682,13,0.00566448801743,1,0.000435729847495,223,0.0971677559913,25,0.0108932461874,1048,21,14,1041,1062,23,0.0100217864924,1048,0.456644880174,301,0.131154684096,1994,0.868845315904,962,0.41917211329,02,Franklin,3706902
Franklin,4391,2924,0.665907538146,1239,0.282168071054,27,0.00614894101571,25,0.00569346390344,93,0.0211796857208,83,0.0189023001594,1286,57,45,1274,1331,47,0.0107037121385,1286,0.292871783193,288,0.0655887041676,4103,0.934411295832,2787,0.634707355955,03,Franklin,3706903
Franklin,3574,2573,0.719921656407,703,0.196698377168,25,0.00699496362619,7,0.00195858981533,203,0.0567991046447,63,0.017627308338,733,46,37,724,770,30,0.00839395635143,733,0.20509233352,346,0.0968102965865,3228,0.903189703414,2462,0.688864017907,05,Franklin,3706905
Franklin,3053,1585,0.519161480511,1286,0.421225024566,10,0.00327546675401,6,0.00196528005241,124,0.0406157877498,42,0.0137569603669,1308,28,18,1298,1326,22,0.00720602685883,1308,0.428431051425,230,0.0753357353423,2823,0.924664264658,1496,0.4900098264,06,Franklin,3706906
Franklin,2585,2122,0.820889748549,253,0.0978723404255,12,0.00464216634429,7,0.0027079303675,145,0.0560928433269,46,0.0177949709865,263,30,26,259,289,10,0.00386847195358,263,0.101740812379,219,0.0847195357834,2366,0.915280464217,2070,0.800773694391,07,Franklin,3706907
Franklin,3843,2726,0.709341660161,852,0.221701795472,27,0.00702576112412,14,0.00364298724954,148,0.0385115794952,76,0.0197762164975,897,74,50,873,947,45,0.0117096018735,897,0.233411397346,288,0.0749414519906,3555,0.925058548009,2625,0.68306010929,08,Franklin,3706908
Franklin,2371,1673,0.705609447491,514,0.216786166175,14,0.00590468156896,6,0.00253057781527,110,0.0463939266132,54,0.0227752003374,541,32,17,526,558,27,0.0113876001687,541,0.228173766343,199,0.083930830873,2172,0.916069169127,1608,0.678194854492,09,Franklin,3706909
Franklin,1630,1109,0.68036809816,445,0.273006134969,29,0.0177914110429,4,0.00245398773006,24,0.0147239263804,19,0.0116564417178,456,39,33,450,489,11,0.00674846625767,456,0.279754601227,60,0.0368098159509,1570,0.963190184049,1085,0.665644171779,10,Franklin,3706910
Franklin,2718,1407,0.51766004415,1123,0.413171449595,25,0.00919793966152,1,0.000367917586461,103,0.0378955114054,59,0.0217071376012,1161,46,40,1155,1201,38,0.0139808682855,1161,0.427152317881,228,0.083885209713,2490,0.916114790287,1319,0.485283296542,11,Franklin,3706911
Franklin,2098,1314,0.626310772164,728,0.346997140133,3,0.00142993326978,2,0.00095328884652,32,0.0152526215443,19,0.00905624404194,740,11,9,738,749,12,0.00571973307912,740,0.352716873213,68,0.0324118207817,2030,0.967588179218,1288,0.613918017159,12,Franklin,3706912
Franklin,2764,2044,0.739507959479,385,0.139290882779,18,0.00651230101302,10,0.00361794500724,272,0.0984081041968,35,0.0126628075253,394,27,27,394,421,9,0.00325615050651,394,0.142547033285,371,0.134225759768,2393,0.865774240232,1973,0.713820549928,13,Franklin,3706913
Franklin,5289,4267,0.806768765362,686,0.129703157497,30,0.00567214974475,27,0.00510493477028,177,0.033465683494,102,0.0192853091322,733,65,52,720,785,47,0.00888636793345,733,0.13858952543,339,0.0640952921157,4950,0.935904707884,4142,0.783134808092,14,Franklin,3706914
Franklin,3920,1602,0.408673469388,1985,0.50637755102,13,0.00331632653061,12,0.0030612244898,237,0.0604591836735,71,0.018112244898,2029,33,22,2018,2051,44,0.0112244897959,2029,0.517602040816,378,0.0964285714286,3542,0.903571428571,1497,0.381887755102,15,Franklin,3706915
Franklin,2974,1469,0.493947545393,1341,0.450907868191,19,0.00638870208473,18,0.00605245460659,84,0.0282447881641,43,0.0144586415602,1360,34,31,1357,1391,19,0.00638870208473,1360,0.457296570276,195,0.0655682582381,2779,0.934431741762,1398,0.470073974445,16,Franklin,3706916
Franklin,4753,3726,0.783925941511,619,0.130233536714,24,0.0050494424574,29,0.00610140963602,252,0.0530191458027,103,0.0216705238797,678,51,39,666,717,59,0.0124132127078,678,0.142646749421,369,0.0776351777825,4384,0.922364822218,3635,0.76478013886,17,Franklin,3706917
Franklin,3496,2853,0.816075514874,425,0.121567505721,21,0.00600686498856,23,0.00657894736842,100,0.0286041189931,74,0.0211670480549,464,42,31,453,495,39,0.0111556064073,464,0.132723112128,177,0.0506292906178,3319,0.949370709382,2799,0.800629290618,18,Franklin,3706918
Franklin,5638,4078,0.723306136928,1066,0.189074139766,10,0.00177367860944,79,0.0140120610145,266,0.047179851011,139,0.0246541326712,1104,42,37,1099,1141,38,0.00673997871586,1104,0.195814118482,573,0.101631784321,5065,0.898368215679,3863,0.685172046825,19,Franklin,3706919
Gaston,1705,1275,0.74780058651,337,0.197653958944,4,0.00234604105572,23,0.0134897360704,24,0.0140762463343,42,0.024633431085,372,17,8,363,380,35,0.0205278592375,372,0.218181818182,41,0.0240469208211,1664,0.975953079179,1257,0.73724340176,01,Gaston,3707101
Gaston,4433,2342,0.528310399278,1682,0.379427024588,10,0.00225580870742,36,0.00812091134672,268,0.0604556733589,95,0.0214301827205,1745,32,25,1738,1770,63,0.0142115948568,1745,0.393638619445,495,0.111662531017,3938,0.888337468983,2162,0.487705842545,02,Gaston,3707102
Gaston,3256,1591,0.488636363636,1408,0.432432432432,9,0.00276412776413,8,0.002457002457,163,0.0500614250614,77,0.0236486486486,1463,28,17,1452,1480,55,0.0168918918919,1463,0.449324324324,301,0.0924447174447,2955,0.907555282555,1495,0.459152334152,03,Gaston,3707103
Gaston,8371,5871,0.701349898459,1673,0.199856647951,24,0.00286704097479,73,0.008720582965,551,0.0658224823796,179,0.0213833472703,1769,72,63,1760,1832,96,0.0114681638992,1769,0.21132481185,1049,0.125313582607,7322,0.874686417393,5446,0.650579381197,04,Gaston,3707104
Gaston,4767,2258,0.473673169708,2178,0.456891126495,24,0.00503461296413,13,0.00272708202224,154,0.0323054331865,140,0.0293685756241,2271,58,54,2267,2325,93,0.019509125236,2271,0.476400251731,254,0.0532829872037,4513,0.946717012796,2190,0.459408432977,05,Gaston,3707105
Gaston,3355,1226,0.365424739195,1690,0.503725782414,22,0.00655737704918,11,0.00327868852459,334,0.0995529061103,72,0.0214605067064,1732,43,39,1728,1771,42,0.0125186289121,1732,0.516244411326,603,0.179731743666,2752,0.820268256334,1021,0.304321907601,06,Gaston,3707106
Gaston,2164,511,0.236136783734,1613,0.745378927911,5,0.00231053604436,1,0.000462107208872,10,0.00462107208872,24,0.0110905730129,1634,16,8,1626,1642,21,0.00970425138632,1634,0.755083179298,42,0.0194085027726,2122,0.980591497227,489,0.225970425139,07,Gaston,3707107
Gaston,3253,1463,0.449738702736,1432,0.440209037811,9,0.00276667691362,7,0.0021518598217,232,0.0713187826622,110,0.0338149400553,1508,35,19,1492,1527,76,0.0233630494928,1508,0.463572087304,355,0.109130033815,2898,0.890869966185,1368,0.42053489087,08,Gaston,3707108
Gaston,3289,1936,0.588628762542,905,0.275159622986,30,0.00912131346914,20,0.00608087564609,274,0.0833079963515,124,0.0377014290058,995,66,48,977,1043,90,0.0273639404074,995,0.302523563393,427,0.129826695044,2862,0.870173304956,1818,0.55275159623,09,Gaston,3707109
Gaston,3783,2641,0.698123182659,856,0.22627544277,17,0.00449378799894,23,0.0060798308221,153,0.0404440919905,93,0.0245836637589,913,43,29,899,942,57,0.01506740682,913,0.24134284959,333,0.0880253766852,3450,0.911974623315,2499,0.660586835845,10,Gaston,3707110
Gaston,3296,1993,0.604672330097,1035,0.314016990291,27,0.00819174757282,21,0.0063713592233,125,0.0379247572816,95,0.028822815534,1103,44,38,1097,1141,68,0.0206310679612,1103,0.334648058252,280,0.0849514563107,3016,0.915048543689,1872,0.567961165049,11,Gaston,3707111
Gaston,5159,4158,0.805970149254,562,0.108935840279,21,0.00407055630936,28,0.00542740841248,305,0.0591199844931,85,0.0164760612522,610,43,39,606,649,48,0.00930412870711,610,0.118239968986,525,0.101763907734,4634,0.898236092266,3966,0.768753634425,12,Gaston,3707112
Gaston,3873,2994,0.77304415182,547,0.141234185386,27,0.00697134004648,67,0.0172992512264,155,0.0400206558224,83,0.0214304156984,583,51,39,571,622,36,0.00929512006197,583,0.150529305448,261,0.0673896204493,3612,0.932610379551,2902,0.749289956106,13,Gaston,3707113
Gaston,1387,1217,0.877433309301,86,0.0620043258832,0,0.0,25,0.0180245133381,41,0.0295602018745,18,0.0129776496035,90,3,2,89,92,4,0.0028839221341,90,0.0648882480173,88,0.0634462869503,1299,0.93655371305,1172,0.844989185292,14,Gaston,3707114
Gaston,7494,5581,0.744729116627,1283,0.17120362957,36,0.00480384307446,206,0.0274886575927,189,0.0252201761409,199,0.0265545769949,1385,79,60,1366,1445,102,0.013610888711,1385,0.184814518281,498,0.06645316253,6996,0.93354683747,5370,0.716573258607,15,Gaston,3707115
Gaston,4597,3975,0.864694365891,399,0.0867957363498,9,0.00195779856428,106,0.0230585164238,40,0.00870132695236,68,0.014792255819,419,25,24,418,443,20,0.00435066347618,419,0.091146399826,115,0.025016314988,4482,0.974983685012,3911,0.850772242767,16,Gaston,3707116
Gaston,5363,3871,0.721797501398,1083,0.201939213127,17,0.00316986761141,137,0.025545403692,187,0.0348685437255,68,0.0126794704456,1115,36,30,1109,1145,32,0.00596680962148,1115,0.207906022748,382,0.0712287898564,4981,0.928771210144,3694,0.68879358568,17,Gaston,3707117
Gaston,8342,5840,0.700071925198,1414,0.169503716135,38,0.00455526252697,214,0.0256533205466,660,0.0791177175737,176,0.0210980580197,1486,87,77,1476,1563,72,0.00863102373532,1486,0.178134739871,1170,0.140254135699,7172,0.859745864301,5394,0.646607528171,18,Gaston,3707118
Gaston,8174,6319,0.773060924884,1158,0.141668705652,42,0.00513824321018,42,0.00513824321018,395,0.0483239540005,218,0.0266699290433,1278,102,87,1263,1365,120,0.0146806948862,1278,0.156349400538,711,0.0869831172009,7463,0.913016882799,6072,0.742843161243,19,Gaston,3707119
Gaston,5794,4938,0.852260959613,540,0.0931998619261,21,0.00362443907491,28,0.00483258543321,149,0.0257162581981,118,0.0203658957542,602,51,46,597,648,62,0.0107007248878,602,0.103900586814,276,0.0476354849845,5518,0.952364515016,4842,0.835692095271,20,Gaston,3707120
Gaston,3778,2721,0.720222339862,888,0.235044997353,21,0.00555849655903,24,0.00635256749603,66,0.0174695606141,58,0.0153520381154,923,41,31,913,954,35,0.00926416093171,923,0.244309158285,135,0.0357331921652,3643,0.964266807835,2668,0.706193753309,21,Gaston,3707121
Gaston,5946,4985,0.838378742011,686,0.115371678439,22,0.00369996636394,28,0.00470904809956,108,0.0181634712412,117,0.0196770938446,755,61,44,738,799,69,0.0116044399596,755,0.126976118399,277,0.0465859401278,5669,0.953414059872,4839,0.813824419778,22,Gaston,3707122
Gaston,3805,3228,0.848357424442,353,0.0927726675427,8,0.00210249671485,72,0.0189224704336,69,0.0181340341656,75,0.0197109067017,394,29,26,391,420,41,0.0107752956636,394,0.103547963206,156,0.0409986859396,3649,0.95900131406,3160,0.830486202365,23,Gaston,3707123
Gaston,3886,3163,0.81394750386,395,0.101646937725,15,0.00386001029336,178,0.0458054554812,66,0.0169840452908,69,0.0177560473495,417,40,37,414,454,22,0.00566134843026,417,0.107308286155,118,0.0303654143078,3768,0.969634585692,3125,0.804168811117,24,Gaston,3707124
Gaston,3312,2904,0.876811594203,189,0.0570652173913,9,0.00271739130435,114,0.0344202898551,56,0.0169082125604,40,0.012077294686,216,17,14,213,230,27,0.00815217391304,216,0.0652173913043,133,0.0401570048309,3179,0.959842995169,2830,0.854468599034,25,Gaston,3707125
Gaston,4262,3576,0.839042702956,319,0.0748474894416,20,0.00469263256687,98,0.0229938995777,200,0.0469263256687,49,0.0114969497888,342,32,32,342,374,23,0.0053965274519,342,0.0802440168935,371,0.0870483341154,3891,0.912951665885,3417,0.80173627405,26,Gaston,3707126
Gaston,4469,4018,0.899082568807,204,0.0456477959275,12,0.00268516446632,168,0.0375923025285,26,0.0058178563437,41,0.00917431192661,219,18,16,217,235,15,0.0033564555829,219,0.0490042515104,93,0.020810024614,4376,0.979189975386,3951,0.884090400537,27,Gaston,3707127
Gaston,4079,3751,0.919588134347,155,0.0379995096837,25,0.0061289531748,78,0.0191223339054,13,0.00318705565089,57,0.0139740132385,162,51,51,162,213,7,0.00171610688894,162,0.0397156165727,54,0.0132385388576,4025,0.986761461142,3713,0.910272125521,28,Gaston,3707128
Gaston,4733,4297,0.907880836679,253,0.0534544686246,11,0.0023241073315,80,0.0169025987746,44,0.00929642932601,48,0.0101415592647,274,25,24,273,298,21,0.00443693217832,274,0.0578914008029,105,0.0221846608916,4628,0.977815339108,4238,0.895415170082,29,Gaston,3707129
Gaston,3693,3225,0.87327376117,189,0.051177904143,21,0.00568643379366,50,0.0135391280802,142,0.0384511237476,66,0.0178716490658,207,35,35,207,242,18,0.00487408610885,207,0.0560519902518,211,0.0571351204982,3482,0.942864879502,3176,0.860005415651,30,Gaston,3707130
Gaston,4255,3861,0.907403055229,285,0.0669800235018,16,0.00376028202115,22,0.00517038777908,23,0.00540540540541,48,0.0112808460635,306,38,36,304,342,21,0.00493537015276,306,0.0719153936545,92,0.0216216216216,4163,0.978378378378,3797,0.892361927145,31,Gaston,3707131
Gaston,3515,3020,0.859174964438,308,0.0876244665718,18,0.00512091038407,40,0.0113798008535,85,0.0241820768137,44,0.0125177809388,320,31,28,317,348,12,0.00341394025605,320,0.0910384068279,200,0.0568990042674,3315,0.943100995733,2925,0.832147937411,32,Gaston,3707132
Gaston,3470,3154,0.908933717579,189,0.0544668587896,25,0.00720461095101,6,0.00172910662824,33,0.00951008645533,63,0.0181556195965,213,53,52,212,265,24,0.00691642651297,213,0.0613832853026,79,0.0227665706052,3391,0.977233429395,3126,0.900864553314,33,Gaston,3707133
Gaston,3736,3494,0.9352248394,129,0.0345289079229,13,0.00347965738758,3,0.000802997858672,52,0.0139186295503,45,0.0120449678801,146,36,36,146,182,17,0.00455032119914,146,0.0390792291221,84,0.0224839400428,3652,0.977516059957,3461,0.926391862955,34,Gaston,3707134
Gaston,2481,2144,0.864167674325,247,0.099556630391,6,0.00241837968561,12,0.00483675937122,25,0.0100765820234,47,0.018943974204,273,20,17,270,290,26,0.0104796453043,273,0.110036275695,69,0.0278113663845,2412,0.972188633615,2099,0.846029826683,35,Gaston,3707135
Gaston,4679,4188,0.89506304766,260,0.0555674289378,5,0.00106860440265,37,0.00790767257961,124,0.0265013891857,65,0.0138918572345,274,29,29,274,303,14,0.00299209232742,274,0.0585595212652,212,0.0453088266724,4467,0.954691173328,4118,0.880102586023,36,Gaston,3707136
Gaston,2134,1860,0.87160262418,218,0.102155576382,8,0.0037488284911,5,0.00234301780694,24,0.0112464854733,19,0.00890346766635,231,13,11,229,242,13,0.00609184629803,231,0.10824742268,46,0.0215557638238,2088,0.978444236176,1839,0.861761949391,37,Gaston,3707137
Gaston,4131,3873,0.937545388526,118,0.0285645122246,26,0.00629387557492,13,0.00314693778746,35,0.00847252481239,66,0.0159767610748,142,63,58,137,200,24,0.00580973129993,142,0.0343742435246,80,0.0193657709998,4051,0.980634229,3831,0.927378358751,38,Gaston,3707138
Gaston,5392,5101,0.94603115727,134,0.0248516320475,23,0.00426557863501,15,0.00278189910979,52,0.00964391691395,67,0.0124258160237,151,52,50,149,201,17,0.0031528189911,151,0.0280044510386,94,0.0174332344214,5298,0.982566765579,5065,0.939354599407,39,Gaston,3707139
Gaston,6853,5386,0.785933167956,1141,0.166496424923,27,0.00393988034437,41,0.00598278126368,129,0.0188238727565,129,0.0188238727565,1220,52,46,1214,1266,79,0.0115277980447,1220,0.178024222968,264,0.0385232744783,6589,0.961476725522,5278,0.770173646578,40,Gaston,3707140
Gaston,4614,4149,0.89921976593,210,0.0455136540962,14,0.00303424360642,25,0.00541829215431,162,0.0351105331599,54,0.0117035110533,230,39,39,230,269,20,0.00433463372345,230,0.0498482878197,284,0.061551798873,4330,0.938448201127,4032,0.873862158648,41,Gaston,3707141
Gaston,3024,2703,0.893849206349,190,0.0628306878307,14,0.00462962962963,47,0.0155423280423,26,0.00859788359788,44,0.0145502645503,211,27,27,211,238,21,0.00694444444444,211,0.0697751322751,68,0.0224867724868,2956,0.977513227513,2668,0.882275132275,42,Gaston,3707142
Gaston,6027,5103,0.84668989547,671,0.111332337813,26,0.00431392069023,48,0.00796416127427,78,0.0129417620707,101,0.0167579226813,723,53,49,719,772,52,0.00862784138045,723,0.119960179194,231,0.0383275261324,5796,0.961672473868,4967,0.82412477186,43,Gaston,3707143
Gaston,6483,5593,0.862717877526,625,0.0964059848835,29,0.0044732376986,34,0.00524448557766,109,0.0168132037637,93,0.0143452105507,657,57,49,649,706,32,0.00493598642604,657,0.10134197131,200,0.0308499151627,6283,0.969150084837,5535,0.853771402129,44,Gaston,3707144
Gaston,4583,3527,0.769583242418,729,0.159066113899,23,0.0050185468034,143,0.0312022692559,48,0.010473488981,113,0.0246563386428,785,54,42,773,827,56,0.0122190704779,785,0.171285184377,164,0.0357844206851,4419,0.964215579315,3418,0.745799694523,45,Gaston,3707145
Gaston,6891,6142,0.89130750254,465,0.0674793208533,21,0.00304745319983,71,0.0103032941518,111,0.0161079669134,81,0.0117544623422,488,51,49,486,537,23,0.0033376868379,488,0.0708170076912,175,0.0253954433319,6716,0.974604556668,6094,0.884341895226,46,Gaston,3707146
Gates,2251,1065,0.473123056419,1116,0.495779653487,12,0.00533096401599,5,0.00222123500666,5,0.00222123500666,48,0.021323856064,1155,30,13,1138,1168,39,0.017325633052,1155,0.513105286539,14,0.00621945801866,2237,0.993780541981,1060,0.470901821413,1,Gates,370731
Gates,1450,1236,0.852413793103,194,0.133793103448,2,0.00137931034483,2,0.00137931034483,1,0.000689655172414,15,0.0103448275862,204,5,3,202,207,10,0.00689655172414,204,0.140689655172,14,0.00965517241379,1436,0.990344827586,1222,0.84275862069,2,Gates,370732
Gates,3040,1717,0.564802631579,1185,0.389802631579,32,0.0105263157895,6,0.00197368421053,35,0.0115131578947,65,0.0213815789474,1221,65,46,1202,1267,36,0.0118421052632,1221,0.401644736842,57,0.01875,2983,0.98125,1699,0.558881578947,3,Gates,370733
Gates,2573,1954,0.759424795958,541,0.210260396424,11,0.00427516517684,5,0.00194325689856,25,0.00971628449281,37,0.0143801010494,569,28,17,558,586,28,0.0108822386319,569,0.221142635056,52,0.020209871745,2521,0.979790128255,1930,0.750097162845,4N,Gates,370734N
Gates,1343,672,0.500372300819,627,0.466865227103,4,0.00297840655249,3,0.00223380491437,6,0.00446760982874,31,0.0230826507818,647,12,9,644,656,20,0.0148920327625,647,0.481757259866,22,0.0163812360387,1321,0.983618763961,662,0.492926284438,4S,Gates,370734S
Gates,1540,1124,0.72987012987,381,0.247402597403,4,0.0025974025974,6,0.0038961038961,1,0.000649350649351,24,0.0155844155844,389,17,14,386,403,8,0.00519480519481,389,0.252597402597,14,0.00909090909091,1526,0.990909090909,1111,0.721428571429,5,Gates,370735
Graham,3599,3359,0.933314809669,7,0.00194498471798,112,0.0311197554876,15,0.00416782439567,38,0.010558488469,68,0.0188941372604,13,163,161,11,174,6,0.00166712975827,13,0.00361211447624,49,0.0136148930258,3550,0.986385106974,3352,0.931369824951,EAST,Graham,37075EAST
Graham,1442,1410,0.977808599168,0,0.0,21,0.0145631067961,0,0.0,0,0.0,11,0.00762829403606,0,32,32,0,32,0,0.0,0,0.0,14,0.00970873786408,1428,0.990291262136,1398,0.969486823856,STEC,Graham,37075STEC
Graham,625,604,0.9664,0,0.0,7,0.0112,3,0.0048,3,0.0048,8,0.0128,2,14,13,1,15,2,0.0032,2,0.0032,7,0.0112,618,0.9888,601,0.9616,TAPO,Graham,37075TAPO
Graham,3195,2631,0.823474178404,10,0.00312989045383,426,0.133333333333,15,0.00469483568075,50,0.0156494522692,63,0.0197183098592,15,482,479,12,494,5,0.00156494522692,15,0.00469483568075,124,0.0388106416275,3071,0.961189358372,2591,0.810954616588,WEST,Graham,37075WEST
Granville,1350,528,0.391111111111,763,0.565185185185,4,0.00296296296296,8,0.00592592592593,22,0.0162962962963,25,0.0185185185185,781,9,4,776,785,18,0.0133333333333,781,0.578518518519,38,0.0281481481481,1312,0.971851851852,516,0.382222222222,ANTI,Granville,37077ANTI
Granville,2373,1466,0.617783396544,787,0.331647703329,11,0.00463548251159,7,0.00294985250737,66,0.0278128950695,36,0.0151706700379,816,27,17,806,833,29,0.0122208175306,816,0.34386852086,110,0.0463548251159,2263,0.953645174884,1442,0.607669616519,BERE,Granville,37077BERE
Granville,11365,5513,0.485085789705,4697,0.413286405631,147,0.0129344478663,56,0.00492740871095,714,0.0628244610647,238,0.0209414870216,4812,221,186,4777,4998,115,0.0101187857457,4812,0.423405191377,1662,0.146238451386,9703,0.853761548614,4765,0.419269687637,BTNR,Granville,37077BTNR
Granville,3563,1941,0.544765646927,1067,0.29946674151,14,0.00392927308448,12,0.00336794835813,488,0.13696323323,41,0.0115071568903,1087,17,17,1087,1104,20,0.00561324726354,1087,0.305079988774,592,0.166152119001,2971,0.833847880999,1854,0.52034802133,CORI,Granville,37077CORI
Granville,2684,1176,0.438152011923,1355,0.504843517139,7,0.00260804769001,18,0.00670640834575,80,0.0298062593145,48,0.0178837555887,1394,25,14,1383,1408,39,0.0145305514158,1394,0.519374068554,118,0.0439642324888,2566,0.956035767511,1140,0.424739195231,CRDL,Granville,37077CRDL
Granville,6360,4024,0.632704402516,1882,0.295911949686,43,0.00676100628931,89,0.0139937106918,187,0.0294025157233,135,0.0212264150943,1982,96,63,1949,2045,100,0.0157232704403,1982,0.311635220126,403,0.0633647798742,5957,0.936635220126,3865,0.607704402516,CRDM,Granville,37077CRDM
Granville,2793,1131,0.404940923738,1554,0.556390977444,18,0.00644468313641,12,0.00429645542427,32,0.0114572144647,46,0.0164697457931,1584,28,20,1576,1604,30,0.0107411385607,1584,0.567132116004,82,0.0293591120659,2711,0.970640887934,1108,0.396706050841,EAOX,Granville,37077EAOX
Granville,5616,4259,0.758368945869,1057,0.188212250712,32,0.00569800569801,33,0.00587606837607,121,0.0215455840456,114,0.0202991452991,1115,65,58,1108,1173,58,0.0103276353276,1115,0.19853988604,317,0.0564458689459,5299,0.943554131054,4103,0.730591168091,MTEN,Granville,37077MTEN
Granville,1776,1030,0.579954954955,706,0.397522522523,10,0.00563063063063,0,0.0,15,0.00844594594595,15,0.00844594594595,715,13,11,713,726,9,0.00506756756757,715,0.40259009009,40,0.0225225225225,1736,0.977477477477,1017,0.572635135135,OKHL,Granville,37077OKHL
Granville,2600,1634,0.628461538462,812,0.312307692308,2,0.000769230769231,41,0.0157692307692,76,0.0292307692308,35,0.0134615384615,829,10,8,827,837,17,0.00653846153846,829,0.318846153846,131,0.0503846153846,2469,0.949615384615,1594,0.613076923077,SALM,Granville,37077SALM
Granville,2831,1854,0.654892264218,850,0.300247262451,2,0.000706464146945,5,0.00176616036736,72,0.02543270929,48,0.0169551395267,877,10,9,876,886,27,0.00953726598375,877,0.309784528435,126,0.0445072412575,2705,0.955492758742,1814,0.640762981279,SASS,Granville,37077SASS
Granville,2254,652,0.2892635315,1468,0.651286601597,10,0.00443655723159,21,0.00931677018634,61,0.0270629991127,42,0.0186335403727,1500,23,17,1494,1517,32,0.0141969831411,1500,0.665483584738,152,0.0674356699201,2102,0.93256433008,589,0.261313220941,SOOX,Granville,37077SOOX
Granville,5553,4458,0.802809292274,848,0.152710246713,16,0.00288132540969,14,0.00252115973348,141,0.0253916801729,76,0.013686295696,887,52,42,877,929,39,0.00702323068612,887,0.1597334774,273,0.0491626148028,5280,0.950837385197,4340,0.781559517378,TYHO,Granville,37077TYHO
Granville,6564,5608,0.85435709933,633,0.0964351005484,21,0.00319926873857,41,0.00624619134674,141,0.0214808043876,120,0.018281535649,677,60,52,669,729,44,0.00670322973796,677,0.103138330286,314,0.0478366849482,6250,0.952163315052,5479,0.834704448507,WILT,Granville,37077WILT
Granville,2234,931,0.416741271262,1173,0.525067144136,1,0.000447627573859,3,0.00134288272158,107,0.0478961504029,19,0.00850492390331,1183,3,3,1183,1186,10,0.00447627573859,1183,0.529543419875,124,0.0555058191585,2110,0.944494180842,924,0.413607878245,WOEL,Granville,37077WOEL
Greene,1531,662,0.432397126061,711,0.464402351404,12,0.00783801436969,0,0.0,128,0.0836054866101,18,0.0117570215545,726,23,15,718,741,15,0.00979751796212,726,0.474199869366,174,0.113651208361,1357,0.886348791639,636,0.415414761594,ARBA,Greene,37079ARBA
Greene,1418,843,0.594499294781,432,0.304654442877,0,0.0,12,0.00846262341326,91,0.0641748942172,40,0.0282087447109,451,8,7,450,458,19,0.0133991537377,451,0.318053596615,171,0.120592383639,1247,0.879407616361,782,0.551480959097,BEAR,Greene,37079BEAR
Greene,1736,874,0.503456221198,586,0.337557603687,18,0.0103686635945,0,0.0,241,0.138824884793,17,0.00979262672811,591,24,24,591,615,5,0.0028801843318,591,0.340437788018,357,0.20564516129,1379,0.79435483871,779,0.448732718894,BULL,Greene,37079BULL
Greene,1497,896,0.598530394122,475,0.317301269205,8,0.00534402137609,2,0.00133600534402,107,0.0714762859051,9,0.0060120240481,480,9,8,479,488,5,0.00334001336005,480,0.320641282565,131,0.0875083500334,1366,0.912491649967,877,0.585838343353,CAST,Greene,37079CAST
Greene,1297,643,0.495759444873,387,0.298380878951,8,0.00616808018504,8,0.00616808018504,219,0.168851195066,32,0.0246723207402,402,10,10,402,412,15,0.011565150347,402,0.309946029298,278,0.21434078643,1019,0.78565921357,610,0.470316114109,HOOK,Greene,37079HOOK
Greene,4738,2103,0.443858168003,2245,0.473828619671,58,0.0122414520895,14,0.00295483326298,264,0.0557197129591,54,0.0113972140144,2278,81,69,2266,2347,33,0.00696496411988,2278,0.480793583791,460,0.0970873786408,4278,0.902912621359,1937,0.408822287885,MAUR,Greene,37079MAUR
Greene,2515,1283,0.51013916501,1054,0.419085487078,4,0.00159045725646,12,0.00477137176938,144,0.0572564612326,18,0.00715705765408,1066,9,7,1064,1073,12,0.00477137176938,1066,0.423856858847,171,0.0679920477137,2344,0.932007952286,1262,0.501789264414,SH1,Greene,37079SH1
Greene,2721,1628,0.598309445057,770,0.282984196986,14,0.00514516721793,11,0.00404263138552,238,0.0874678427049,60,0.0220507166483,794,32,27,789,821,24,0.00882028665932,794,0.291804483646,449,0.165012862918,2272,0.834987137082,1468,0.539507533995,SHIN,Greene,37079SHIN
Greene,1767,838,0.474250141483,697,0.394453876627,13,0.0073571024335,10,0.00565930956423,180,0.101867572156,29,0.0164119977363,717,17,15,715,732,20,0.0113186191285,717,0.405772495756,240,0.135823429542,1527,0.864176570458,789,0.446519524618,SUGG,Greene,37079SUGG
Greene,2142,1080,0.504201680672,607,0.283380018674,19,0.00887021475257,9,0.00420168067227,390,0.182072829132,37,0.0172735760971,618,37,31,612,649,11,0.00513538748833,618,0.288515406162,623,0.290849673203,1519,0.709150326797,898,0.419234360411,WALS,Greene,37079WALS
Guilford,3798,2751,0.724328593997,684,0.18009478673,10,0.00263296471827,189,0.0497630331754,46,0.0121116377041,118,0.0310689836756,763,31,22,754,785,79,0.0208004212744,763,0.200895208004,150,0.0394944707741,3648,0.960505529226,2663,0.701158504476,CG1,Guilford,37081CG1
Guilford,2481,2043,0.82345828295,279,0.112454655381,3,0.00120918984281,96,0.0386940749698,15,0.00604594921403,45,0.0181378476421,297,12,8,293,305,18,0.00725513905683,297,0.119709794438,57,0.0229746070133,2424,0.977025392987,2010,0.81015719468,CG2,Guilford,37081CG2
Guilford,2216,1786,0.8059566787,276,0.124548736462,2,0.000902527075812,96,0.043321299639,10,0.00451263537906,46,0.0207581227437,302,12,6,296,308,26,0.0117328519856,302,0.136281588448,66,0.0297833935018,2150,0.970216606498,1732,0.781588447653,CG3A,Guilford,37081CG3A
Guilford,3110,2351,0.755948553055,560,0.180064308682,8,0.00257234726688,87,0.0279742765273,26,0.00836012861736,78,0.0250803858521,598,24,14,588,612,38,0.0122186495177,598,0.192282958199,110,0.0353697749196,3000,0.96463022508,2282,0.733762057878,CG3B,Guilford,37081CG3B
Guilford,4731,1867,0.394631156204,2517,0.532022828155,25,0.00528429507504,97,0.0205030648911,125,0.0264214753752,100,0.0211371803001,2586,62,35,2559,2621,69,0.0145846544071,2586,0.546607482562,223,0.0471359120693,4508,0.952864087931,1795,0.379412386388,FEN1,Guilford,37081FEN1
Guilford,2094,1883,0.89923591213,153,0.0730659025788,12,0.00573065902579,11,0.00525310410697,4,0.00191021967526,31,0.0148042024833,169,24,17,162,186,16,0.00764087870105,169,0.0807067812798,26,0.0124164278892,2068,0.987583572111,1868,0.892072588348,FEN2,Guilford,37081FEN2
Guilford,5006,2762,0.551737914503,1603,0.320215741111,19,0.00379544546544,374,0.0747103475829,119,0.0237714742309,129,0.0257690771075,1673,47,35,1661,1708,70,0.0139832201358,1673,0.334198961247,339,0.067718737515,4667,0.932281262485,2582,0.515781062725,FR1,Guilford,37081FR1
Guilford,3258,2425,0.744321669736,386,0.118477593616,15,0.00460405156538,353,0.108348680172,30,0.00920810313076,49,0.0150399017802,408,26,22,404,430,22,0.00675260896255,408,0.125230202578,104,0.0319214241866,3154,0.968078575813,2356,0.723143032535,FR2,Guilford,37081FR2
Guilford,2137,1676,0.784277023865,298,0.139447824052,4,0.00187178287319,93,0.0435189518016,24,0.0112306972391,42,0.0196537201685,317,14,11,314,328,19,0.00889096864764,317,0.1483387927,91,0.042583060365,2046,0.957416939635,1612,0.754328497894,FR3,Guilford,37081FR3
Guilford,1785,1537,0.86106442577,139,0.0778711484594,5,0.00280112044818,36,0.0201680672269,35,0.0196078431373,33,0.018487394958,150,5,5,150,155,11,0.00616246498599,150,0.0840336134454,99,0.0554621848739,1686,0.944537815126,1483,0.83081232493,FR4,Guilford,37081FR4
Guilford,4797,3894,0.811757348343,506,0.105482593287,13,0.00271002710027,188,0.0391911611424,74,0.0154263081092,122,0.0254325620179,550,37,32,545,582,44,0.0091723994163,550,0.114654992704,283,0.0589952053367,4514,0.941004794663,3713,0.774025432562,FR5,Guilford,37081FR5
Guilford,1403,540,0.384889522452,756,0.538845331433,4,0.00285103349964,58,0.0413399857448,16,0.0114041339986,29,0.0206699928724,775,15,7,767,782,19,0.0135424091233,775,0.552387740556,44,0.0313613684961,1359,0.968638631504,523,0.372772630078,G01,Guilford,37081G01
Guilford,2236,762,0.340787119857,809,0.361806797853,25,0.0111806797853,391,0.174865831843,165,0.0737924865832,84,0.0375670840787,865,57,33,841,898,56,0.0250447227191,865,0.386851520572,300,0.134168157424,1936,0.865831842576,662,0.296064400716,G02,Guilford,37081G02
Guilford,3102,266,0.0857511283043,2481,0.799806576402,17,0.00548033526757,115,0.0370728562218,138,0.0444874274662,85,0.0274016763378,2537,68,34,2503,2571,56,0.0180528691167,2537,0.817859445519,230,0.0741457124436,2872,0.925854287556,203,0.065441650548,G03,Guilford,37081G03
Guilford,3157,366,0.11593284764,2470,0.782388343364,26,0.00823566677225,4,0.00126702565727,228,0.0722204624644,63,0.019955654102,2520,50,29,2499,2549,50,0.0158378207159,2520,0.79822616408,316,0.100095026924,2841,0.899904973076,311,0.0985112448527,G04,Guilford,37081G04
Guilford,2215,69,0.031151241535,2037,0.919638826185,12,0.00541760722348,17,0.00767494356659,37,0.0167042889391,43,0.0194130925508,2075,29,17,2063,2092,38,0.0171557562077,2075,0.936794582393,60,0.0270880361174,2155,0.972911963883,65,0.0293453724605,G05,Guilford,37081G05
Guilford,2062,107,0.0518913676043,1732,0.839961202716,11,0.00533462657614,61,0.029582929195,95,0.0460717749758,56,0.0271580989331,1783,34,13,1762,1796,51,0.0247332686712,1783,0.864694471387,142,0.0688651794374,1920,0.931134820563,89,0.0431619786615,G06,Guilford,37081G06
Guilford,3531,1120,0.317190597564,1807,0.511753044463,22,0.00623052959502,330,0.0934579439252,134,0.0379495893515,118,0.0334182951005,1880,81,45,1844,1925,73,0.0206740300198,1880,0.532427074483,265,0.0750495610309,3266,0.924950438969,1026,0.29056924384,G07,Guilford,37081G07
Guilford,4178,1107,0.264959310675,2151,0.51483963619,17,0.00406893250359,489,0.117041646721,302,0.0722833891814,112,0.0268070847295,2202,39,28,2191,2230,51,0.0122067975108,2202,0.5270464337,490,0.117280995692,3688,0.882719004308,969,0.231929152705,G08,Guilford,37081G08
Guilford,4397,1171,0.266317944053,2742,0.623607004776,27,0.00614055037526,102,0.023197634751,239,0.0543552422106,116,0.0263816238344,2824,64,36,2796,2860,82,0.0186490789174,2824,0.642256083693,445,0.101205367296,3952,0.898794632704,1047,0.238116897885,G09,Guilford,37081G09
Guilford,5105,1318,0.258178256611,3036,0.594711067581,31,0.00607247796278,223,0.0436826640548,333,0.0652301665034,164,0.032125367287,3126,73,53,3106,3179,90,0.0176297747307,3126,0.612340842311,628,0.123016650343,4477,0.876983349657,1112,0.217825661117,G10,Guilford,37081G10
Guilford,1663,1359,0.817197835238,220,0.132291040289,13,0.00781719783524,34,0.0204449789537,11,0.00661455201443,26,0.0156343956705,235,20,18,233,253,15,0.00901984365604,235,0.141310883945,33,0.0198436560433,1630,0.980156343957,1339,0.805171377029,G11,Guilford,37081G11
Guilford,1385,1148,0.828880866426,100,0.072202166065,13,0.00938628158845,86,0.0620938628159,14,0.0101083032491,24,0.0173285198556,108,24,22,106,130,8,0.0057761732852,108,0.0779783393502,46,0.0332129963899,1339,0.96678700361,1118,0.807220216606,G12,Guilford,37081G12
Guilford,1701,1510,0.887713109935,103,0.0605526161082,5,0.00293944738389,19,0.0111699000588,26,0.0152851263962,38,0.0223398001176,123,14,11,120,134,20,0.0117577895356,123,0.0723104056437,45,0.026455026455,1656,0.973544973545,1496,0.87948265726,G13,Guilford,37081G13
Guilford,1432,1341,0.936452513966,36,0.0251396648045,4,0.00279329608939,25,0.0174581005587,4,0.00279329608939,22,0.0153631284916,40,18,17,39,57,4,0.00279329608939,40,0.0279329608939,34,0.0237430167598,1398,0.97625698324,1316,0.918994413408,G14,Guilford,37081G14
Guilford,1662,1528,0.919374247894,85,0.0511432009627,2,0.00120336943442,16,0.00962695547533,5,0.00300842358604,26,0.0156438026474,99,2,2,99,101,14,0.00842358604091,99,0.0595667870036,31,0.0186522262335,1631,0.981347773767,1514,0.910950661853,G15,Guilford,37081G15
Guilford,1734,1675,0.965974625144,35,0.020184544406,1,0.000576701268743,7,0.0040369088812,4,0.00230680507497,12,0.00692041522491,40,3,2,39,42,5,0.00288350634371,40,0.0230680507497,19,0.0109573241061,1715,0.989042675894,1665,0.960207612457,G16,Guilford,37081G16
Guilford,2051,1809,0.882008776207,131,0.0638712823013,5,0.00243783520234,54,0.0263286201853,11,0.00536323744515,41,0.0199902486592,145,18,17,144,162,14,0.00682593856655,145,0.0706972208679,39,0.0190151145783,2012,0.980984885422,1790,0.872745002438,G17,Guilford,37081G17
Guilford,1494,1447,0.968540829987,26,0.0174029451138,0,0.0,6,0.00401606425703,4,0.00267737617135,11,0.00736278447122,29,1,1,29,30,3,0.00200803212851,29,0.0194109772423,16,0.0107095046854,1478,0.989290495315,1435,0.960508701473,G18,Guilford,37081G18
Guilford,2015,1753,0.869975186104,205,0.101736972705,4,0.00198511166253,27,0.0133995037221,8,0.00397022332506,18,0.00893300248139,218,10,7,215,225,13,0.00645161290323,218,0.108188585608,26,0.0129032258065,1989,0.987096774194,1741,0.864019851117,G19,Guilford,37081G19
Guilford,3132,2562,0.818007662835,432,0.137931034483,4,0.00127713920817,62,0.0197956577267,23,0.007343550447,49,0.0156449553001,460,16,7,451,467,28,0.00893997445722,460,0.14687100894,76,0.0242656449553,3056,0.975734355045,2532,0.808429118774,G20,Guilford,37081G20
Guilford,5310,2938,0.55329566855,1481,0.278907721281,30,0.00564971751412,467,0.0879472693032,231,0.0435028248588,163,0.0306967984934,1584,75,55,1564,1639,103,0.0193973634652,1584,0.298305084746,405,0.0762711864407,4905,0.923728813559,2820,0.531073446328,G21,Guilford,37081G21
Guilford,2019,1768,0.875681030213,155,0.0767706785537,5,0.00247647350173,38,0.0188211986132,28,0.0138682516097,25,0.0123823675087,164,10,7,161,171,9,0.00445765230312,164,0.0812283308569,42,0.0208023774146,1977,0.979197622585,1753,0.868251609708,G22,Guilford,37081G22
Guilford,2077,1394,0.671160327395,471,0.226769378912,5,0.00240731824747,92,0.0442946557535,43,0.0207029369283,72,0.0346653827636,527,26,12,513,539,56,0.0269619643717,527,0.253731343284,117,0.0563312469909,1960,0.943668753009,1335,0.642753972075,G23,Guilford,37081G23
Guilford,1827,1203,0.658456486043,498,0.272577996716,7,0.00383141762452,47,0.0257252326218,16,0.00875752599891,56,0.0306513409962,541,37,12,516,553,43,0.0235358511221,541,0.296113847838,55,0.0301039956212,1772,0.969896004379,1180,0.645867542419,G24,Guilford,37081G24
Guilford,2397,1731,0.722152690864,571,0.23821443471,6,0.00250312891114,32,0.0133500208594,23,0.0095953274927,34,0.0141843971631,592,11,7,588,599,21,0.00876095118899,592,0.246975385899,85,0.0354609929078,2312,0.964539007092,1677,0.699624530663,G25,Guilford,37081G25
Guilford,4007,1704,0.425255802346,1929,0.481407536811,19,0.00474170202146,139,0.034689293736,99,0.0247067631645,117,0.0291989019216,1995,54,32,1973,2027,66,0.016471175443,1995,0.497878712254,224,0.0559021712004,3783,0.9440978288,1603,0.400049912653,G26,Guilford,37081G26
Guilford,3953,3174,0.802934480142,570,0.144194282823,9,0.00227675183405,92,0.0232734631925,27,0.00683025550215,81,0.0204907665065,623,35,15,603,638,53,0.0134075385783,623,0.157601821401,127,0.0321274981027,3826,0.967872501897,3090,0.781684796357,G27,Guilford,37081G27
Guilford,1792,1334,0.744419642857,363,0.202566964286,10,0.00558035714286,14,0.0078125,26,0.0145089285714,45,0.0251116071429,389,20,14,383,403,26,0.0145089285714,389,0.217075892857,93,0.0518973214286,1699,0.948102678571,1288,0.71875,G28,Guilford,37081G28
Guilford,2554,1837,0.719263899765,526,0.205951448708,10,0.00391542678152,84,0.0328895849648,40,0.0156617071261,57,0.0223179326547,558,33,23,548,581,32,0.0125293657009,558,0.218480814409,118,0.0462020360219,2436,0.953797963978,1773,0.694205168363,G29,Guilford,37081G29
Guilford,1964,1811,0.922097759674,89,0.0453156822811,4,0.0020366598778,21,0.0106924643585,7,0.00356415478615,32,0.0162932790224,101,8,5,98,106,12,0.0061099796334,101,0.0514256619145,31,0.015784114053,1933,0.984215885947,1786,0.909368635438,G30,Guilford,37081G30
Guilford,1800,1645,0.913888888889,103,0.0572222222222,8,0.00444444444444,20,0.0111111111111,10,0.00555555555556,14,0.00777777777778,107,11,11,107,118,4,0.00222222222222,107,0.0594444444444,42,0.0233333333333,1758,0.976666666667,1616,0.897777777778,G31,Guilford,37081G31
Guilford,2883,2548,0.88380159556,157,0.0544571626778,5,0.00173430454388,116,0.040235865418,10,0.00346860908776,47,0.0163024627125,173,15,14,172,187,16,0.00554977454041,173,0.0600069372182,49,0.01699618453,2834,0.98300381547,2516,0.872702046479,G32,Guilford,37081G32
Guilford,1901,1815,0.954760652288,33,0.0173592845871,2,0.00105207785376,26,0.0136770120989,5,0.0026301946344,20,0.0105207785376,36,11,9,34,45,3,0.00157811678064,36,0.0189374013677,22,0.0115728563914,1879,0.988427143609,1799,0.946344029458,G33,Guilford,37081G33
Guilford,2043,1905,0.932452276065,77,0.0376896720509,4,0.00195790504161,36,0.0176211453744,7,0.00342633382281,14,0.00685266764562,78,8,8,78,86,1,0.000489476260401,78,0.0381791483113,42,0.0205580029369,2001,0.979441997063,1874,0.917278511992,G34,Guilford,37081G34
Guilford,1316,1248,0.948328267477,34,0.0258358662614,3,0.00227963525836,10,0.00759878419453,1,0.000759878419453,20,0.0151975683891,44,14,11,41,55,10,0.00759878419453,44,0.0334346504559,15,0.0113981762918,1301,0.988601823708,1236,0.939209726444,G35,Guilford,37081G35
Guilford,2706,1718,0.634885439763,658,0.243163340724,14,0.00517368810052,81,0.029933481153,144,0.0532150776053,91,0.0336289726534,723,31,23,715,746,65,0.0240206947524,723,0.267184035477,206,0.0761271249076,2500,0.923872875092,1652,0.610495195861,G36,Guilford,37081G36
Guilford,4341,2146,0.494356139138,1670,0.384703985257,35,0.00806265837365,150,0.0345542501728,196,0.0451508868924,144,0.0331720801659,1778,72,45,1751,1823,108,0.0248790601244,1778,0.409583045381,511,0.117714812255,3830,0.882285187745,1897,0.436996083852,G37,Guilford,37081G37
Guilford,3041,2216,0.728707661953,558,0.183492272279,10,0.00328839197632,130,0.0427490956922,49,0.016113120684,78,0.0256494574153,599,26,18,591,617,41,0.0134824071029,599,0.196974679382,154,0.0506412364354,2887,0.949358763565,2126,0.699112134166,G38,Guilford,37081G38
Guilford,2450,2096,0.855510204082,200,0.0816326530612,4,0.00163265306122,50,0.0204081632653,28,0.0114285714286,72,0.029387755102,239,27,17,229,256,39,0.0159183673469,239,0.0975510204082,98,0.04,2352,0.96,2040,0.832653061224,G39,Guilford,37081G39
Guilford,2138,1836,0.858746492049,163,0.0762394761459,1,0.000467726847521,78,0.0364826941066,19,0.0088868101029,41,0.0191768007484,175,12,11,174,186,12,0.00561272217025,175,0.0818521983162,50,0.0233863423761,2088,0.976613657624,1805,0.844246959775,G40A1,Guilford,37081G40A1
Guilford,1676,1303,0.777446300716,263,0.15692124105,4,0.00238663484487,51,0.0304295942721,15,0.00894988066826,40,0.0238663484487,288,17,9,280,297,25,0.0149164677804,288,0.171837708831,54,0.0322195704057,1622,0.967780429594,1273,0.759546539379,G40A2,Guilford,37081G40A2
Guilford,1967,1560,0.793085917641,226,0.114895780376,2,0.00101677681749,131,0.0665988815455,16,0.00813421453991,32,0.0162684290798,237,16,12,233,249,11,0.00559227249619,237,0.120488052872,58,0.0294865277072,1909,0.970513472293,1524,0.774783934926,G40B,Guilford,37081G40B
Guilford,4554,3275,0.719148001757,769,0.168862538428,18,0.00395256916996,217,0.0476504172156,181,0.0397452788757,94,0.0206411945542,816,36,29,809,845,47,0.0103205972771,816,0.179183135705,324,0.0711462450593,4230,0.928853754941,3149,0.691480017567,G41,Guilford,37081G41
Guilford,3147,2680,0.851604702892,315,0.100095328885,4,0.00127105179536,48,0.0152526215443,46,0.0146170956466,54,0.0171591992374,342,8,6,340,348,27,0.00857959961868,342,0.108674928503,102,0.0324118207817,3045,0.967588179218,2636,0.837623133143,G42,Guilford,37081G42
Guilford,4926,2365,0.480105562322,1920,0.389768574909,17,0.00345107592367,161,0.0326837190418,253,0.0513601299229,210,0.0426309378806,2060,68,30,2022,2090,140,0.0284206252538,2060,0.418189200162,550,0.111652456354,4376,0.888347543646,2157,0.437880633374,G43,Guilford,37081G43
Guilford,3008,2047,0.680518617021,779,0.25897606383,15,0.00498670212766,63,0.0209441489362,35,0.0116356382979,69,0.0229388297872,819,40,25,804,844,40,0.0132978723404,819,0.27227393617,115,0.0382313829787,2893,0.961768617021,1975,0.656582446809,G44,Guilford,37081G44
Guilford,3825,2498,0.653071895425,994,0.259869281046,12,0.00313725490196,130,0.0339869281046,55,0.0143790849673,136,0.0355555555556,1076,53,23,1046,1099,82,0.0214379084967,1076,0.281307189542,176,0.0460130718954,3649,0.953986928105,2415,0.63137254902,G45,Guilford,37081G45
Guilford,5423,384,0.0708095150286,4747,0.875345749585,31,0.00571639314033,26,0.00479439424673,88,0.0162271805274,147,0.0271067674719,4871,88,39,4822,4910,124,0.0228655725613,4871,0.898211322146,204,0.0376175548589,5219,0.962382445141,347,0.0639867232159,G46,Guilford,37081G46
Guilford,3578,1480,0.413638904416,1542,0.430967020682,42,0.0117384013415,127,0.0354946897708,242,0.0676355505869,145,0.0405254332029,1644,82,54,1616,1698,102,0.0285075461151,1644,0.459474566797,416,0.11626607043,3162,0.88373392957,1340,0.374510899944,G47,Guilford,37081G47
Guilford,4396,3210,0.730209281165,744,0.169244767971,18,0.00409463148317,210,0.0477707006369,107,0.0243403093722,107,0.0243403093722,799,40,29,788,828,55,0.0125113739763,799,0.181756141947,229,0.052092811647,4167,0.947907188353,3116,0.708826205641,G48,Guilford,37081G48
Guilford,2095,907,0.432935560859,872,0.416229116945,12,0.00572792362768,48,0.0229116945107,180,0.0859188544153,76,0.036276849642,928,32,24,920,952,56,0.0267303102625,928,0.442959427208,323,0.154176610979,1772,0.845823389021,790,0.377088305489,G49,Guilford,37081G49
Guilford,5518,1737,0.314787966655,2398,0.43457774556,104,0.0188474084813,234,0.042406669083,883,0.16002174701,162,0.0293584632113,2501,153,121,2469,2622,103,0.0186661833998,2501,0.45324392896,1408,0.255164914824,4110,0.744835085176,1333,0.241573033708,G50,Guilford,37081G50
Guilford,3219,1192,0.370301335819,1182,0.367194780988,36,0.0111835973905,434,0.134824479652,270,0.0838769804287,105,0.0326188257223,1250,81,57,1226,1307,68,0.0211245728487,1250,0.388319353837,421,0.130785958372,2798,0.869214041628,1069,0.332090711401,G51,Guilford,37081G51
Guilford,3489,572,0.163943823445,2457,0.704213241617,24,0.00687876182287,127,0.036400114646,215,0.0616222413299,94,0.0269418171396,2528,60,27,2495,2555,71,0.0203496703927,2528,0.724562912009,358,0.102608197191,3131,0.897391802809,482,0.138148466609,G52,Guilford,37081G52
Guilford,4490,621,0.138307349666,3329,0.741425389755,41,0.00913140311804,88,0.0195991091314,323,0.0719376391982,88,0.0195991091314,3389,75,51,3365,3440,60,0.0133630289532,3389,0.754788418708,580,0.129175946548,3910,0.870824053452,432,0.0962138084633,G53,Guilford,37081G53
Guilford,4459,969,0.217313298946,2739,0.614263287733,48,0.0107647454586,69,0.0154743215968,505,0.113254092846,129,0.02893025342,2852,84,56,2824,2908,113,0.0253420049338,2852,0.639605292667,896,0.200941915228,3563,0.799058084772,640,0.143529939448,G54,Guilford,37081G54
Guilford,3308,673,0.203446191052,2320,0.701330108827,23,0.00695284159613,109,0.0329504232164,78,0.0235792019347,105,0.0317412333736,2401,58,27,2370,2428,81,0.0244860943168,2401,0.725816203144,195,0.0589480048368,3113,0.941051995163,598,0.180773881499,G55,Guilford,37081G55
Guilford,2783,737,0.264822134387,1173,0.421487603306,26,0.00934243621991,559,0.200862378728,201,0.0722242184693,87,0.0312612288897,1206,47,31,1190,1237,33,0.0118577075099,1206,0.433345310816,324,0.116421128279,2459,0.883578871721,636,0.228530362918,G56,Guilford,37081G56
Guilford,2732,782,0.286237188873,1602,0.586383601757,26,0.0095168374817,135,0.0494143484627,76,0.0278184480234,111,0.0406295754026,1682,60,36,1658,1718,80,0.0292825768668,1682,0.615666178624,210,0.0768667642753,2522,0.923133235725,686,0.251098096633,G57,Guilford,37081G57
Guilford,2835,855,0.301587301587,1325,0.467372134039,18,0.00634920634921,282,0.0994708994709,248,0.0874779541446,107,0.0377425044092,1401,45,25,1381,1426,76,0.0268077601411,1401,0.49417989418,419,0.147795414462,2416,0.852204585538,730,0.257495590829,G58,Guilford,37081G58
Guilford,2561,742,0.289730573995,1220,0.476376415463,18,0.00702850449043,179,0.0698945724326,302,0.117922686451,100,0.0390472471691,1286,51,30,1265,1316,66,0.0257711831316,1286,0.502147598594,430,0.167903162827,2131,0.832096837173,631,0.246388129637,G59,Guilford,37081G59
Guilford,4170,1370,0.328537170264,1574,0.377458033573,28,0.00671462829736,492,0.117985611511,571,0.136930455635,135,0.0323741007194,1650,56,42,1636,1692,76,0.0182254196643,1650,0.395683453237,1050,0.251798561151,3120,0.748201438849,986,0.236450839329,G60,Guilford,37081G60
Guilford,3723,1099,0.295192049423,1701,0.456889605157,49,0.0131614289551,239,0.0641955412302,508,0.136449100188,127,0.034112275047,1789,69,56,1776,1845,88,0.0236368520011,1789,0.480526457158,785,0.210851463873,2938,0.789148536127,891,0.239323126511,G61,Guilford,37081G61
Guilford,2199,1362,0.619372442019,507,0.230559345157,3,0.00136425648022,118,0.0536607548886,143,0.0650295588904,66,0.0300136425648,554,10,4,548,558,47,0.0213733515234,554,0.25193269668,291,0.132332878581,1908,0.867667121419,1237,0.56252842201,G62,Guilford,37081G62
Guilford,2221,1433,0.645204862674,580,0.261143628996,9,0.0040522287258,91,0.0409725348942,44,0.0198108959928,64,0.0288158487168,627,27,17,617,644,47,0.0211616389014,627,0.282305267897,113,0.0508779828906,2108,0.949122017109,1383,0.622692480864,G63,Guilford,37081G63
Guilford,4425,1910,0.431638418079,1937,0.437740112994,23,0.00519774011299,203,0.0458757062147,182,0.0411299435028,170,0.038418079096,2052,65,37,2024,2089,115,0.025988700565,2052,0.463728813559,381,0.0861016949153,4044,0.913898305085,1767,0.399322033898,G64,Guilford,37081G64
Guilford,3970,2357,0.593702770781,1020,0.256926952141,17,0.00428211586902,269,0.067758186398,137,0.0345088161209,170,0.0428211586902,1111,63,36,1084,1147,91,0.0229219143577,1111,0.279848866499,298,0.0750629722922,3672,0.924937027708,2241,0.564483627204,G65,Guilford,37081G65
Guilford,3447,2378,0.689875253844,661,0.191760951552,22,0.00638236147375,247,0.0716565129098,60,0.0174064403829,79,0.0229184798375,702,44,33,691,735,41,0.0118944009283,702,0.20365535248,187,0.0542500725268,3260,0.945749927473,2260,0.655642587757,G66,Guilford,37081G66
Guilford,1764,54,0.030612244898,1654,0.937641723356,6,0.00340136054422,6,0.00340136054422,11,0.0062358276644,33,0.0187074829932,1685,19,7,1673,1692,31,0.0175736961451,1685,0.955215419501,48,0.0272108843537,1716,0.972789115646,50,0.0283446712018,G67,Guilford,37081G67
Guilford,2972,46,0.0154777927322,2773,0.933041722746,13,0.00437415881561,4,0.00134589502019,67,0.0225437415882,69,0.0232166890983,2833,36,14,2811,2847,60,0.0201884253028,2833,0.953230148048,138,0.0464333781965,2834,0.953566621803,32,0.0107671601615,G68,Guilford,37081G68
Guilford,3005,561,0.186688851913,2285,0.760399334443,12,0.00399334442596,12,0.00399334442596,70,0.0232945091514,65,0.0216306156406,2334,33,14,2315,2348,49,0.016306156406,2334,0.776705490849,140,0.0465890183028,2865,0.953410981697,529,0.176039933444,G69,Guilford,37081G69
Guilford,3271,70,0.0214001834301,3051,0.932742280648,16,0.00489147049832,6,0.00183430143687,48,0.014674411495,80,0.0244573524916,3124,47,20,3097,3144,73,0.0223173341486,3124,0.955059614797,137,0.0418832161419,3134,0.958116783858,35,0.0107000917151,G70,Guilford,37081G70
Guilford,3974,170,0.0427780573729,3379,0.850276799195,32,0.00805234021137,129,0.0324609964771,189,0.0475591343734,75,0.0188726723704,3438,58,38,3418,3476,59,0.0148465022647,3438,0.865123301459,316,0.0795168595873,3658,0.920483140413,101,0.0254151987921,G71,Guilford,37081G71
Guilford,4013,426,0.106154996262,3118,0.776974831797,18,0.00448542237727,49,0.0122103164715,278,0.0692748567157,124,0.0308995763768,3215,68,33,3180,3248,97,0.0241714428109,3215,0.801146274608,436,0.108646897583,3577,0.891353102417,326,0.0812359830551,G72,Guilford,37081G72
Guilford,2108,92,0.0436432637571,1938,0.91935483871,5,0.00237191650854,5,0.00237191650854,26,0.0123339658444,42,0.0199240986717,1980,28,5,1957,1985,42,0.0199240986717,1980,0.939278937381,68,0.0322580645161,2040,0.967741935484,66,0.0313092979127,G73,Guilford,37081G73
Guilford,2602,31,0.0119139123751,2443,0.938893159108,12,0.00461183704842,7,0.00269023827825,57,0.02190622598,52,0.0199846272098,2490,46,16,2460,2506,47,0.0180630284397,2490,0.956956187548,80,0.0307455803228,2522,0.969254419677,24,0.00922367409685,G74,Guilford,37081G74
Guilford,2436,242,0.0993431855501,2058,0.844827586207,12,0.00492610837438,37,0.0151888341544,24,0.00985221674877,63,0.0258620689655,2110,38,13,2085,2123,52,0.0213464696223,2110,0.866174055829,79,0.0324302134647,2357,0.967569786535,205,0.0841543513957,G75,Guilford,37081G75
Guilford,3267,2409,0.737373737374,612,0.187327823691,8,0.00244872972146,26,0.00795837159474,151,0.0462197734925,61,0.0186715641261,642,20,19,641,661,30,0.00918273645546,642,0.196510560147,235,0.0719314355678,3032,0.928068564432,2331,0.71349862259,GIB,Guilford,37081GIB
Guilford,3386,3165,0.934731246308,121,0.0357353809805,15,0.00443000590667,9,0.002658003544,34,0.0100413467218,42,0.0124040165387,138,34,32,136,170,17,0.0050206733609,138,0.0407560543414,66,0.0194920259894,3320,0.980507974011,3134,0.925575900768,GR,Guilford,37081GR
Guilford,4377,1799,0.41101210875,1387,0.316883710304,47,0.0107379483665,260,0.0594014164953,762,0.174091843729,122,0.0278729723555,1443,99,73,1417,1516,56,0.0127941512451,1443,0.329677861549,1151,0.262965501485,3226,0.737034498515,1493,0.341101210875,H01,Guilford,37081H01
Guilford,2497,1487,0.595514617541,550,0.220264317181,34,0.0136163396075,123,0.0492591109331,256,0.102523027633,47,0.0188225871045,569,40,40,569,609,19,0.00760913095715,569,0.227873448138,404,0.161794152984,2093,0.838205847016,1376,0.551061273528,H02,Guilford,37081H02
Guilford,4015,1118,0.278455790785,1711,0.426151930262,25,0.00622665006227,513,0.127770859278,542,0.13499377335,106,0.026400996264,1776,48,36,1764,1812,65,0.0161892901619,1776,0.442341220423,718,0.178829389788,3297,0.821170610212,965,0.240348692403,H03,Guilford,37081H03
Guilford,4875,2175,0.446153846154,1409,0.289025641026,50,0.0102564102564,704,0.14441025641,407,0.0834871794872,130,0.0266666666667,1469,76,70,1463,1539,60,0.0123076923077,1469,0.301333333333,680,0.139487179487,4195,0.860512820513,1955,0.401025641026,H04,Guilford,37081H04
Guilford,3973,897,0.225773974327,2388,0.601057135666,26,0.00654417316889,367,0.0923735212686,176,0.044299018374,119,0.0299521771961,2474,67,34,2441,2508,86,0.0216461112509,2474,0.622703246917,369,0.0928769192046,3604,0.907123080795,741,0.186508935313,H05,Guilford,37081H05
Guilford,4397,2358,0.536274732772,1346,0.306117807596,19,0.00432112804185,359,0.0816465772117,197,0.0448032749602,118,0.0268364794178,1406,53,41,1394,1447,60,0.0136456675006,1406,0.319763475097,399,0.0907436888788,3998,0.909256311121,2216,0.503979986354,H06,Guilford,37081H06
Guilford,2759,335,0.121420804639,2083,0.754983689743,18,0.00652410293585,97,0.0351576658209,167,0.0605291772381,59,0.0213845596231,2124,30,21,2115,2145,41,0.0148604566872,2124,0.76984414643,242,0.0877129394708,2517,0.912287060529,279,0.101123595506,H07,Guilford,37081H07
Guilford,2135,291,0.136299765808,1567,0.733957845433,35,0.016393442623,42,0.0196721311475,146,0.0683840749415,54,0.0252927400468,1610,52,39,1597,1649,43,0.0201405152225,1610,0.754098360656,212,0.0992974238876,1923,0.900702576112,254,0.118969555035,H08,Guilford,37081H08
Guilford,3846,322,0.083723348934,3111,0.808892355694,23,0.00598023920957,94,0.0244409776391,143,0.0371814872595,153,0.0397815912637,3219,59,26,3186,3245,108,0.0280811232449,3219,0.836973478939,287,0.0746229849194,3559,0.925377015081,243,0.0631825273011,H09,Guilford,37081H09
Guilford,3150,464,0.147301587302,2364,0.750476190476,12,0.00380952380952,100,0.031746031746,137,0.0434920634921,73,0.0231746031746,2410,33,18,2395,2428,46,0.0146031746032,2410,0.765079365079,207,0.0657142857143,2943,0.934285714286,415,0.131746031746,H10,Guilford,37081H10
Guilford,4115,1961,0.476549210207,1895,0.460510328068,25,0.00607533414338,64,0.015552855407,95,0.0230862697448,75,0.0182260024301,1945,47,32,1930,1977,50,0.0121506682868,1945,0.472660996355,189,0.0459295261239,3926,0.954070473876,1902,0.462211421628,H11,Guilford,37081H11
Guilford,2527,1120,0.443213296399,990,0.391768895924,20,0.00791452314998,150,0.0593589236249,157,0.0621290067273,90,0.0356153541749,1054,43,30,1041,1084,64,0.0253264740799,1054,0.417095370004,280,0.1108033241,2247,0.8891966759,1037,0.410368025326,H12,Guilford,37081H12
Guilford,2503,2044,0.816620055933,297,0.118657610867,9,0.00359568517779,75,0.0299640431482,38,0.0151817818618,40,0.0159808230124,319,20,19,318,338,22,0.00878945265681,319,0.127447063524,108,0.0431482221334,2395,0.956851777867,1995,0.797043547743,H13,Guilford,37081H13
Guilford,1609,1482,0.921068986948,57,0.0354257302672,7,0.00435052827843,39,0.0242386575513,7,0.00435052827843,17,0.0105655686762,64,13,12,63,76,7,0.00435052827843,64,0.0397762585457,30,0.0186451211933,1579,0.981354878807,1463,0.909260410193,H14,Guilford,37081H14
Guilford,2868,1853,0.646094839609,718,0.250348675035,18,0.00627615062762,121,0.042189679219,86,0.0299860529986,72,0.0251046025105,763,37,31,757,794,45,0.015690376569,763,0.266039051604,276,0.0962343096234,2592,0.903765690377,1683,0.586820083682,H15,Guilford,37081H15
Guilford,1968,1385,0.703760162602,316,0.160569105691,18,0.00914634146341,75,0.0381097560976,109,0.0553861788618,65,0.0330284552846,354,49,28,333,382,38,0.0193089430894,354,0.17987804878,176,0.0894308943089,1792,0.910569105691,1343,0.682418699187,H16,Guilford,37081H16
Guilford,2190,988,0.451141552511,904,0.412785388128,24,0.0109589041096,86,0.0392694063927,116,0.0529680365297,72,0.0328767123288,953,37,30,946,983,49,0.0223744292237,953,0.435159817352,214,0.0977168949772,1976,0.902283105023,914,0.417351598174,H17,Guilford,37081H17
Guilford,3189,1292,0.405142677955,1642,0.514894951395,4,0.00125431169646,106,0.0332392599561,58,0.0181875195986,87,0.0272812793979,1689,25,12,1676,1701,47,0.0147381624334,1689,0.529633113829,208,0.0652242082157,2981,0.934775791784,1185,0.371589840075,H18,Guilford,37081H18
Guilford,1861,405,0.217624932832,1365,0.73347662547,11,0.00591080064481,12,0.00644814615798,36,0.0193444384739,32,0.0171950564213,1392,26,12,1378,1404,27,0.0145083288555,1392,0.747984954326,73,0.039226222461,1788,0.960773777539,386,0.207415368082,H19A,Guilford,37081H19A
Guilford,1353,955,0.705838876571,305,0.225424981523,6,0.00443458980044,45,0.0332594235033,18,0.0133037694013,24,0.0177383592018,317,8,8,317,325,12,0.00886917960089,317,0.234294161123,56,0.0413895048041,1297,0.958610495196,929,0.686622320769,H19B,Guilford,37081H19B
Guilford,1954,1313,0.671954964176,452,0.231320368475,18,0.00921187308086,67,0.0342886386899,52,0.0266120777892,52,0.0266120777892,488,40,24,472,512,36,0.0184237461617,488,0.249744114637,124,0.0634595701126,1830,0.936540429887,1263,0.64636642784,H20A,Guilford,37081H20A
Guilford,1440,1120,0.777777777778,214,0.148611111111,3,0.00208333333333,45,0.03125,34,0.0236111111111,24,0.0166666666667,227,14,10,223,237,13,0.00902777777778,227,0.157638888889,61,0.0423611111111,1379,0.957638888889,1101,0.764583333333,H20B,Guilford,37081H20B
Guilford,2014,1536,0.762661370407,338,0.167825223436,8,0.00397219463754,62,0.0307845084409,46,0.0228401191658,24,0.0119165839126,348,14,12,346,360,10,0.00496524329692,348,0.172790466733,119,0.0590863952334,1895,0.940913604767,1476,0.732869910626,H21,Guilford,37081H21
Guilford,2207,1439,0.652016311735,579,0.262347077481,14,0.00634345265066,31,0.0140462165836,83,0.0376076121432,61,0.0276393294064,617,29,23,611,640,38,0.0172179429089,617,0.27956502039,207,0.0937924784776,2000,0.906207521522,1336,0.605346624377,H22,Guilford,37081H22
Guilford,1925,1589,0.825454545455,250,0.12987012987,5,0.0025974025974,25,0.012987012987,30,0.0155844155844,26,0.0135064935065,255,13,13,255,268,5,0.0025974025974,255,0.132467532468,86,0.0446753246753,1839,0.955324675325,1541,0.800519480519,H23,Guilford,37081H23
Guilford,3047,2261,0.74204135215,489,0.160485723663,4,0.00131276665573,189,0.0620282244831,66,0.0216606498195,38,0.0124712832294,517,7,6,516,523,28,0.00918936659009,517,0.169675090253,156,0.0511978995734,2891,0.948802100427,2155,0.707253035773,H24,Guilford,37081H24
Guilford,4341,3317,0.764109652154,631,0.145358212393,10,0.00230361667818,266,0.0612762036397,53,0.0122091683944,64,0.0147431467404,654,22,16,648,670,23,0.00529831835982,654,0.150656530753,185,0.0426169085464,4156,0.957383091454,3198,0.736696613683,H25,Guilford,37081H25
Guilford,2398,1795,0.748540450375,376,0.156797331109,8,0.00333611342786,141,0.058798999166,30,0.0125104253545,48,0.0200166805671,397,15,9,391,406,21,0.00875729774812,397,0.165554628857,84,0.0350291909925,2314,0.964970809008,1748,0.728940783987,H26,Guilford,37081H26
Guilford,5858,4157,0.709627859338,762,0.130078525094,21,0.00358484124274,681,0.1162512803,107,0.0182656196654,130,0.0221918743598,819,41,33,811,852,57,0.00973028337316,819,0.139808808467,354,0.0604301809491,5504,0.939569819051,3955,0.675145100717,H27,Guilford,37081H27
Guilford,9926,5964,0.600846262341,2769,0.278964336087,26,0.00261938343744,767,0.0772718114044,188,0.018940157163,212,0.0213580495668,2876,75,53,2854,2929,107,0.0107797703002,2876,0.289744106387,560,0.0564174894217,9366,0.943582510578,5651,0.569312915575,HP,Guilford,37081HP
Guilford,3436,2754,0.80151338766,476,0.138533178114,14,0.00407450523865,93,0.0270663562282,40,0.011641443539,59,0.01717112922,512,22,20,510,532,36,0.0104772991851,512,0.149010477299,112,0.0325960419092,3324,0.967403958091,2695,0.78434225844,JAM1,Guilford,37081JAM1
Guilford,2117,1644,0.7765706188,305,0.144071799717,4,0.00188946622579,102,0.0481813887577,22,0.0103920642419,40,0.0188946622579,332,6,5,331,337,27,0.0127538970241,332,0.156825696741,88,0.0415682569674,2029,0.958431743033,1591,0.751535191308,JAM2,Guilford,37081JAM2
Guilford,2344,1702,0.726109215017,376,0.160409556314,8,0.00341296928328,146,0.0622866894198,52,0.0221843003413,60,0.0255972696246,396,31,28,393,424,20,0.00853242320819,396,0.168941979522,121,0.0516211604096,2223,0.94837883959,1651,0.704351535836,JAM3,Guilford,37081JAM3
Guilford,2555,2197,0.85988258317,175,0.0684931506849,16,0.00626223091977,93,0.0363992172211,49,0.0191780821918,25,0.00978473581213,184,21,21,184,205,9,0.00352250489237,184,0.0720156555773,81,0.0317025440313,2474,0.968297455969,2168,0.848532289628,JAM4,Guilford,37081JAM4
Guilford,2323,1944,0.836848902282,77,0.0331467929402,5,0.00215238915196,157,0.0675850193715,94,0.0404649160568,46,0.019801980198,86,23,21,84,107,9,0.00387430047353,86,0.0370210934137,156,0.0671545415411,2167,0.932845458459,1887,0.812311665949,JAM5,Guilford,37081JAM5
Guilford,3635,2586,0.711416781293,699,0.192297111417,39,0.0107290233838,34,0.00935350756534,212,0.0583218707015,65,0.0178817056396,737,61,51,727,788,38,0.0104539202201,737,0.202751031637,367,0.100962861073,3268,0.899037138927,2467,0.678679504814,JEF1,Guilford,37081JEF1
Guilford,3363,1879,0.558727326792,1164,0.346119536128,23,0.00683913172762,41,0.0121914956884,135,0.0401427297056,121,0.0359797799584,1247,63,39,1223,1286,83,0.0246803449301,1247,0.370799881059,348,0.103479036574,3015,0.896520963426,1707,0.507582515611,JEF2,Guilford,37081JEF2
Guilford,4433,1311,0.295736521543,2833,0.639070606813,30,0.00676742612226,60,0.0135348522445,95,0.0214301827205,104,0.0234604105572,2913,55,33,2891,2946,80,0.0180464696594,2913,0.657117076472,225,0.050755695917,4208,0.949244304083,1214,0.273855177081,JEF3,Guilford,37081JEF3
Guilford,2397,1712,0.714226115978,513,0.214017521902,19,0.00792657488527,48,0.0200250312891,47,0.0196078431373,58,0.0241969128077,544,32,30,542,574,31,0.0129328327076,544,0.22695035461,97,0.0404672507301,2300,0.95953274927,1674,0.698372966208,JEF4,Guilford,37081JEF4
Guilford,3983,1913,0.48029123776,1368,0.343459703741,44,0.0110469495355,40,0.0100426813959,523,0.131308059252,95,0.0238513683153,1428,65,53,1416,1481,60,0.0150640220939,1428,0.358523725835,895,0.224704996234,3088,0.775295003766,1621,0.40697966357,MON1,Guilford,37081MON1
Guilford,6987,2822,0.403892944039,3606,0.516101331043,29,0.00415056533562,77,0.0110204665808,269,0.0385000715615,184,0.0263346214398,3726,78,45,3693,3771,120,0.0171747531129,3726,0.533276084156,520,0.074423930156,6467,0.925576069844,2623,0.37541147846,MON2,Guilford,37081MON2
Guilford,5082,4047,0.796340023613,673,0.132428177883,18,0.00354191263282,48,0.00944510035419,199,0.0391578118851,97,0.0190869736324,717,49,37,705,754,44,0.00865800865801,717,0.141086186541,347,0.0682802046438,4735,0.931719795356,3910,0.769382133018,MON3,Guilford,37081MON3
Guilford,4046,3612,0.892733564014,260,0.0642609985171,5,0.00123578843302,91,0.022491349481,41,0.0101334651508,37,0.00914483440435,269,12,12,269,281,9,0.00222441917944,269,0.0664854176965,121,0.0299060800791,3925,0.970093919921,3531,0.872713791399,NCGR1,Guilford,37081NCGR1
Guilford,2491,2327,0.934162986752,81,0.0325170614211,6,0.00240867121638,30,0.0120433560819,17,0.00682456844641,30,0.0120433560819,96,23,12,85,108,15,0.00602167804095,96,0.0385387394621,66,0.0264953833802,2425,0.97350461662,2279,0.914893617021,NCGR2,Guilford,37081NCGR2
Guilford,3043,2394,0.786723627999,538,0.176799211305,8,0.00262898455472,24,0.00788695366415,41,0.0134735458429,38,0.0124876766349,553,24,21,550,574,15,0.00492934604009,553,0.181728557345,73,0.0239894840618,2970,0.976010515938,2370,0.778836674335,NCLAY1,Guilford,37081NCLAY1
Guilford,1713,1569,0.915936952715,75,0.0437828371278,18,0.0105078809107,21,0.0122591943958,12,0.00700525394046,18,0.0105078809107,77,27,27,77,104,2,0.00116754232341,77,0.0449503794513,29,0.0169293636894,1684,0.983070636311,1554,0.907180385289,NCLAY2,Guilford,37081NCLAY2
Guilford,2914,2663,0.913864104324,64,0.0219629375429,15,0.00514756348662,105,0.0360329444063,15,0.00514756348662,52,0.0178448867536,81,40,35,76,116,17,0.00583390528483,81,0.0277968428277,102,0.035003431709,2812,0.964996568291,2579,0.885037748799,NDRI,Guilford,37081NDRI
Guilford,2717,1855,0.682738314317,669,0.246227456754,18,0.00662495399338,12,0.00441663599558,135,0.0496871549503,28,0.0103054839897,685,25,22,682,707,16,0.00588884799411,685,0.252116304748,199,0.0732425469268,2518,0.926757453073,1801,0.662863452337,NMAD,Guilford,37081NMAD
Guilford,1610,1519,0.94347826087,63,0.0391304347826,7,0.00434782608696,1,0.000621118012422,10,0.00621118012422,10,0.00621118012422,65,10,9,64,74,2,0.00124223602484,65,0.0403726708075,22,0.0136645962733,1588,0.986335403727,1509,0.937267080745,NWASH,Guilford,37081NWASH
Guilford,4034,3682,0.912741695588,177,0.0438770451165,16,0.0039662865642,79,0.0195835399108,48,0.0118988596926,32,0.00793257312841,186,26,24,184,210,9,0.00223103619236,186,0.0461080813089,101,0.0250371839365,3933,0.974962816063,3623,0.898116013882,OR1,Guilford,37081OR1
Guilford,3150,2739,0.869523809524,179,0.0568253968254,13,0.00412698412698,148,0.0469841269841,24,0.00761904761905,47,0.0149206349206,188,20,20,188,208,9,0.00285714285714,188,0.0596825396825,100,0.031746031746,3050,0.968253968254,2669,0.847301587302,OR2,Guilford,37081OR2
Guilford,2297,1743,0.758815846757,336,0.146277753592,18,0.00783630822812,13,0.00565955594253,134,0.0583369612538,53,0.0230735742273,378,34,23,367,401,42,0.018284719199,378,0.164562472791,171,0.0744449281672,2126,0.925555071833,1718,0.747932085329,PG1,Guilford,37081PG1
Guilford,3439,3072,0.893282931085,239,0.0694969467869,28,0.00814190171562,23,0.00668799069497,36,0.0104681593486,41,0.0119220703693,256,51,48,253,304,17,0.00494329747019,256,0.0744402442571,77,0.0223902297179,3362,0.977609770282,3042,0.884559464961,PG2,Guilford,37081PG2
Guilford,3880,2625,0.676546391753,1045,0.269329896907,12,0.00309278350515,81,0.0208762886598,32,0.00824742268041,85,0.0219072164948,1098,60,31,1069,1129,53,0.0136597938144,1098,0.282989690722,102,0.0262886597938,3778,0.973711340206,2566,0.661340206186,RC1,Guilford,37081RC1
Guilford,4839,3641,0.752428187642,955,0.197354825377,17,0.00351312254598,55,0.0113659847076,83,0.0171523041951,88,0.0181855755321,1014,41,23,996,1037,59,0.0121926017772,1014,0.209547427154,242,0.0500103327134,4597,0.949989667287,3511,0.725563132879,RC2,Guilford,37081RC2
Guilford,2598,2419,0.931100846805,94,0.036181678214,11,0.00423402617398,19,0.00731331793687,13,0.0050038491147,42,0.0161662817552,109,33,30,106,139,15,0.00577367205543,109,0.0419553502694,55,0.0211701308699,2543,0.97882986913,2387,0.918783679754,SCLAY,Guilford,37081SCLAY
Guilford,4946,4035,0.815810756167,452,0.0913869793773,24,0.00485240598463,315,0.0636878285483,43,0.0086938940558,77,0.0155681358674,482,32,31,481,513,30,0.00606550748079,482,0.0974524868581,207,0.0418520016175,4739,0.958147998383,3888,0.786089769511,SDRI,Guilford,37081SDRI
Guilford,4267,3704,0.868057183033,218,0.0510897586126,15,0.00351535036325,139,0.0325755800328,107,0.0250761659245,84,0.0196859620342,249,45,37,241,286,31,0.00726505741739,249,0.05835481603,256,0.0599953128662,4011,0.940004687134,3569,0.836419029763,SF1,Guilford,37081SF1
Guilford,2082,1914,0.919308357349,79,0.037944284342,12,0.00576368876081,27,0.0129682997118,15,0.00720461095101,35,0.0168107588857,90,31,28,87,118,11,0.00528338136407,90,0.0432276657061,58,0.0278578290106,2024,0.972142170989,1880,0.90297790586,SF2,Guilford,37081SF2
Guilford,3073,2611,0.849658314351,217,0.0706150341686,16,0.00520663846404,137,0.0445818418484,36,0.0117149365441,56,0.0182232346241,244,27,16,233,260,27,0.00878620240807,244,0.0794012365766,113,0.0367718841523,2960,0.963228115848,2548,0.829157175399,SF3,Guilford,37081SF3
Guilford,4544,3845,0.846170774648,336,0.0739436619718,7,0.00154049295775,251,0.0552376760563,38,0.00836267605634,67,0.0147447183099,363,25,18,356,381,27,0.00594190140845,363,0.0798855633803,191,0.0420334507042,4353,0.957966549296,3700,0.81426056338,SF4,Guilford,37081SF4
Guilford,3767,2650,0.703477568357,927,0.246084417308,35,0.00929121316698,18,0.00477833820016,72,0.0191133528006,65,0.0172551101672,959,50,45,954,1004,32,0.00849482346695,959,0.254579240775,128,0.0339792938678,3639,0.966020706132,2611,0.693124502256,SMAD,Guilford,37081SMAD
Guilford,5050,4591,0.909108910891,237,0.0469306930693,18,0.00356435643564,72,0.0142574257426,64,0.0126732673267,68,0.0134653465347,265,38,30,257,295,28,0.00554455445545,265,0.0524752475248,178,0.0352475247525,4872,0.964752475248,4486,0.888316831683,STOK,Guilford,37081STOK
Guilford,3101,1395,0.449854885521,1300,0.419219606579,17,0.00548210254757,196,0.0632054176072,123,0.0396646243147,70,0.0225733634312,1359,41,22,1340,1381,59,0.0190261206063,1359,0.438245727185,250,0.0806191551113,2851,0.919380844889,1286,0.414704933892,SUM1,Guilford,37081SUM1
Guilford,2553,1310,0.51312181747,1061,0.415589502546,26,0.0101840971406,30,0.0117508813161,85,0.0332941637289,41,0.0160595377987,1095,41,30,1084,1125,34,0.0133176654916,1095,0.428907168038,141,0.0552291421857,2412,0.944770857814,1283,0.502546024285,SUM2,Guilford,37081SUM2
Guilford,1722,1493,0.867015098722,87,0.0505226480836,20,0.0116144018583,17,0.00987224157956,85,0.0493612078978,20,0.0116144018583,93,27,27,93,120,6,0.00348432055749,93,0.0540069686411,195,0.113240418118,1527,0.886759581882,1389,0.806620209059,SUM3,Guilford,37081SUM3
Guilford,2702,2512,0.929681717246,74,0.0273871206514,25,0.00925240562546,15,0.00555144337528,24,0.00888230940044,52,0.019245003701,99,42,38,95,137,25,0.00925240562546,99,0.0366395262768,63,0.0233160621762,2639,0.976683937824,2485,0.919689119171,SUM4,Guilford,37081SUM4
Guilford,1327,1108,0.834966088922,177,0.133383571967,1,0.000753579502638,1,0.000753579502638,30,0.0226073850791,10,0.00753579502638,181,3,3,181,184,4,0.00301431801055,181,0.136397889977,55,0.0414468726451,1272,0.958553127355,1086,0.818387339864,SWASH,Guilford,37081SWASH
Halifax,568,219,0.385563380282,334,0.588028169014,7,0.012323943662,0,0.0,4,0.00704225352113,4,0.00704225352113,336,10,9,335,345,2,0.00352112676056,336,0.591549295775,5,0.00880281690141,563,0.991197183099,219,0.385563380282,BUTWD,Halifax,37083BUTWD
Halifax,499,116,0.23246492986,331,0.663326653307,1,0.00200400801603,1,0.00200400801603,49,0.0981963927856,1,0.00200400801603,331,2,2,331,333,0,0.0,331,0.663326653307,59,0.118236472946,440,0.881763527054,106,0.212424849699,CONC,Halifax,37083CONC
Halifax,1848,234,0.126623376623,1584,0.857142857143,5,0.00270562770563,5,0.00270562770563,6,0.00324675324675,14,0.00757575757576,1596,14,7,1589,1603,12,0.00649350649351,1596,0.863636363636,12,0.00649350649351,1836,0.993506493506,231,0.125,ENF-1,Halifax,37083ENF-1
Halifax,2364,256,0.108291032149,2074,0.877326565144,9,0.00380710659898,0,0.0,11,0.00465313028765,14,0.00592216582064,2084,14,11,2081,2095,10,0.00423011844332,2084,0.881556683587,26,0.0109983079526,2338,0.989001692047,249,0.105329949239,ENF-2,Halifax,37083ENF-2
Halifax,1630,325,0.199386503067,1261,0.773619631902,9,0.00552147239264,8,0.00490797546012,10,0.00613496932515,17,0.0104294478528,1277,21,10,1266,1287,16,0.00981595092025,1277,0.783435582822,20,0.0122699386503,1610,0.98773006135,323,0.198159509202,ENF-3,Halifax,37083ENF-3
Halifax,1738,1022,0.588032220944,682,0.392405063291,4,0.00230149597238,4,0.00230149597238,9,0.00517836593786,17,0.00978135788262,694,9,5,690,699,12,0.00690448791715,694,0.399309551208,21,0.012082853855,1717,0.987917146145,1009,0.580552359033,FAUCT,Halifax,37083FAUCT
Halifax,2775,725,0.261261261261,1964,0.707747747748,38,0.0136936936937,4,0.00144144144144,14,0.00504504504505,30,0.0108108108108,1992,54,38,1976,2030,28,0.0100900900901,1992,0.717837837838,38,0.0136936936937,2737,0.986306306306,700,0.252252252252,HAL,Halifax,37083HAL
Halifax,668,268,0.40119760479,384,0.574850299401,0,0.0,0,0.0,14,0.0209580838323,2,0.00299401197605,386,0,0,386,386,2,0.00299401197605,386,0.577844311377,27,0.0404191616766,641,0.959580838323,257,0.384730538922,HOB,Halifax,37083HOB
Halifax,3341,167,0.0499850344208,1419,0.424723136785,1671,0.500149655792,2,0.000598623166717,8,0.00239449266687,74,0.0221490571685,1476,1726,1686,1436,3162,57,0.0170607602514,1476,0.441783897037,50,0.0149655791679,3291,0.985034420832,167,0.0499850344208,HOL,Halifax,37083HOL
Halifax,2144,632,0.294776119403,1446,0.674440298507,24,0.0111940298507,3,0.00139925373134,20,0.00932835820896,19,0.00886194029851,1462,31,27,1458,1489,16,0.00746268656716,1462,0.681902985075,29,0.013526119403,2115,0.986473880597,628,0.292910447761,LIT-1,Halifax,37083LIT-1
Halifax,1847,1254,0.678938819708,536,0.290200324851,23,0.0124526258798,7,0.00378992961559,11,0.00595560368165,16,0.00866269626421,541,31,27,537,568,5,0.00270709258257,541,0.292907417434,16,0.00866269626421,1831,0.991337303736,1251,0.677314564158,LIT-2,Halifax,37083LIT-2
Halifax,415,82,0.197590361446,313,0.75421686747,0,0.0,5,0.0120481927711,12,0.0289156626506,3,0.00722891566265,314,1,1,314,315,1,0.00240963855422,314,0.756626506024,16,0.0385542168675,399,0.961445783133,80,0.192771084337,PAL,Halifax,37083PAL
Halifax,1818,207,0.113861386139,1511,0.831133113311,64,0.035203520352,1,0.000550055005501,15,0.00825082508251,20,0.01100110011,1522,76,68,1514,1590,11,0.00605060506051,1522,0.837183718372,21,0.0115511551155,1797,0.988448844884,204,0.112211221122,RINGW,Halifax,37083RINGW
Halifax,572,278,0.486013986014,276,0.482517482517,1,0.00174825174825,1,0.00174825174825,11,0.0192307692308,5,0.00874125874126,276,1,1,276,277,0,0.0,276,0.482517482517,27,0.0472027972028,545,0.952797202797,263,0.45979020979,ROSEN,Halifax,37083ROSEN
Halifax,1604,928,0.57855361596,577,0.359725685786,12,0.0074812967581,11,0.0068578553616,41,0.0255610972569,35,0.0218204488778,605,16,13,602,618,28,0.0174563591022,605,0.377182044888,77,0.0480049875312,1527,0.951995012469,910,0.567331670823,RR-1,Halifax,37083RR-1
Halifax,3678,2332,0.63404023926,1063,0.28901576944,22,0.00598151169114,144,0.0391517128874,71,0.0193039695487,46,0.0125067971724,1091,32,25,1084,1116,28,0.00761283306145,1091,0.296628602501,141,0.0383360522023,3537,0.961663947798,2278,0.619358346928,RR-10,Halifax,37083RR-10
Halifax,3681,2309,0.627275196957,1214,0.329801684325,40,0.0108666123336,34,0.00923662048356,42,0.0114099429503,42,0.0114099429503,1228,59,51,1220,1279,14,0.00380331431676,1228,0.333604998642,90,0.0244498777506,3591,0.975550122249,2288,0.621570225482,RR-11,Halifax,37083RR-11
Halifax,677,488,0.72082717873,160,0.236336779911,12,0.0177252584934,3,0.00443131462334,1,0.00147710487445,13,0.0192023633678,169,16,14,167,183,9,0.01329394387,169,0.249630723781,1,0.00147710487445,676,0.998522895126,487,0.719350073855,RR-2,Halifax,37083RR-2
Halifax,1628,1383,0.849508599509,202,0.124078624079,4,0.002457002457,18,0.0110565110565,7,0.00429975429975,14,0.00859950859951,210,8,7,209,217,8,0.004914004914,210,0.128992628993,27,0.0165847665848,1601,0.983415233415,1372,0.842751842752,RR-3,Halifax,37083RR-3
Halifax,1342,1154,0.859910581222,133,0.0991058122206,4,0.00298062593145,23,0.0171385991058,20,0.0149031296572,8,0.00596125186289,133,8,8,133,141,0,0.0,133,0.0991058122206,39,0.0290611028316,1303,0.970938897168,1139,0.848733233979,RR-4,Halifax,37083RR-4
Halifax,1584,1096,0.691919191919,403,0.254419191919,14,0.00883838383838,11,0.00694444444444,36,0.0227272727273,24,0.0151515151515,420,20,19,419,439,17,0.0107323232323,420,0.265151515152,52,0.0328282828283,1532,0.967171717172,1082,0.683080808081,RR-5,Halifax,37083RR-5
Halifax,1412,1138,0.805949008499,194,0.137393767705,5,0.00354107648725,34,0.0240793201133,21,0.0148725212465,20,0.014164305949,208,13,6,201,214,14,0.00991501416431,208,0.14730878187,48,0.0339943342776,1364,0.966005665722,1117,0.791076487252,RR-6,Halifax,37083RR-6
Halifax,1888,595,0.315148305085,1223,0.647775423729,3,0.00158898305085,11,0.00582627118644,43,0.0227754237288,13,0.00688559322034,1228,6,5,1227,1233,5,0.00264830508475,1228,0.650423728814,43,0.0227754237288,1845,0.977224576271,591,0.313029661017,RR-7,Halifax,37083RR-7
Halifax,1830,960,0.524590163934,785,0.428961748634,6,0.00327868852459,12,0.00655737704918,35,0.0191256830601,32,0.0174863387978,795,18,16,793,811,10,0.00546448087432,795,0.434426229508,69,0.0377049180328,1761,0.962295081967,939,0.513114754098,RR-8,Halifax,37083RR-8
Halifax,3975,1365,0.343396226415,2486,0.625408805031,37,0.00930817610063,6,0.00150943396226,11,0.00276729559748,70,0.0176100628931,2525,65,57,2517,2582,39,0.00981132075472,2525,0.635220125786,64,0.0161006289308,3911,0.983899371069,1349,0.339371069182,RR-9,Halifax,37083RR-9
Halifax,2197,140,0.0637232589895,2047,0.931725079654,5,0.0022758306782,0,0.0,1,0.00045516613564,4,0.00182066454256,2049,8,7,2048,2056,2,0.000910332271279,2049,0.932635411925,16,0.00728265817023,2181,0.99271734183,133,0.0605370960401,SN-1,Halifax,37083SN-1
Halifax,1487,771,0.518493611298,696,0.468056489576,4,0.00268997982515,3,0.00201748486886,10,0.00672494956288,3,0.00201748486886,699,5,4,698,703,3,0.00201748486886,699,0.470073974445,18,0.0121049092132,1469,0.987895090787,763,0.513113651648,SN-2,Halifax,37083SN-2
Halifax,1571,268,0.170591979631,1219,0.775938892425,10,0.00636537237428,3,0.00190961171229,27,0.0171865054106,44,0.0280076384468,1251,27,16,1240,1267,32,0.0203691915977,1251,0.796308084023,51,0.0324633991088,1520,0.967536600891,260,0.165499681731,WEL-1,Halifax,37083WEL-1
Halifax,772,287,0.371761658031,464,0.60103626943,1,0.00129533678756,6,0.00777202072539,2,0.00259067357513,12,0.0155440414508,475,7,1,469,476,11,0.0142487046632,475,0.615284974093,2,0.00259067357513,770,0.997409326425,287,0.371761658031,WEL-2,Halifax,37083WEL-2
Halifax,3138,891,0.283938814532,2128,0.678138942001,36,0.0114722753346,21,0.00669216061185,19,0.00605481198215,43,0.0137029955386,2158,39,37,2156,2195,30,0.00956022944551,2158,0.687699171447,47,0.014977692798,3091,0.985022307202,887,0.282664117272,WEL-3,Halifax,37083WEL-3
Harnett,12943,8648,0.668160395581,2704,0.20891601638,196,0.0151433207139,270,0.0208606969018,492,0.0380128254655,633,0.0489067449587,3010,367,313,2956,3323,306,0.0236421231554,3010,0.232558139535,1343,0.103762651626,11600,0.896237348374,8018,0.619485436143,PR01,Harnett,37085PR01
Harnett,17943,12163,0.677868806777,3555,0.198127403444,221,0.0123167809173,323,0.018001449033,827,0.0460903973694,854,0.0475951624589,4004,434,341,3911,4345,449,0.0250236861171,4004,0.223151089561,1973,0.109959315611,15970,0.890040684389,11331,0.631499749206,PR07,Harnett,37085PR07
Harnett,10373,7280,0.701822037983,1485,0.143160127253,133,0.0128217487708,76,0.00732671358334,1168,0.112600019281,231,0.0222693531283,1608,203,185,1590,1793,123,0.0118577075099,1608,0.155017834763,1925,0.185577942736,8448,0.814422057264,6716,0.647450110865,PR08,Harnett,37085PR08
Harnett,11015,7180,0.651838402179,2608,0.236768043577,91,0.00826146164321,124,0.011257376305,463,0.0420335905583,549,0.0498411257376,2918,279,211,2850,3129,310,0.0281434407626,2918,0.26491148434,1209,0.109759418974,9806,0.890240581026,6627,0.60163413527,PR16,Harnett,37085PR16
Harnett,4892,2654,0.542518397383,1946,0.397792313982,50,0.0102207686018,41,0.00838103025348,126,0.0257563368765,75,0.0153311529027,1982,78,68,1972,2050,36,0.0073589533933,1982,0.405151267375,375,0.0766557645135,4517,0.923344235487,2434,0.497547015536,PR17,Harnett,37085PR17
Harnett,3767,1689,0.448367401115,1827,0.485001327316,81,0.0215025219007,18,0.00477833820016,49,0.0130076984338,103,0.0273427130342,1890,125,102,1867,1992,63,0.0167241837006,1890,0.501725511017,123,0.0326519777011,3644,0.967348022299,1645,0.436687018848,PR20,Harnett,37085PR20
Harnett,8829,6451,0.730660323932,1413,0.16004077472,143,0.0161966247593,34,0.00385094574697,625,0.0707894438781,163,0.0184618869634,1505,191,166,1480,1671,92,0.0104202061389,1505,0.170460980859,1166,0.132064786499,7663,0.867935213501,6043,0.684448974969,PR23,Harnett,37085PR23
Harnett,10911,8148,0.74676931537,1295,0.11868756301,119,0.010906424709,32,0.00293282008982,1062,0.0973329667308,255,0.0233709100907,1380,217,206,1369,1586,85,0.00779030336358,1380,0.126477866373,1846,0.169187058931,9065,0.830812941069,7517,0.688937769224,PR24,Harnett,37085PR24
Harnett,5689,2778,0.48831077518,2392,0.42046053788,69,0.0121286693619,26,0.00457022323783,267,0.0469326770962,157,0.0275971172438,2504,131,89,2462,2593,112,0.019687115486,2504,0.440147653366,390,0.0685533485674,5299,0.931446651433,2698,0.474248549833,PR25,Harnett,37085PR25
Harnett,5990,4589,0.766110183639,900,0.150250417362,87,0.0145242070117,19,0.00317195325543,261,0.0435726210351,134,0.0223706176962,967,146,126,947,1093,67,0.0111853088481,967,0.16143572621,388,0.064774624374,5602,0.935225375626,4512,0.75325542571,PR26,Harnett,37085PR26
Harnett,7464,5693,0.762727759914,1024,0.137191854234,55,0.00736870310825,112,0.0150053590568,422,0.0565380493033,158,0.0211682743837,1102,108,86,1080,1188,78,0.0104501607717,1102,0.147642015005,656,0.0878885316184,6808,0.912111468382,5506,0.737674169346,PR27,Harnett,37085PR27
Harnett,7547,6221,0.824301046774,788,0.104412349278,70,0.0092752086922,22,0.00291506558898,317,0.0420034450775,129,0.0170928845899,857,121,97,833,954,69,0.00914270571088,857,0.113555054989,616,0.0816218364913,6931,0.918378163509,5962,0.789982774612,PR28,Harnett,37085PR28
Harnett,7315,4806,0.657006151743,2036,0.278332194122,77,0.0105263157895,71,0.00970608339029,193,0.0263841421736,132,0.018045112782,2110,120,99,2089,2209,74,0.0101161995899,2110,0.288448393712,349,0.0477101845523,6966,0.952289815448,4698,0.642241968558,PR29,Harnett,37085PR29
Haywood,2674,2563,0.958489154824,10,0.0037397157816,12,0.00448765893792,17,0.00635751682872,41,0.0153328347046,31,0.011593118923,18,31,31,18,49,8,0.00299177262528,18,0.00673148840688,112,0.0418848167539,2562,0.958115183246,2493,0.932311144353,AC,Haywood,37087AC
Haywood,37,36,0.972972972973,0,0.0,0,0.0,1,0.027027027027,0,0.0,0,0.0,0,0,0,0,0,0,0.0,0,0.0,0,0.0,37,1.0,36,0.972972972973,BC,Haywood,37087BC
Haywood,1906,1856,0.973767051417,9,0.00472193074502,4,0.00209863588667,1,0.000524658971668,19,0.0099685204617,17,0.00891920251836,10,14,14,10,24,1,0.000524658971668,10,0.00524658971668,38,0.0199370409234,1868,0.980062959077,1844,0.967471143757,BE-1,Haywood,37087BE-1
Haywood,1758,1668,0.948805460751,2,0.00113765642776,17,0.00967007963595,8,0.00455062571104,42,0.0238907849829,21,0.0119453924915,5,30,29,4,34,3,0.00170648464164,5,0.0028441410694,96,0.0546075085324,1662,0.945392491468,1620,0.921501706485,BE-2,Haywood,37087BE-2
Haywood,2711,2573,0.949096274437,26,0.00959055699004,6,0.00221320545924,10,0.0036886757654,46,0.0169679085208,50,0.018443378827,35,38,37,34,72,9,0.00331980818886,35,0.0129103651789,108,0.0398376982663,2603,0.960162301734,2521,0.929915160457,BE-3,Haywood,37087BE-3
Haywood,2303,2218,0.963091619627,13,0.00564481111594,10,0.00434216239687,6,0.00260529743812,34,0.0147633521494,22,0.00955275727312,18,21,21,18,39,5,0.00217108119844,18,0.00781589231437,108,0.0468953538862,2195,0.953104646114,2152,0.934433347807,BE-4,Haywood,37087BE-4
Haywood,2449,2202,0.899142507146,167,0.0681910984075,24,0.00979991833401,5,0.00204164965292,14,0.00571661902817,37,0.0151082074316,188,34,33,187,221,21,0.00857492854226,188,0.0767660269498,63,0.0257247856268,2386,0.974275214373,2156,0.880359330339,BE56,Haywood,37087BE56
Haywood,1646,1620,0.984204131227,4,0.00243013365735,2,0.00121506682868,1,0.000607533414338,6,0.00364520048603,13,0.00789793438639,11,5,5,11,16,7,0.00425273390036,11,0.00668286755772,24,0.0145808019441,1622,0.985419198056,1601,0.972660996355,BE-7,Haywood,37087BE-7
Haywood,504,496,0.984126984127,1,0.00198412698413,0,0.0,1,0.00198412698413,0,0.0,6,0.0119047619048,1,4,4,1,5,0,0.0,1,0.00198412698413,4,0.00793650793651,500,0.992063492063,493,0.978174603175,CE,Haywood,37087CE
Haywood,3076,2914,0.94733420026,34,0.0110533159948,5,0.00162548764629,17,0.0055266579974,67,0.0217815344603,39,0.0126788036411,45,26,23,42,68,11,0.00357607282185,45,0.0146293888166,126,0.0409622886866,2950,0.959037711313,2868,0.932379713914,CL-N,Haywood,37087CL-N
Haywood,3454,3283,0.950492182976,48,0.0138969310944,17,0.00492182976259,11,0.0031847133758,57,0.0165026056746,38,0.0110017371164,64,38,33,59,97,16,0.00463231036479,64,0.0185292414592,115,0.033294730747,3339,0.966705269253,3231,0.935437174291,CL-S,Haywood,37087CL-S
Haywood,1736,1699,0.978686635945,1,0.000576036866359,3,0.00172811059908,10,0.00576036866359,8,0.00460829493088,15,0.00864055299539,3,7,7,3,10,2,0.00115207373272,3,0.00172811059908,32,0.0184331797235,1704,0.981566820276,1675,0.964861751152,CR,Haywood,37087CR
Haywood,1652,1607,0.972760290557,2,0.00121065375303,15,0.0090799031477,2,0.00121065375303,12,0.00726392251816,14,0.00847457627119,4,23,23,4,27,2,0.00121065375303,4,0.00242130750605,51,0.0308716707022,1601,0.969128329298,1573,0.952179176755,EF,Haywood,37087EF
Haywood,1020,993,0.973529411765,3,0.00294117647059,5,0.00490196078431,2,0.00196078431373,6,0.00588235294118,11,0.0107843137255,5,11,10,4,15,2,0.00196078431373,5,0.00490196078431,11,0.0107843137255,1009,0.989215686275,986,0.966666666667,FC-1,Haywood,37087FC-1
Haywood,246,242,0.983739837398,0,0.0,0,0.0,2,0.00813008130081,0,0.0,2,0.00813008130081,2,2,0,0,2,2,0.00813008130081,2,0.00813008130081,2,0.00813008130081,244,0.991869918699,240,0.975609756098,FC-2,Haywood,37087FC-2
Haywood,1718,1553,0.903958090803,45,0.0261932479627,13,0.00756693830035,7,0.00407450523865,76,0.0442374854482,24,0.0139697322468,47,32,30,45,77,2,0.0011641443539,47,0.0273573923166,109,0.0634458672875,1609,0.936554132712,1519,0.884167636787,HA,Haywood,37087HA
Haywood,1078,1067,0.989795918367,1,0.000927643784787,3,0.00278293135436,0,0.0,7,0.00649350649351,0,0.0,1,3,3,1,4,0,0.0,1,0.000927643784787,15,0.0139146567718,1063,0.986085343228,1057,0.980519480519,ID,Haywood,37087ID
Haywood,3815,3649,0.956487549148,20,0.00524246395806,16,0.00419397116645,34,0.0089121887287,51,0.0133682830931,45,0.0117955439056,35,48,38,25,73,15,0.00393184796855,35,0.00917431192661,101,0.0264744429882,3714,0.973525557012,3609,0.946002621232,IH,Haywood,37087IH
Haywood,4039,3910,0.968061401337,12,0.00297103243377,21,0.0051993067591,12,0.00297103243377,43,0.0106461995543,41,0.0101510274821,16,41,41,16,57,4,0.00099034414459,16,0.00396137657836,150,0.0371379054221,3889,0.962862094578,3814,0.944293141867,JC,Haywood,37087JC
Haywood,2061,2028,0.983988355167,2,0.000970402717128,2,0.000970402717128,11,0.0053372149442,10,0.00485201358564,8,0.00388161086851,3,3,3,3,6,1,0.000485201358564,3,0.00145560407569,41,0.0198932557011,2020,0.980106744299,1997,0.968947113052,LJ,Haywood,37087LJ
Haywood,3788,3670,0.968848996832,10,0.0026399155227,10,0.0026399155227,10,0.0026399155227,49,0.0129355860612,39,0.0102956705385,19,29,29,19,48,9,0.00237592397043,19,0.00501583949314,101,0.0266631467793,3687,0.973336853221,3624,0.956705385428,P,Haywood,37087P
Haywood,1758,1707,0.970989761092,7,0.00398179749716,6,0.00341296928328,1,0.000568828213879,15,0.00853242320819,22,0.0125142207053,17,16,15,16,32,10,0.00568828213879,17,0.00967007963595,38,0.0216154721274,1720,0.978384527873,1687,0.959613196815,PC,Haywood,37087PC
Haywood,2811,2702,0.961223763785,6,0.00213447171825,35,0.0124510850231,17,0.00604766986837,26,0.00924937744575,25,0.00889363215937,8,54,54,8,62,2,0.00071149057275,8,0.002845962291,76,0.0270366417645,2735,0.972963358236,2660,0.946282461757,SA,Haywood,37087SA
Haywood,1143,1032,0.902887139108,31,0.0271216097988,11,0.00962379702537,9,0.00787401574803,35,0.0306211723535,25,0.0218722659668,36,24,20,32,56,5,0.00437445319335,36,0.0314960629921,81,0.0708661417323,1062,0.929133858268,990,0.866141732283,WC,Haywood,37087WC
Haywood,1980,1898,0.958585858586,8,0.0040404040404,8,0.0040404040404,4,0.0020202020202,49,0.0247474747475,13,0.00656565656566,12,11,11,12,23,4,0.0020202020202,12,0.00606060606061,114,0.0575757575758,1866,0.942424242424,1834,0.926262626263,WE,Haywood,37087WE
Haywood,401,391,0.97506234414,2,0.00498753117207,2,0.00498753117207,1,0.00249376558603,0,0.0,5,0.0124688279302,2,5,5,2,7,0,0.0,2,0.00498753117207,3,0.0074812967581,398,0.992518703242,388,0.967581047382,WO,Haywood,37087WO
Haywood,2631,2471,0.939186621057,47,0.0178639300646,22,0.00836183960471,14,0.00532117065754,57,0.0216647662486,20,0.00760167236792,50,33,33,50,83,3,0.00114025085519,50,0.0190041809198,97,0.0368681109844,2534,0.963131889016,2437,0.926263778031,WS-1,Haywood,37087WS-1
Haywood,2438,2248,0.922067268253,94,0.0385561936013,12,0.00492206726825,12,0.00492206726825,40,0.0164068908942,32,0.0131255127153,104,20,20,104,124,10,0.00410172272354,104,0.0426579163249,114,0.0467596390484,2324,0.953240360952,2185,0.896226415094,WS-2,Haywood,37087WS-2
Haywood,2203,2109,0.957330912392,19,0.00862460281434,22,0.00998638220608,4,0.00181570585565,34,0.015433499773,15,0.00680889695869,20,34,34,20,54,1,0.000453926463913,20,0.00907852927826,69,0.03132092601,2134,0.96867907399,2078,0.943259192011,WW,Haywood,37087WW
Henderson,2149,1890,0.879478827362,45,0.02093997208,10,0.0046533271289,15,0.00697999069335,143,0.0665425779432,46,0.0214053047929,59,23,23,59,82,14,0.00651465798046,59,0.0274546300605,291,0.135411819451,1858,0.864588180549,1758,0.81805490926,AR,Henderson,37089AR
Henderson,3453,3380,0.97885896322,18,0.00521285838401,4,0.00115841297423,6,0.00173761946134,17,0.00492325514046,28,0.00810889081958,25,18,18,25,43,7,0.00202722270489,25,0.00724008108891,83,0.0240370692152,3370,0.975962930785,3317,0.960613958876,AT,Henderson,37089AT
Henderson,1124,1052,0.935943060498,13,0.0115658362989,5,0.00444839857651,2,0.0017793594306,31,0.0275800711744,21,0.0186832740214,26,24,12,14,38,13,0.0115658362989,26,0.0231316725979,40,0.0355871886121,1084,0.964412811388,1043,0.92793594306,BC,Henderson,37089BC
Henderson,1287,933,0.724941724942,207,0.160839160839,6,0.004662004662,23,0.017871017871,78,0.0606060606061,40,0.03108003108,231,17,12,226,243,24,0.018648018648,231,0.179487179487,186,0.144522144522,1101,0.855477855478,837,0.65034965035,BK,Henderson,37089BK
Henderson,1576,1495,0.948604060914,16,0.010152284264,3,0.00190355329949,7,0.00444162436548,24,0.0152284263959,31,0.0196700507614,26,19,17,24,43,10,0.00634517766497,26,0.0164974619289,46,0.0291878172589,1530,0.970812182741,1479,0.93845177665,CB,Henderson,37089CB
Henderson,4702,4232,0.900042535091,68,0.0144619310932,27,0.00574223734581,61,0.0129732028924,215,0.0457252233092,99,0.021054870268,91,55,52,88,143,23,0.0048915355168,91,0.01935346661,536,0.113994045087,4166,0.886005954913,3959,0.841982135262,CC,Henderson,37089CC
Henderson,3914,3398,0.86816555953,99,0.0252938170669,26,0.00664282064384,29,0.0074092999489,292,0.0746039856924,70,0.017884517118,128,61,55,122,183,29,0.0074092999489,128,0.0327031170158,556,0.142054164538,3358,0.857945835462,3160,0.807358201329,ED,Henderson,37089ED
Henderson,4097,3333,0.813522089334,183,0.0446668293874,18,0.00439345862826,45,0.0109836465707,398,0.0971442518916,120,0.0292897241884,241,59,44,226,285,58,0.0141567000244,241,0.0588235294118,844,0.206004393459,3253,0.793995606541,2941,0.717842323651,EF,Henderson,37089EF
Henderson,2724,2536,0.930983847283,36,0.0132158590308,9,0.00330396475771,29,0.0106461086637,65,0.0238619676946,49,0.0179882525698,52,31,31,52,83,16,0.00587371512482,52,0.0190895741557,131,0.0480910425844,2593,0.951908957416,2470,0.906754772394,ES,Henderson,37089ES
Henderson,3179,2990,0.940547341931,27,0.00849323686694,2,0.00062912865681,34,0.0106951871658,84,0.026423403586,42,0.013211701793,47,16,16,47,63,20,0.0062912865681,47,0.014784523435,151,0.0474992135892,3028,0.952500786411,2927,0.920729789242,EV,Henderson,37089EV
Henderson,5694,5022,0.881981032666,224,0.039339655778,25,0.00439058658237,176,0.0309097295399,133,0.0233579206182,114,0.0200210748156,275,69,67,273,342,51,0.00895679662803,275,0.048296452406,289,0.0507551808922,5405,0.949244819108,4882,0.857393747805,FL,Henderson,37089FL
Henderson,2924,2879,0.984610123119,10,0.00341997264022,3,0.00102599179207,8,0.00273597811218,2,0.000683994528044,22,0.00752393980848,19,12,11,18,30,9,0.0030779753762,19,0.00649794801642,32,0.0109439124487,2892,0.989056087551,2850,0.974692202462,FR,Henderson,37089FR
Henderson,1937,1585,0.818275684047,83,0.042849767682,8,0.00413009808983,56,0.0289106866288,125,0.0645327826536,80,0.0413009808983,106,22,22,106,128,23,0.0118740320083,106,0.0547237996902,287,0.148167268973,1650,0.851832731027,1456,0.751677852349,GM,Henderson,37089GM
Henderson,3358,3227,0.96098868374,10,0.00297796307326,12,0.00357355568791,10,0.00297796307326,59,0.0175699821322,40,0.011911852293,24,33,33,24,57,14,0.00416914830256,24,0.00714711137582,111,0.0330553901132,3247,0.966944609887,3181,0.947290053603,GR,Henderson,37089GR
Henderson,4216,3892,0.923149905123,117,0.0277514231499,23,0.00545540796964,69,0.0163662239089,42,0.00996204933586,73,0.0173149905123,146,47,44,143,190,29,0.00687855787476,146,0.0346299810247,127,0.0301233396584,4089,0.969876660342,3822,0.906546489564,HC,Henderson,37089HC
Henderson,2797,2644,0.945298534144,27,0.00965319985699,11,0.00393278512692,14,0.00500536288881,51,0.0182338219521,50,0.0178762960315,47,33,32,46,79,20,0.00715051841258,47,0.0168037182696,129,0.0461208437612,2668,0.953879156239,2571,0.919199141938,HS,Henderson,37089HS
Henderson,2896,2532,0.874309392265,141,0.0486878453039,6,0.00207182320442,45,0.0155386740331,118,0.0407458563536,54,0.0186464088398,161,14,11,158,172,20,0.00690607734807,161,0.0555939226519,245,0.0845994475138,2651,0.915400552486,2442,0.843232044199,HV-1,Henderson,37089HV-1
Henderson,4403,3135,0.712014535544,612,0.138996138996,28,0.00635930047695,60,0.0136270724506,462,0.10492845787,106,0.0240744946627,667,44,38,661,705,55,0.0124914830797,667,0.151487622076,879,0.199636611401,3524,0.800363388599,2773,0.629797865092,HV-2,Henderson,37089HV-2
Henderson,3723,3035,0.815202793446,340,0.0913242009132,11,0.00295460650013,49,0.0131614289551,201,0.0539887187752,87,0.0233682514102,390,18,18,390,408,50,0.0134300295461,390,0.104754230459,352,0.0945474080043,3371,0.905452591996,2897,0.778135911899,HV-3,Henderson,37089HV-3
Henderson,2165,2087,0.963972286374,28,0.0129330254042,2,0.000923787528868,20,0.00923787528868,5,0.00230946882217,23,0.010623556582,32,6,6,32,38,4,0.00184757505774,32,0.0147806004619,25,0.0115473441109,2140,0.988452655889,2071,0.956581986143,LJ,Henderson,37089LJ
Henderson,2084,2004,0.961612284069,34,0.0163147792706,3,0.00143953934741,9,0.00431861804223,18,0.00863723608445,16,0.00767754318618,38,10,10,38,48,4,0.00191938579655,38,0.0182341650672,52,0.0249520153551,2032,0.975047984645,1975,0.947696737044,LP,Henderson,37089LP
Henderson,1897,1521,0.801792303637,64,0.0337374802319,16,0.00843437005799,26,0.0137058513442,229,0.120716921455,41,0.0216130732736,77,34,31,74,108,13,0.00685292567211,77,0.0405904059041,495,0.260938323669,1402,0.739061676331,1284,0.676858197153,MG,Henderson,37089MG
Henderson,6463,5298,0.819743153334,103,0.0159368714219,62,0.00959306823457,61,0.00943834132756,783,0.121151168188,156,0.0241373974934,134,129,128,133,262,31,0.00479653411728,134,0.0207334055392,1477,0.228531641652,4986,0.771468358348,4693,0.726133374594,NB,Henderson,37089NB
Henderson,2809,2345,0.834816660733,194,0.0690637237451,12,0.00427198291207,43,0.0153079387682,159,0.0566037735849,56,0.0199359202563,218,24,20,214,238,24,0.00854396582414,218,0.0776076895692,320,0.113919544322,2489,0.886080455678,2204,0.784620861517,NE,Henderson,37089NE
Henderson,3681,3399,0.923390383048,89,0.0241782124423,16,0.00434664493344,30,0.0081499592502,66,0.0179299103504,81,0.0220048899756,109,46,46,109,155,20,0.0054333061668,109,0.0296115186091,168,0.0456397718011,3513,0.954360228199,3331,0.904917142081,NM,Henderson,37089NM
Henderson,2776,2508,0.903458213256,87,0.0313400576369,11,0.00396253602305,47,0.0169308357349,84,0.0302593659942,39,0.0140489913545,103,27,24,100,127,16,0.00576368876081,103,0.0371037463977,212,0.0763688760807,2564,0.923631123919,2393,0.862031700288,NW,Henderson,37089NW
Henderson,3373,3027,0.897420693744,57,0.0168989030537,11,0.00326119181737,67,0.0198636228876,110,0.0326119181737,101,0.0299436703232,92,49,38,81,130,35,0.0103765194189,92,0.0272754224726,241,0.0714497479988,3132,0.928550252001,2914,0.863919359621,PR,Henderson,37089PR
Henderson,2422,2307,0.952518579686,23,0.00949628406276,8,0.00330305532618,25,0.0103220478943,26,0.0107349298101,33,0.0136251032205,34,16,14,32,48,11,0.00454170107349,34,0.0140379851363,125,0.0516102394715,2297,0.948389760528,2224,0.918249380677,PV,Henderson,37089PV
Henderson,3198,2941,0.919637273296,61,0.0190744215134,19,0.00594121325829,49,0.0153220762977,71,0.0222013758599,57,0.0178236397749,76,47,46,75,122,15,0.0046904315197,76,0.0237648530331,244,0.0762976860538,2954,0.923702313946,2781,0.869606003752,RG,Henderson,37089RG
Henderson,1232,1214,0.98538961039,2,0.00162337662338,2,0.00162337662338,0,0.0,7,0.00568181818182,7,0.00568181818182,8,3,3,8,11,6,0.00487012987013,8,0.00649350649351,31,0.0251623376623,1201,0.974837662338,1188,0.964285714286,RR,Henderson,37089RR
Henderson,4092,3615,0.883431085044,28,0.00684261974585,16,0.0039100684262,10,0.00244379276637,328,0.080156402737,95,0.0232160312805,56,53,51,54,107,28,0.00684261974585,56,0.0136852394917,663,0.162023460411,3429,0.837976539589,3325,0.812561094819,SB,Henderson,37089SB
Henderson,2473,1926,0.778811160534,78,0.0315406389001,19,0.00768297614234,20,0.00808734330772,379,0.153255155681,51,0.0206227254347,89,26,26,89,115,11,0.00444803881925,89,0.0359886777194,715,0.289122523251,1758,0.710877476749,1628,0.658309745249,SE,Henderson,37089SE
Henderson,4864,4695,0.965254934211,35,0.00719572368421,12,0.00246710526316,21,0.00431743421053,55,0.0113075657895,46,0.00945723684211,53,20,19,52,72,18,0.00370065789474,53,0.0108963815789,168,0.0345394736842,4696,0.965460526316,4582,0.942023026316,SM,Henderson,37089SM
Henderson,3058,2837,0.927730542838,65,0.0212557226946,3,0.000981033355134,34,0.0111183780249,74,0.02419882276,45,0.014715500327,83,17,12,78,95,18,0.0058862001308,83,0.0271419228254,173,0.0565729234794,2885,0.943427076521,2747,0.898299542184,SW,Henderson,37089SW
Hertford,3202,1252,0.391005621487,1780,0.555902560899,52,0.0162398500937,59,0.0184259837601,15,0.00468457214241,44,0.0137414116177,1812,69,60,1803,1872,32,0.00999375390381,1812,0.565896314803,44,0.0137414116177,3158,0.986258588382,1239,0.386945658963,A1,Hertford,37091A1
Hertford,3308,1469,0.44407496977,1711,0.51723095526,23,0.00695284159613,14,0.00423216444982,46,0.0139056831923,45,0.0136033857316,1734,49,40,1725,1774,23,0.00695284159613,1734,0.524183796856,81,0.0244860943168,3227,0.975513905683,1450,0.438331318017,A2,Hertford,37091A2
Hertford,1912,133,0.0695606694561,1713,0.895920502092,42,0.0219665271967,5,0.00261506276151,6,0.00313807531381,13,0.00679916317992,1726,53,42,1715,1768,13,0.00679916317992,1726,0.902719665272,5,0.00261506276151,1907,0.997384937238,131,0.0685146443515,A3,Hertford,37091A3
Hertford,686,128,0.186588921283,544,0.793002915452,3,0.00437317784257,2,0.00291545189504,2,0.00291545189504,7,0.0102040816327,551,7,3,547,554,7,0.0102040816327,551,0.803206997085,4,0.00583090379009,682,0.99416909621,125,0.18221574344,BR,Hertford,37091BR
Hertford,658,379,0.575987841945,248,0.376899696049,2,0.00303951367781,1,0.00151975683891,7,0.0106382978723,21,0.031914893617,265,10,6,261,271,17,0.0258358662614,265,0.40273556231,17,0.0258358662614,641,0.974164133739,374,0.568389057751,CM,Hertford,37091CM
Hertford,868,173,0.19930875576,614,0.707373271889,28,0.0322580645161,0,0.0,22,0.0253456221198,31,0.0357142857143,634,45,37,626,671,20,0.0230414746544,634,0.730414746544,19,0.0218894009217,849,0.978110599078,171,0.197004608295,CO,Hertford,37091CO
Hertford,1310,579,0.441984732824,708,0.540458015267,2,0.00152671755725,0,0.0,10,0.00763358778626,11,0.00839694656489,714,10,7,711,721,6,0.00458015267176,714,0.545038167939,16,0.012213740458,1294,0.987786259542,573,0.437404580153,HV,Hertford,37091HV
Hertford,4116,1366,0.331875607386,2609,0.633867832847,14,0.00340136054422,29,0.00704567541302,55,0.0133624878523,43,0.0104470359572,2640,21,17,2636,2657,31,0.0075315840622,2640,0.64139941691,111,0.0269679300292,4005,0.973032069971,1332,0.32361516035,M1,Hertford,37091M1
Hertford,1909,623,0.326348873756,1214,0.635935044526,3,0.00157150340492,11,0.00576217915139,36,0.0188580408591,22,0.0115243583028,1232,20,6,1218,1238,18,0.00942902042954,1232,0.645364064955,67,0.0350969093766,1842,0.964903090623,612,0.320586694605,M2,Hertford,37091M2
Hertford,932,705,0.75643776824,200,0.214592274678,0,0.0,7,0.00751072961373,5,0.00536480686695,15,0.0160944206009,209,8,4,205,213,9,0.00965665236052,209,0.224248927039,11,0.0118025751073,921,0.988197424893,699,0.75,ML,Hertford,37091ML
Hertford,1141,451,0.395267309378,669,0.586327782647,6,0.00525854513585,0,0.0,7,0.00613496932515,8,0.00701139351446,674,10,7,671,681,5,0.00438212094654,674,0.590709903593,13,0.011393514461,1128,0.988606485539,446,0.390885188431,SJ,Hertford,37091SJ
Hertford,1508,583,0.386604774536,860,0.570291777188,20,0.0132625994695,1,0.000663129973475,20,0.0132625994695,24,0.0159151193634,877,36,24,865,901,17,0.0112732095491,877,0.581564986737,29,0.0192307692308,1479,0.980769230769,578,0.383289124668,UN,Hertford,37091UN
Hertford,3119,945,0.302981724912,2063,0.661429945495,79,0.0253286309715,7,0.00224430907342,4,0.00128246232767,21,0.00673292722026,2077,98,85,2064,2162,14,0.00448861814684,2077,0.665918563642,227,0.0727797370952,2892,0.927220262905,749,0.240141070856,WN,Hertford,37091WN
Hoke,774,52,0.0671834625323,162,0.209302325581,488,0.630490956072,1,0.00129198966408,50,0.0645994832041,21,0.0271317829457,170,504,498,164,668,8,0.0103359173127,170,0.219638242894,68,0.0878552971576,706,0.912144702842,49,0.0633074935401,01,Hoke,3709301
Hoke,3895,694,0.178177150193,867,0.222593068036,1911,0.490629011553,27,0.00693196405648,237,0.0608472400513,159,0.0408215661104,939,2043,1988,884,2927,72,0.018485237484,939,0.24107830552,408,0.104749679076,3487,0.895250320924,599,0.15378690629,02,Hoke,3709302
Hoke,1620,377,0.232716049383,587,0.362345679012,458,0.282716049383,14,0.00864197530864,149,0.091975308642,35,0.0216049382716,606,483,471,594,1077,19,0.0117283950617,606,0.374074074074,211,0.13024691358,1409,0.86975308642,328,0.202469135802,03,Hoke,3709303
Hoke,1431,766,0.535290006988,472,0.329839273235,115,0.0803633822502,9,0.0062893081761,44,0.0307477288609,25,0.0174703004892,482,123,123,482,605,10,0.00698812019567,482,0.336827393431,79,0.0552061495458,1352,0.944793850454,743,0.519217330538,04,Hoke,3709304
Hoke,2604,1335,0.51267281106,875,0.336021505376,192,0.073732718894,13,0.00499231950845,70,0.0268817204301,119,0.0456989247312,935,267,248,916,1183,60,0.0230414746544,935,0.359062980031,193,0.0741167434716,2411,0.925883256528,1249,0.479646697389,05,Hoke,3709305
Hoke,15695,8378,0.533800573431,4965,0.316342784326,284,0.0180949346926,338,0.0215355208665,825,0.0525645109908,905,0.0576616756929,5432,537,417,5312,5849,467,0.0297546989487,5432,0.346097483275,2255,0.143676330041,13440,0.856323669959,7362,0.469066581714,06,Hoke,3709306
Hoke,5740,3813,0.664285714286,1213,0.211324041812,172,0.0299651567944,82,0.0142857142857,194,0.0337979094077,266,0.0463414634146,1350,268,230,1312,1580,137,0.0238675958188,1350,0.235191637631,613,0.106794425087,5127,0.893205574913,3485,0.607142857143,12,Hoke,3709312
Hoke,1978,1109,0.560667340748,432,0.218402426694,343,0.173407482305,11,0.00556117290192,37,0.0187057633974,46,0.0232558139535,456,378,362,440,818,24,0.0121334681496,456,0.230535894843,91,0.0460060667341,1887,0.953993933266,1078,0.544994944388,13,Hoke,3709313
Hoke,2289,831,0.363040629096,1036,0.452599388379,116,0.0506771515946,17,0.00742682394059,225,0.0982961992136,64,0.0279598077763,1067,151,135,1051,1202,31,0.0135430318917,1067,0.466142420271,306,0.133682830931,1983,0.866317169069,789,0.344692005242,61,Hoke,3709361
Hoke,1498,676,0.45126835781,616,0.411214953271,72,0.0480640854473,18,0.0120160213618,47,0.0313751668892,69,0.0460614152203,657,88,73,642,730,41,0.0273698264352,657,0.438584779706,92,0.0614152202937,1406,0.938584779706,653,0.435914552737,62,Hoke,3709362
Hoke,5791,2021,0.348989811777,2466,0.425833189432,183,0.0316007597997,56,0.0096701778622,784,0.135382490071,281,0.0485235710585,2632,276,215,2571,2847,166,0.0286651700915,2632,0.454498359523,1345,0.23225695044,4446,0.76774304956,1637,0.282680020722,63,Hoke,3709363
Hoke,2711,1182,0.43600147547,1192,0.439690151236,169,0.0623386204353,14,0.00516414607156,65,0.0239763924751,89,0.0328292143121,1247,212,189,1224,1436,55,0.0202877167097,1247,0.459977867945,144,0.0531169310218,2567,0.946883068978,1133,0.41792696422,64,Hoke,3709364
Hoke,926,38,0.0410367170626,833,0.899568034557,9,0.0097192224622,1,0.00107991360691,16,0.0172786177106,29,0.0313174946004,859,20,10,849,869,26,0.0280777537797,859,0.927645788337,18,0.0194384449244,908,0.980561555076,37,0.0399568034557,65,Hoke,3709365
Hyde,593,486,0.819561551433,29,0.0489038785835,6,0.0101180438449,5,0.00843170320405,57,0.0961214165261,10,0.0168634064081,35,8,8,35,43,6,0.0101180438449,35,0.0590219224283,70,0.118043844857,523,0.881956155143,472,0.795952782462,BM,Hyde,37095BM
Hyde,1021,604,0.591576885406,379,0.371204701273,1,0.000979431929481,1,0.000979431929481,18,0.0176297747307,18,0.0176297747307,392,1,1,392,393,13,0.0127326150833,392,0.383937316357,64,0.0626836434868,957,0.937316356513,560,0.548481880509,ENG,Hyde,37095ENG
Hyde,1211,490,0.404624277457,665,0.549132947977,14,0.0115606936416,7,0.00578034682081,32,0.0264244426094,3,0.00247729149463,666,17,16,665,682,1,0.000825763831544,666,0.549958711808,17,0.0140379851363,1194,0.985962014864,487,0.402146985962,FF,Hyde,37095FF
Hyde,716,359,0.501396648045,344,0.480446927374,3,0.00418994413408,2,0.00279329608939,0,0.0,8,0.0111731843575,346,6,6,346,352,2,0.00279329608939,346,0.483240223464,33,0.0460893854749,683,0.953910614525,330,0.460893854749,LL,Hyde,37095LL
Hyde,948,906,0.955696202532,15,0.0158227848101,4,0.0042194092827,2,0.00210970464135,15,0.0158227848101,6,0.00632911392405,15,10,10,15,25,0,0.0,15,0.0158227848101,181,0.190928270042,767,0.809071729958,740,0.7805907173,OCK,Hyde,37095OCK
Hyde,536,334,0.623134328358,189,0.352611940299,0,0.0,0,0.0,5,0.00932835820896,8,0.0149253731343,195,2,1,194,196,6,0.0111940298507,195,0.363805970149,4,0.00746268656716,532,0.992537313433,332,0.619402985075,SLAD,Hyde,37095SLAD
Hyde,785,539,0.686624203822,215,0.273885350318,0,0.0,0,0.0,15,0.0191082802548,16,0.0203821656051,224,6,6,224,230,9,0.0114649681529,224,0.285350318471,42,0.0535031847134,743,0.946496815287,515,0.656050955414,SQ,Hyde,37095SQ
Iredell,6341,5506,0.86831730011,577,0.0909951111812,15,0.00236555748305,44,0.00693896861694,103,0.0162434947169,96,0.0151395678915,611,54,46,603,657,34,0.00536193029491,611,0.0963570414761,251,0.039583661883,6090,0.960416338117,5385,0.849235136414,BA,Iredell,37097BA
Iredell,6995,5935,0.848463187991,509,0.0727662616154,28,0.00400285918513,104,0.0148677626876,293,0.0418870621873,126,0.0180128663331,566,49,48,565,614,57,0.00814867762688,566,0.0809149392423,599,0.0856325947105,6396,0.914367405289,5683,0.812437455325,BE,Iredell,37097BE
Iredell,8178,6956,0.850574712644,710,0.0868182929812,43,0.00525800929323,79,0.00966006358523,183,0.0223771093177,207,0.025311812179,821,92,80,809,901,111,0.0135730007337,821,0.100391293715,540,0.06603081438,7638,0.93396918562,6650,0.813157251162,CC1,Iredell,37097CC1
Iredell,8660,6387,0.73752886836,1530,0.176674364896,44,0.00508083140878,156,0.0180138568129,315,0.0363741339492,228,0.0263279445727,1675,95,77,1657,1752,145,0.0167436489607,1675,0.193418013857,700,0.080831408776,7960,0.919168591224,6075,0.701501154734,CC2,Iredell,37097CC2
Iredell,10611,8759,0.825464140986,1116,0.105173876166,62,0.00584299312035,138,0.013005371784,281,0.0264819526906,255,0.024031665253,1214,150,131,1195,1345,98,0.00923569880313,1214,0.114409574969,644,0.060691734992,9967,0.939308265008,8468,0.79803977005,CC3,Iredell,37097CC3
Iredell,8756,7551,0.862380082229,419,0.047852900868,28,0.00319780721791,463,0.0528780264961,125,0.0142759250799,170,0.0194152581087,483,73,65,475,548,64,0.00730927364093,483,0.0551621745089,422,0.0481955230699,8334,0.95180447693,7289,0.832457743262,CC4,Iredell,37097CC4
Iredell,6999,5885,0.840834404915,586,0.0837262466067,12,0.00171453064724,150,0.0214316330904,256,0.0365766538077,110,0.015716530933,639,40,35,634,674,53,0.00757251035862,639,0.0912987569653,515,0.0735819402772,6484,0.926418059723,5674,0.810687241034,CD,Iredell,37097CD
Iredell,3527,2582,0.73206691239,649,0.184009072866,21,0.00595406861355,78,0.0221151119932,146,0.041394953218,51,0.0144598809186,668,45,41,664,709,19,0.00538701445988,668,0.189396087326,288,0.0816557981287,3239,0.918344201871,2481,0.70343067763,CH-A,Iredell,37097CH-A
Iredell,4785,3736,0.780773249739,463,0.0967607105538,17,0.00355276907001,66,0.0137931034483,398,0.0831765935214,105,0.0219435736677,528,47,38,519,566,65,0.0135841170324,528,0.110344827586,617,0.1289446186,4168,0.8710553814,3550,0.741901776385,CH-B,Iredell,37097CH-B
Iredell,3912,3174,0.811349693252,466,0.119120654397,6,0.00153374233129,77,0.0196830265849,149,0.0380879345603,40,0.0102249488753,485,18,15,482,500,19,0.00485685071575,485,0.123977505112,263,0.0672290388548,3649,0.932770961145,3069,0.784509202454,CS,Iredell,37097CS
Iredell,8242,7518,0.912157243388,247,0.0299684542587,21,0.00254792526086,264,0.0320310604222,104,0.01261829653,88,0.0106770201407,279,41,37,275,316,32,0.00388255277845,279,0.0338510070371,307,0.0372482407183,7935,0.962751759282,7340,0.890560543557,DV1-A,Iredell,37097DV1-A
Iredell,10438,9796,0.938493964361,182,0.0174362904771,27,0.00258670243342,163,0.0156160183943,100,0.00958037938302,170,0.0162866449511,219,70,69,218,288,37,0.00354474037172,219,0.0209810308488,346,0.0331481126653,10092,0.966851887335,9579,0.9177045411,DV1-B,Iredell,37097DV1-B
Iredell,5172,4866,0.940835266821,72,0.0139211136891,22,0.00425367362722,128,0.0247486465584,36,0.00696055684455,48,0.0092807424594,94,39,33,88,127,22,0.00425367362722,94,0.0181747873163,178,0.0344160866203,4994,0.96558391338,4728,0.914153132251,DV2-A,Iredell,37097DV2-A
Iredell,5328,4668,0.876126126126,170,0.0319069069069,18,0.00337837837838,311,0.0583708708709,72,0.0135135135135,89,0.0167042042042,199,49,41,191,240,29,0.00544294294294,199,0.0373498498498,242,0.0454204204204,5086,0.95457957958,4524,0.849099099099,DV2-B,Iredell,37097DV2-B
Iredell,1817,1540,0.84755090809,130,0.0715465052284,1,0.000550357732526,3,0.00165107319758,120,0.0660429279031,23,0.0126582278481,135,10,10,135,145,5,0.00275178866263,135,0.074298293891,156,0.0858558062741,1661,0.914144193726,1507,0.829389102917,EM,Iredell,37097EM
Iredell,8928,7754,0.868503584229,858,0.0961021505376,12,0.00134408602151,67,0.00750448028674,105,0.0117607526882,132,0.0147849462366,930,47,35,918,965,72,0.00806451612903,930,0.104166666667,305,0.0341621863799,8623,0.96583781362,7585,0.84957437276,FT,Iredell,37097FT
Iredell,1662,1599,0.962093862816,5,0.00300842358604,3,0.00180505415162,1,0.000601684717208,39,0.0234657039711,15,0.00902527075812,12,9,9,12,21,7,0.00421179302046,12,0.0072202166065,60,0.0361010830325,1602,0.963898916968,1586,0.954271961492,NH,Iredell,37097NH
Iredell,1840,1687,0.916847826087,43,0.0233695652174,9,0.00489130434783,3,0.00163043478261,84,0.045652173913,14,0.00760869565217,50,12,12,50,62,7,0.00380434782609,50,0.0271739130435,106,0.0576086956522,1734,0.942391304348,1667,0.90597826087,OL,Iredell,37097OL
Iredell,2622,2448,0.933638443936,102,0.0389016018307,5,0.00190694126621,3,0.00114416475973,36,0.0137299771167,28,0.0106788710908,113,19,18,112,131,11,0.00419527078566,113,0.0430968726163,69,0.0263157894737,2553,0.973684210526,2418,0.922196796339,SB,Iredell,37097SB
Iredell,4295,3800,0.884749708964,226,0.0526193247963,10,0.0023282887078,116,0.0270081490105,71,0.0165308498254,72,0.0167636786962,255,25,25,255,280,29,0.00675203725262,255,0.0593713620489,167,0.0388824214203,4128,0.96111757858,3729,0.868218859139,SH-A,Iredell,37097SH-A
Iredell,4410,3960,0.897959183673,280,0.0634920634921,17,0.00385487528345,33,0.00748299319728,59,0.0133786848073,61,0.0138321995465,308,31,31,308,339,28,0.00634920634921,308,0.0698412698413,107,0.0242630385488,4303,0.975736961451,3925,0.890022675737,SH-B,Iredell,37097SH-B
Iredell,5640,3876,0.687234042553,1007,0.178546099291,23,0.0040780141844,258,0.0457446808511,343,0.0608156028369,133,0.0235815602837,1080,54,31,1057,1111,73,0.0129432624113,1080,0.191489361702,756,0.134042553191,4884,0.865957446809,3532,0.626241134752,ST1,Iredell,37097ST1
Iredell,4332,2820,0.650969529086,1040,0.240073868883,12,0.00277008310249,67,0.0154662973223,299,0.0690212373038,94,0.0216989843029,1092,38,24,1078,1116,52,0.0120036934441,1092,0.252077562327,517,0.119344413666,3815,0.880655586334,2660,0.614035087719,ST2,Iredell,37097ST2
Iredell,5090,2294,0.45068762279,2293,0.450491159136,13,0.00255402750491,35,0.00687622789784,324,0.0636542239686,131,0.0257367387033,2369,52,26,2343,2395,76,0.014931237721,2369,0.465422396857,546,0.107269155206,4544,0.892730844794,2145,0.42141453831,ST3,Iredell,37097ST3
Iredell,4369,3097,0.708857862211,936,0.21423666743,10,0.0022888532845,39,0.00892652780957,212,0.0485236896315,75,0.0171663996338,979,33,17,963,996,43,0.00984206912337,979,0.224078736553,353,0.080796520943,4016,0.919203479057,2990,0.684367132067,ST4,Iredell,37097ST4
Iredell,4699,2982,0.634603107044,1336,0.284315811875,13,0.00276654607363,51,0.0108533730581,183,0.0389444562673,134,0.0285167056821,1433,41,27,1419,1460,97,0.020642689934,1433,0.304958501809,388,0.0825707597361,4311,0.917429240264,2811,0.598212385614,ST5,Iredell,37097ST5
Iredell,5644,2472,0.43798724309,2571,0.45552799433,24,0.00425230333097,62,0.0109851169383,402,0.0712260807938,113,0.0200212615167,2649,57,40,2632,2689,78,0.0138199858257,2649,0.469347980156,711,0.12597448618,4933,0.87402551382,2207,0.391034727144,ST6,Iredell,37097ST6
Iredell,3975,3086,0.776352201258,473,0.118993710692,12,0.00301886792453,5,0.00125786163522,336,0.0845283018868,63,0.0158490566038,499,35,33,497,532,26,0.00654088050314,499,0.125534591195,429,0.107924528302,3546,0.892075471698,3006,0.756226415094,TB,Iredell,37097TB
Iredell,2170,1912,0.881105990783,51,0.0235023041475,19,0.00875576036866,1,0.000460829493088,174,0.0801843317972,13,0.00599078341014,55,24,24,55,79,4,0.00184331797235,55,0.0253456221198,262,0.120737327189,1908,0.879262672811,1844,0.849769585253,UG,Iredell,37097UG
Jackson,2094,1969,0.940305635148,13,0.0062082139446,49,0.023400191022,6,0.00286532951289,28,0.0133715377268,29,0.0138490926457,16,72,72,16,88,3,0.00143266475645,16,0.00764087870105,50,0.0238777459408,2044,0.976122254059,1950,0.931232091691,ALLSC,Jackson,37099ALLSC
Jackson,1839,1735,0.943447525829,8,0.00435019032083,65,0.0353452963567,5,0.00271886895052,4,0.00217509516041,22,0.0119630233823,10,83,83,10,93,2,0.00108754758021,10,0.00543773790103,33,0.0179445350734,1806,0.982055464927,1708,0.928765633496,BCK,Jackson,37099BCK
Jackson,640,621,0.9703125,1,0.0015625,8,0.0125,2,0.003125,0,0.0,8,0.0125,3,11,11,3,14,2,0.003125,3,0.0046875,14,0.021875,626,0.978125,611,0.9546875,CAN,Jackson,37099CAN
Jackson,1974,1822,0.922998986829,11,0.00557244174265,11,0.00557244174265,16,0.0081053698075,101,0.0511651469098,13,0.00658561296859,13,17,17,13,30,2,0.00101317122594,13,0.00658561296859,174,0.0881458966565,1800,0.911854103343,1755,0.88905775076,CAS,Jackson,37099CAS
Jackson,738,706,0.956639566396,1,0.00135501355014,19,0.0257452574526,5,0.00677506775068,5,0.00677506775068,2,0.00271002710027,2,20,20,2,22,1,0.00135501355014,2,0.00271002710027,10,0.0135501355014,728,0.986449864499,702,0.951219512195,CFK,Jackson,37099CFK
Jackson,9428,8249,0.874946966483,523,0.0554730589733,73,0.0077428935087,110,0.0116673737802,325,0.0344717861689,148,0.0156979210861,590,133,117,574,707,67,0.0071064913025,590,0.0625795502758,476,0.0504879083581,8952,0.949512091642,8131,0.862431056428,CUL,Jackson,37099CUL
Jackson,1429,1366,0.955913226032,10,0.00699790062981,17,0.0118964310707,12,0.00839748075577,5,0.00349895031491,19,0.0132960111966,16,28,27,15,43,6,0.00419874037789,16,0.0111966410077,22,0.0153953813856,1407,0.984604618614,1349,0.944016794962,GCK,Jackson,37099GCK
Jackson,2230,2119,0.950224215247,1,0.000448430493274,11,0.00493273542601,7,0.00313901345291,75,0.0336322869955,17,0.00762331838565,3,22,22,3,25,2,0.000896860986547,3,0.00134529147982,211,0.0946188340807,2019,0.905381165919,1984,0.889686098655,HAMMNT,Jackson,37099HAMMNT
Jackson,6161,2388,0.387599415679,32,0.00519396201915,3293,0.534491154033,55,0.00892712222042,89,0.0144457068658,304,0.049342639182,71,3563,3543,51,3614,39,0.00633014121084,71,0.01152410323,318,0.0516149975653,5843,0.948385002435,2311,0.375101444571,QUA,Jackson,37099QUA
Jackson,1359,1100,0.809418690213,13,0.00956585724798,36,0.0264900662252,9,0.00662251655629,188,0.138337012509,13,0.00956585724798,13,43,43,13,56,0,0.0,13,0.00956585724798,252,0.185430463576,1107,0.814569536424,1050,0.772626931567,RIV,Jackson,37099RIV
Jackson,1495,1440,0.963210702341,1,0.00066889632107,35,0.0234113712375,4,0.00267558528428,0,0.0,15,0.0100334448161,2,42,42,2,44,1,0.00066889632107,2,0.00133779264214,10,0.0066889632107,1485,0.993311036789,1434,0.959197324415,SAV,Jackson,37099SAV
Jackson,8198,7431,0.906440595267,103,0.0125640400098,154,0.0187850695292,112,0.0136618687485,247,0.0301292998292,151,0.0184191266162,134,250,238,122,372,31,0.00378141010002,134,0.0163454501098,424,0.0517199316907,7774,0.948280068309,7286,0.888753354477,SYLDIL,Jackson,37099SYLDIL
Jackson,2686,2543,0.946760982874,28,0.0104244229337,33,0.012285927029,21,0.0078183172003,20,0.00744601638124,41,0.0152643335815,33,56,54,31,87,5,0.00186150409531,33,0.012285927029,44,0.0163812360387,2642,0.983618763961,2524,0.939687267312,WEB,Jackson,37099WEB
Johnston,2292,1657,0.72294938918,299,0.130453752182,9,0.00392670157068,14,0.00610820244328,248,0.108202443281,65,0.0283595113438,323,47,39,315,362,24,0.0104712041885,323,0.14092495637,342,0.149214659686,1950,0.850785340314,1594,0.695462478185,PR01,Johnston,37101PR01
Johnston,1653,1020,0.617059891107,498,0.301270417423,7,0.00423472474289,1,0.000604960677556,100,0.0604960677556,27,0.016333938294,507,17,13,503,520,9,0.005444646098,507,0.306715063521,169,0.102238354507,1484,0.897761645493,969,0.586206896552,PR02,Johnston,37101PR02
Johnston,2888,2333,0.807825484765,278,0.0962603878116,16,0.00554016620499,7,0.00242382271468,208,0.0720221606648,46,0.0159279778393,298,26,22,294,320,20,0.00692520775623,298,0.103185595568,303,0.104916897507,2585,0.895083102493,2261,0.782894736842,PR03,Johnston,37101PR03
Johnston,1929,1266,0.656298600311,373,0.193364437532,28,0.0145152928979,1,0.000518403317781,222,0.115085536547,39,0.0202177293935,390,41,41,390,431,17,0.00881285640228,390,0.202177293935,288,0.149300155521,1641,0.850699844479,1234,0.639709694142,PR04,Johnston,37101PR04
Johnston,1763,1325,0.75155984118,298,0.169030062394,14,0.00794100964265,2,0.00113442994895,115,0.0652297220647,9,0.00510493477028,302,18,18,302,320,4,0.0022688598979,302,0.171298922292,167,0.0947249007374,1596,0.905275099263,1277,0.724333522405,PR05,Johnston,37101PR05
Johnston,2548,2112,0.828885400314,309,0.121271585557,11,0.00431711145997,7,0.00274725274725,82,0.0321821036107,27,0.0105965463108,316,23,21,314,337,7,0.00274725274725,316,0.124018838305,198,0.0777080062794,2350,0.922291993721,2009,0.788461538462,PR06,Johnston,37101PR06
Johnston,4216,3370,0.799335863378,508,0.120493358634,14,0.00332068311195,19,0.00450664136622,243,0.0576375711575,62,0.0147058823529,532,25,24,531,556,24,0.00569259962049,532,0.126185958254,365,0.0865749525617,3851,0.913425047438,3269,0.775379506641,PR07,Johnston,37101PR07
Johnston,3067,2733,0.891098793609,141,0.0459732637757,11,0.00358656667754,10,0.0032605151614,116,0.0378219758722,56,0.0182588849038,162,29,27,160,189,21,0.00684708183893,162,0.0528203456146,208,0.067818715357,2859,0.932181284643,2660,0.867297032931,PR08,Johnston,37101PR08
Johnston,6109,4919,0.805205434605,702,0.114912424292,24,0.00392862989033,81,0.0132591258798,278,0.0455066295629,105,0.0171877557702,749,49,33,733,782,47,0.00769356686855,749,0.122605991161,593,0.0970698968735,5516,0.902930103127,4664,0.76346374202,PR09,Johnston,37101PR09
Johnston,6312,4358,0.690430925222,1292,0.204689480355,14,0.00221799746515,45,0.00712927756654,462,0.0731939163498,141,0.0223384030418,1369,45,31,1355,1400,77,0.0121989860583,1369,0.216888466413,757,0.119930291508,5555,0.880069708492,4132,0.654626108999,PR10,Johnston,37101PR10
Johnston,3990,2786,0.698245614035,929,0.232832080201,12,0.00300751879699,24,0.00601503759398,157,0.0393483709273,82,0.0205513784461,970,42,29,957,999,41,0.0102756892231,970,0.243107769424,351,0.087969924812,3639,0.912030075188,2623,0.657393483709,PR11A,Johnston,37101PR11A
Johnston,5600,4376,0.781428571429,885,0.158035714286,15,0.00267857142857,82,0.0146428571429,149,0.0266071428571,93,0.0166071428571,935,45,28,918,963,50,0.00892857142857,935,0.166964285714,373,0.0666071428571,5227,0.933392857143,4173,0.745178571429,PR11B,Johnston,37101PR11B
Johnston,9508,7783,0.818573832562,1229,0.129259570888,64,0.00673117374842,100,0.0105174589819,132,0.0138830458561,200,0.0210349179638,1322,124,104,1302,1426,93,0.00978123685318,1322,0.139040807741,387,0.04070256626,9121,0.95929743374,7558,0.794909549853,PR12,Johnston,37101PR12
Johnston,3623,3026,0.83521943141,359,0.0990891526359,21,0.00579630140767,31,0.00855644493514,126,0.034777808446,60,0.0165608611648,389,49,39,379,428,30,0.00828043058239,389,0.107369583218,279,0.0770080044162,3344,0.922991995584,2898,0.799889594259,PR13,Johnston,37101PR13
Johnston,3061,2705,0.883698137863,86,0.0280953936622,19,0.0062071218556,12,0.00392028748775,194,0.0633779810519,45,0.0147010780791,91,30,28,89,119,5,0.0016334531199,91,0.0297288467821,334,0.109114668409,2727,0.890885331591,2600,0.849395622346,PR14,Johnston,37101PR14
Johnston,3907,2972,0.760685948298,273,0.0698745840799,30,0.00767852572306,14,0.0035833120041,552,0.141284873304,66,0.0168927565907,289,50,47,286,336,16,0.00409521371897,289,0.0739697977988,846,0.21653442539,3061,0.78346557461,2735,0.700025595086,PR15,Johnston,37101PR15
Johnston,3109,2169,0.697651978128,442,0.142167899646,25,0.00804117079447,5,0.00160823415889,378,0.121582502412,90,0.0289482148601,473,56,53,470,526,31,0.00997105178514,473,0.152138951431,558,0.179478932133,2551,0.820521067867,2049,0.659054358315,PR16,Johnston,37101PR16
Johnston,1310,1092,0.83358778626,54,0.0412213740458,5,0.00381679389313,2,0.00152671755725,156,0.119083969466,1,0.000763358778626,54,5,5,54,59,0,0.0,54,0.0412213740458,172,0.131297709924,1138,0.868702290076,1076,0.821374045802,PR17,Johnston,37101PR17
Johnston,2056,1692,0.822957198444,156,0.0758754863813,12,0.00583657587549,1,0.000486381322957,159,0.0773346303502,36,0.0175097276265,168,20,18,166,186,12,0.00583657587549,168,0.0817120622568,261,0.126945525292,1795,0.873054474708,1611,0.783560311284,PR18,Johnston,37101PR18
Johnston,2812,2159,0.767780938834,326,0.115931721195,12,0.00426742532006,3,0.00106685633001,282,0.100284495021,30,0.0106685633001,347,16,14,345,361,21,0.0074679943101,347,0.123399715505,355,0.126244665718,2457,0.873755334282,2099,0.746443812233,PR19,Johnston,37101PR19
Johnston,4793,3039,0.634049655748,1116,0.232839557688,28,0.00584185270186,7,0.00146046317546,501,0.104527435844,102,0.0212810348425,1176,58,39,1157,1215,60,0.0125182557897,1176,0.245357813478,827,0.172543292301,3966,0.827456707699,2778,0.579595243063,PR20,Johnston,37101PR20
Johnston,4075,3220,0.79018404908,325,0.079754601227,23,0.00564417177914,5,0.00122699386503,406,0.0996319018405,96,0.0235582822086,359,50,50,359,409,34,0.00834355828221,359,0.0880981595092,576,0.141349693252,3499,0.858650306748,3083,0.756564417178,PR21,Johnston,37101PR21
Johnston,4852,3555,0.732687551525,655,0.134995877988,24,0.00494641384996,9,0.00185490519373,537,0.110676009893,72,0.0148392415499,691,31,30,690,721,36,0.00741962077494,691,0.142415498763,775,0.159727947238,4077,0.840272052762,3363,0.693116240725,PR22,Johnston,37101PR22
Johnston,9510,7703,0.809989484753,879,0.092429022082,72,0.00757097791798,49,0.00515247108307,631,0.0663512092534,176,0.0185068349106,953,123,115,945,1068,74,0.00778128286015,953,0.100210304942,1179,0.123974763407,8331,0.876025236593,7220,0.75920084122,PR23,Johnston,37101PR23
Johnston,4226,1979,0.468291528632,1395,0.330099384761,27,0.00638902035021,14,0.00331282536678,701,0.165877898722,110,0.0260293421675,1440,48,36,1428,1476,45,0.0106483672504,1440,0.340747752011,1240,0.293421675343,2986,0.706578324657,1524,0.360624704212,PR24,Johnston,37101PR24
Johnston,4528,2192,0.484098939929,1234,0.272526501767,15,0.00331272084806,11,0.00242932862191,943,0.208259717314,133,0.0293727915194,1293,47,28,1274,1321,59,0.0130300353357,1293,0.285556537102,1486,0.328180212014,3042,0.671819787986,1742,0.384717314488,PR25,Johnston,37101PR25
Johnston,4445,1861,0.418672665917,1665,0.374578177728,11,0.00247469066367,17,0.00382452193476,793,0.178402699663,98,0.0220472440945,1706,31,17,1692,1723,41,0.00922384701912,1706,0.383802024747,1125,0.25309336333,3320,0.74690663667,1625,0.365579302587,PR26,Johnston,37101PR26
Johnston,7226,4871,0.674093551066,1478,0.20453916413,44,0.00608912261279,97,0.0134237475782,594,0.0822031552726,142,0.0196512593413,1560,81,63,1542,1623,82,0.0113479103238,1560,0.215887074453,974,0.134791032383,6252,0.865208967617,4549,0.629532244672,PR27,Johnston,37101PR27
Johnston,5844,4187,0.716461327858,879,0.150410677618,29,0.00496235455168,28,0.00479123887748,625,0.106947296372,96,0.0164271047228,921,50,48,919,969,42,0.00718685831622,921,0.157597535934,1172,0.200547570157,4672,0.799452429843,3721,0.636721423682,PR28,Johnston,37101PR28
Johnston,6599,5674,0.859827246553,441,0.0668283073193,27,0.00409152901955,54,0.0081830580391,267,0.04046067586,136,0.0206091832096,481,68,61,474,542,40,0.00606152447341,481,0.0728898317927,471,0.0713744506743,6128,0.928625549326,5497,0.833005000758,PR29A,Johnston,37101PR29A
Johnston,7666,6543,0.853509000783,744,0.097051917558,32,0.004174276024,59,0.00769632141925,167,0.0217845030003,121,0.0157839812158,792,56,46,782,838,48,0.006261414036,792,0.103313331594,465,0.0606574484738,7201,0.939342551526,6292,0.820767023219,PR29B,Johnston,37101PR29B
Johnston,5555,3447,0.620522052205,1438,0.258865886589,47,0.00846084608461,32,0.00576057605761,463,0.0833483348335,128,0.0230423042304,1501,76,68,1493,1569,63,0.0113411341134,1501,0.270207020702,889,0.1600360036,4666,0.8399639964,3103,0.558595859586,PR30,Johnston,37101PR30
Johnston,3611,2818,0.780393242869,452,0.125173082249,18,0.00498476876212,30,0.00830794793686,214,0.0592633619496,79,0.0218775962337,482,31,30,481,512,30,0.00830794793686,482,0.133481030186,361,0.0999723068402,3250,0.90002769316,2705,0.749099972307,PR31A,Johnston,37101PR31A
Johnston,6509,5297,0.813796282071,657,0.100937163927,38,0.00583807036411,56,0.00860347211553,287,0.0440927945921,174,0.0267322169304,742,93,73,722,815,85,0.0130588416039,742,0.113996005531,599,0.0920264249501,5910,0.90797357505,5035,0.773544323245,PR31B,Johnston,37101PR31B
Johnston,3818,3094,0.810371922472,375,0.0982189628078,17,0.00445259298062,17,0.00445259298062,232,0.0607647983237,83,0.0217391304348,412,39,28,401,440,37,0.0096909376637,412,0.107909900471,488,0.127815610267,3330,0.872184389733,2884,0.7553693033,PR32,Johnston,37101PR32
Johnston,5167,4338,0.839558738146,325,0.0628991677956,65,0.0125798335591,36,0.00696729243275,296,0.0572866266692,107,0.0207083413973,352,121,119,350,471,27,0.00522546932456,352,0.0681246371202,639,0.123669440681,4528,0.876330559319,4068,0.7873040449,PR33,Johnston,37101PR33
Johnston,8701,5678,0.652568670268,2051,0.23572003218,59,0.00678082978968,90,0.0103436386622,637,0.0732099758648,186,0.0213768532353,2158,116,85,2127,2243,107,0.0122974370762,2158,0.248017469256,1242,0.142742213539,7459,0.857257786461,5189,0.596368233536,PR34,Johnston,37101PR34
Jones,1074,659,0.613594040968,362,0.337057728119,2,0.00186219739292,2,0.00186219739292,31,0.0288640595903,18,0.0167597765363,369,10,10,369,379,7,0.00651769087523,369,0.343575418994,53,0.0493482309125,1021,0.950651769088,641,0.596834264432,P01,Jones,37103P01
Jones,641,517,0.80655226209,80,0.1248049922,9,0.0140405616225,0,0.0,28,0.0436817472699,7,0.0109204368175,83,9,9,83,92,3,0.00468018720749,83,0.129485179407,42,0.0655226209048,599,0.934477379095,508,0.792511700468,P02,Jones,37103P02
Jones,907,813,0.896361631753,82,0.090407938258,4,0.00441014332966,0,0.0,7,0.0077177508269,1,0.00110253583241,82,4,4,82,86,0,0.0,82,0.090407938258,27,0.0297684674752,880,0.970231532525,794,0.875413450937,P03,Jones,37103P03
Jones,2612,1675,0.641271056662,855,0.327335375191,10,0.00382848392037,12,0.00459418070444,19,0.0072741194487,41,0.0156967840735,887,28,18,877,905,32,0.0122511485452,887,0.339586523737,50,0.0191424196018,2562,0.980857580398,1643,0.629019908116,P04,Jones,37103P04
Jones,1981,937,0.472993437658,940,0.474507824331,16,0.00807672892479,3,0.0015143866734,39,0.0196870267542,46,0.0232205956588,971,28,21,964,992,31,0.0156486622918,971,0.490156486623,87,0.0439172135285,1894,0.956082786471,891,0.449772841999,P05,Jones,37103P05
Jones,900,692,0.768888888889,133,0.147777777778,3,0.00333333333333,4,0.00444444444444,52,0.0577777777778,16,0.0177777777778,141,8,8,141,149,8,0.00888888888889,141,0.156666666667,68,0.0755555555556,832,0.924444444444,680,0.755555555556,P06,Jones,37103P06
Jones,2038,1102,0.540726202159,837,0.410696761531,13,0.00637880274779,13,0.00637880274779,14,0.00686947988224,59,0.0289499509323,871,40,28,859,899,34,0.0166830225711,871,0.427379784102,71,0.0348380765456,1967,0.965161923454,1060,0.520117762512,P07,Jones,37103P07
Lee,18516,8908,0.48109742925,6007,0.324422121409,162,0.00874918988983,161,0.00869518254483,2719,0.146845971052,559,0.0301901058544,6258,286,236,6208,6494,251,0.0135558435947,6258,0.337977965003,5362,0.289587383884,13154,0.710412616116,6698,0.361741196803,A,Lee,37105A
Lee,6691,4677,0.69899865491,1384,0.206845015693,36,0.00538036167987,51,0.00762217904648,406,0.0606785233896,137,0.0204752652817,1441,88,74,1427,1515,57,0.00851890599313,1441,0.215363921686,945,0.141234494097,5746,0.858765505903,4208,0.62890449858,B,Lee,37105B
Lee,11943,9374,0.784894917525,1485,0.124340617935,85,0.00711713974713,43,0.00360043540149,660,0.0552624968601,296,0.0247843925312,1601,179,157,1579,1758,116,0.00971280247844,1601,0.134053420414,1220,0.102151888135,10723,0.897848111865,8939,0.748471908231,C,Lee,37105C
Lee,10529,8650,0.821540507171,1155,0.109697027258,47,0.00446386171526,178,0.0169056890493,334,0.0317219109127,165,0.015671003894,1241,86,67,1222,1308,86,0.00816791718112,1241,0.117864944439,738,0.0700921265077,9791,0.929907873492,8326,0.79076835407,D,Lee,37105D
Lee,10187,7079,0.694905271424,1534,0.150584077746,77,0.00755865318543,76,0.00746048885835,1167,0.114557769706,254,0.0249337390792,1628,120,108,1616,1736,94,0.00922744674585,1628,0.159811524492,2311,0.22685775989,7876,0.77314224011,6150,0.603710611564,E,Lee,37105E
Lenoir,3684,1951,0.529587404995,1516,0.411509229099,9,0.00244299674267,22,0.00597176981542,135,0.0366449511401,51,0.0138436482085,1550,24,13,1539,1563,34,0.00922909880565,1550,0.420738327904,255,0.0692182410423,3429,0.930781758958,1856,0.503800217155,C,Lenoir,37107C
Lenoir,5974,4514,0.755607633077,1102,0.184466019417,53,0.00887177770338,55,0.00920656176766,174,0.0291262135922,76,0.0127217944426,1139,70,66,1135,1205,37,0.00619350518915,1139,0.190659524607,401,0.0671242048878,5573,0.932875795112,4330,0.724807499163,FC,Lenoir,37107FC
Lenoir,2628,1814,0.690258751903,619,0.235540334855,19,0.0072298325723,9,0.00342465753425,143,0.0544140030441,24,0.00913242009132,626,33,32,625,658,7,0.00266362252664,626,0.238203957382,214,0.0814307458143,2414,0.918569254186,1749,0.665525114155,I,Lenoir,37107I
Lenoir,1999,38,0.0190095047524,1925,0.962981490745,4,0.00200100050025,5,0.00250125062531,6,0.00300150075038,21,0.0105052526263,1946,15,4,1935,1950,21,0.0105052526263,1946,0.973486743372,29,0.0145072536268,1970,0.985492746373,31,0.0155077538769,K1,Lenoir,37107K1
Lenoir,1684,115,0.0682897862233,1534,0.910926365796,1,0.000593824228029,2,0.00118764845606,16,0.00950118764846,16,0.00950118764846,1542,5,4,1541,1546,8,0.00475059382423,1542,0.91567695962,25,0.0148456057007,1659,0.985154394299,115,0.0682897862233,K2,Lenoir,37107K2
Lenoir,2074,678,0.326904532305,1267,0.610896817743,5,0.00241080038573,13,0.00626808100289,53,0.0255544840887,58,0.0279652844744,1305,17,9,1297,1314,38,0.0183220829315,1305,0.629218900675,112,0.0540019286403,1962,0.94599807136,632,0.304725168756,K3,Lenoir,37107K3
Lenoir,3613,2455,0.679490727927,1024,0.283420979795,5,0.00138389150291,41,0.0113479103238,48,0.0132853584279,40,0.0110711320232,1052,15,10,1047,1062,28,0.00774979241627,1052,0.291170772211,109,0.0301688347634,3504,0.969831165237,2395,0.662884029892,K4,Lenoir,37107K4
Lenoir,2038,754,0.369970559372,1225,0.601079489696,3,0.00147203140334,22,0.0107948969578,20,0.00981354268891,14,0.00686947988224,1235,4,3,1234,1238,10,0.00490677134446,1235,0.60598626104,34,0.0166830225711,2004,0.983316977429,744,0.365063788027,K5,Lenoir,37107K5
Lenoir,3274,400,0.122174709835,2804,0.856444715944,6,0.00183262064753,17,0.00519242516799,16,0.0048869883934,31,0.00946854001222,2832,12,7,2827,2839,28,0.00855222968845,2832,0.864996945632,51,0.015577275504,3223,0.984422724496,387,0.118204031765,K6,Lenoir,37107K6
Lenoir,2867,456,0.159051273108,2319,0.808859434949,10,0.00348796651552,6,0.00209277990931,38,0.013254272759,38,0.013254272759,2352,25,12,2339,2364,33,0.0115102895012,2352,0.820369724451,73,0.0254621555633,2794,0.974537844437,434,0.151377746774,K7,Lenoir,37107K7
Lenoir,1392,7,0.00502873563218,1368,0.98275862069,6,0.00431034482759,1,0.000718390804598,0,0.0,10,0.00718390804598,1378,11,6,1373,1384,10,0.00718390804598,1378,0.989942528736,10,0.00718390804598,1382,0.992816091954,7,0.00502873563218,K8,Lenoir,37107K8
Lenoir,2465,1149,0.466125760649,1204,0.488438133874,5,0.00202839756592,34,0.0137931034483,28,0.0113590263692,45,0.0182555780933,1220,15,13,1218,1233,16,0.00649087221095,1220,0.494929006085,79,0.0320486815416,2386,0.967951318458,1107,0.449087221095,K9,Lenoir,37107K9
Lenoir,5715,2963,0.518460192476,2326,0.406999125109,22,0.00384951881015,33,0.00577427821522,296,0.0517935258093,75,0.0131233595801,2370,43,31,2358,2401,44,0.0076990376203,2370,0.41469816273,463,0.0810148731409,5252,0.918985126859,2836,0.496237970254,MH,Lenoir,37107MH
Lenoir,5129,3501,0.682589198674,1270,0.247611620199,17,0.00331448625463,11,0.00214466757653,244,0.0475726262429,86,0.0167674010528,1317,39,32,1310,1349,47,0.00916357964516,1317,0.256775199844,423,0.0824722168064,4706,0.917527783194,3356,0.65431858062,N,Lenoir,37107N
Lenoir,1069,864,0.808231992516,82,0.0767072029935,14,0.0130963517306,0,0.0,94,0.087932647334,15,0.0140318054256,89,14,14,89,103,7,0.00654817586529,89,0.0832553788587,162,0.151543498597,907,0.848456501403,816,0.763330215154,PH1,Lenoir,37107PH1
Lenoir,1970,1415,0.718274111675,216,0.109644670051,6,0.00304568527919,5,0.00253807106599,312,0.158375634518,16,0.00812182741117,224,11,9,222,233,8,0.00406091370558,224,0.113705583756,411,0.208629441624,1559,0.791370558376,1330,0.675126903553,PH2,Lenoir,37107PH2
Lenoir,1256,1028,0.81847133758,149,0.118630573248,3,0.00238853503185,2,0.0015923566879,54,0.0429936305732,20,0.015923566879,160,9,8,159,168,11,0.00875796178344,160,0.127388535032,95,0.0756369426752,1161,0.924363057325,988,0.786624203822,SH,Lenoir,37107SH
Lenoir,1722,1445,0.839140534262,150,0.0871080139373,5,0.00290360046458,8,0.00464576074332,90,0.0522648083624,24,0.01393728223,155,14,14,155,169,5,0.00290360046458,155,0.0900116144019,120,0.0696864111498,1602,0.93031358885,1422,0.825783972125,SW,Lenoir,37107SW
Lenoir,2056,1609,0.782587548638,199,0.0967898832685,10,0.00486381322957,9,0.00437743190661,192,0.0933852140078,37,0.0179961089494,214,18,16,212,230,15,0.00729571984436,214,0.104085603113,282,0.137159533074,1774,0.862840466926,1543,0.750486381323,T1,Lenoir,37107T1
Lenoir,1663,1395,0.838845460012,98,0.0589296452195,5,0.00300661455201,6,0.00360793746242,129,0.077570655442,30,0.0180396873121,105,13,10,102,115,7,0.00420926037282,105,0.0631389055923,206,0.123872519543,1457,0.876127480457,1336,0.803367408298,T2,Lenoir,37107T2
Lenoir,3545,1677,0.473060648801,1636,0.46149506347,9,0.00253878702398,8,0.00225669957687,172,0.0485190409027,43,0.0121297602257,1656,20,18,1654,1674,20,0.00564174894217,1656,0.467136812412,294,0.0829337094499,3251,0.91706629055,1572,0.443441466855,V,Lenoir,37107V
Lenoir,1678,1530,0.911799761621,88,0.0524433849821,5,0.00297973778308,1,0.000595947556615,39,0.023241954708,15,0.00893921334923,98,7,7,98,105,10,0.00595947556615,98,0.0584028605483,69,0.0411203814064,1609,0.958879618594,1506,0.897497020262,W,Lenoir,37107W
Lincoln,3255,2918,0.896466973886,133,0.0408602150538,8,0.00245775729647,35,0.010752688172,103,0.031643625192,58,0.0178187403994,156,18,16,154,172,23,0.00706605222734,156,0.0479262672811,357,0.109677419355,2898,0.890322580645,2681,0.823655913978,AS25,Lincoln,37109AS25
Lincoln,3334,2393,0.71775644871,484,0.145170965807,13,0.00389922015597,40,0.0119976004799,268,0.0803839232154,136,0.0407918416317,560,23,19,556,579,76,0.0227954409118,560,0.167966406719,788,0.236352729454,2546,0.763647270546,1948,0.584283143371,BC13,Lincoln,37109BC13
Lincoln,2870,2356,0.820905923345,404,0.140766550523,1,0.000348432055749,9,0.00313588850174,68,0.0236933797909,32,0.011149825784,418,8,8,418,426,14,0.00487804878049,418,0.145644599303,208,0.0724738675958,2662,0.927526132404,2227,0.775958188153,BS26,Lincoln,37109BS26
Lincoln,1789,1712,0.956959195081,19,0.0106204583566,5,0.00279485746227,16,0.00894354387926,20,0.0111794298491,17,0.00950251537172,20,7,7,20,27,1,0.000558971492454,20,0.0111794298491,41,0.0229178311906,1748,0.977082168809,1695,0.947456679709,CF19,Lincoln,37109CF19
Lincoln,1429,1355,0.948215535339,13,0.00909727081875,2,0.00139958012596,1,0.000699790062981,34,0.0237928621414,24,0.0167949615115,22,6,5,21,27,9,0.00629811056683,22,0.0153953813856,118,0.0825752274318,1311,0.917424772568,1283,0.897830650805,CR06,Lincoln,37109CR06
Lincoln,3455,3270,0.946454413893,65,0.0188133140376,17,0.00492040520984,28,0.00810419681621,36,0.0104196816208,39,0.0112879884226,78,25,25,78,103,13,0.00376266280753,78,0.0225759768452,95,0.027496382055,3360,0.972503617945,3212,0.929667149059,DN29,Lincoln,37109DN29
Lincoln,3834,3684,0.960876369327,59,0.0153886280647,9,0.00234741784038,10,0.00260824204486,38,0.00991131977047,34,0.00886802295253,70,25,25,70,95,11,0.00286906624935,70,0.018257694314,149,0.0388628064684,3685,0.961137193532,3577,0.932968179447,DV08,Lincoln,37109DV08
Lincoln,2990,2730,0.913043478261,162,0.0541806020067,17,0.0056856187291,14,0.00468227424749,27,0.00903010033445,40,0.0133779264214,170,41,40,169,210,8,0.00267558528428,170,0.056856187291,73,0.0244147157191,2917,0.975585284281,2680,0.896321070234,DW28,Lincoln,37109DW28
Lincoln,2970,2151,0.724242424242,398,0.134006734007,9,0.0030303030303,11,0.0037037037037,322,0.108417508418,79,0.0265993265993,436,22,18,432,454,38,0.0127946127946,436,0.146801346801,605,0.203703703704,2365,0.796296296296,1912,0.643771043771,HG17,Lincoln,37109HG17
Lincoln,3725,3497,0.938791946309,72,0.0193288590604,5,0.00134228187919,14,0.00375838926174,87,0.023355704698,50,0.0134228187919,90,17,16,89,106,18,0.0048322147651,90,0.0241610738255,280,0.0751677852349,3445,0.924832214765,3323,0.892080536913,HV07,Lincoln,37109HV07
Lincoln,2269,2094,0.922873512561,84,0.0370207139709,14,0.00617011899515,5,0.00220361392684,47,0.0207139709123,25,0.0110180696342,88,26,26,88,114,4,0.00176289114147,88,0.0387836051124,83,0.0365799911855,2186,0.963420008814,2053,0.904803878361,IS20,Lincoln,37109IS20
Lincoln,3343,2903,0.86838169309,332,0.0993119952139,12,0.00358959018845,19,0.00568351779838,25,0.00747831289261,52,0.0155548908166,348,28,28,348,376,16,0.00478612025127,348,0.104098115465,131,0.0391863595573,3212,0.960813640443,2810,0.84056236913,IS23,Lincoln,37109IS23
Lincoln,2164,1904,0.879852125693,149,0.068853974122,4,0.00184842883549,22,0.0101663585952,62,0.0286506469501,23,0.0106284658041,159,9,8,158,167,10,0.00462107208872,159,0.0734750462107,125,0.0577634011091,2039,0.942236598891,1846,0.853049907579,LI14,Lincoln,37109LI14
Lincoln,2244,2105,0.938057040998,40,0.017825311943,0,0.0,12,0.00534759358289,63,0.0280748663102,24,0.0106951871658,47,3,3,47,50,7,0.00311942959002,47,0.020944741533,133,0.0592691622103,2111,0.94073083779,2045,0.911319073084,LM16,Lincoln,37109LM16
Lincoln,2220,1768,0.796396396396,325,0.146396396396,8,0.0036036036036,4,0.0018018018018,60,0.027027027027,55,0.0247747747748,354,19,13,348,367,29,0.0130630630631,354,0.159459459459,229,0.103153153153,1991,0.896846846847,1629,0.733783783784,LN11,Lincoln,37109LN11
Lincoln,2666,1994,0.747936984246,434,0.162790697674,10,0.00375093773443,3,0.00112528132033,148,0.0555138784696,77,0.0288822205551,474,24,20,470,494,40,0.0150037509377,474,0.177794448612,332,0.124531132783,2334,0.875468867217,1850,0.69392348087,LS12,Lincoln,37109LS12
Lincoln,2035,1909,0.938083538084,35,0.017199017199,2,0.000982800982801,10,0.004914004914,38,0.0186732186732,41,0.0201474201474,52,14,14,52,66,17,0.00835380835381,52,0.0255528255528,75,0.036855036855,1960,0.963144963145,1877,0.922358722359,LS15,Lincoln,37109LS15
Lincoln,1757,1453,0.826977803073,221,0.12578258395,11,0.00626067159932,10,0.00569151963574,11,0.00626067159932,51,0.0290267501423,242,37,37,242,279,21,0.0119521912351,242,0.137734775185,42,0.0239043824701,1715,0.97609561753,1432,0.815025611838,LW18,Lincoln,37109LW18
Lincoln,3762,3475,0.923710792132,159,0.0422647527911,24,0.00637958532695,31,0.00824029771398,38,0.010101010101,35,0.00930356193514,182,32,31,181,213,23,0.00611376927166,182,0.0483785220627,94,0.0249867091972,3668,0.975013290803,3424,0.910154173312,LW31,Lincoln,37109LW31
Lincoln,1890,1772,0.937566137566,29,0.0153439153439,17,0.00899470899471,4,0.0021164021164,40,0.021164021164,28,0.0148148148148,40,26,26,40,66,11,0.00582010582011,40,0.021164021164,72,0.0380952380952,1818,0.961904761905,1753,0.927513227513,NB03,Lincoln,37109NB03
Lincoln,3950,3723,0.94253164557,90,0.0227848101266,14,0.00354430379747,2,0.000506329113924,91,0.0230379746835,30,0.00759493670886,100,24,24,100,124,10,0.00253164556962,100,0.0253164556962,154,0.0389873417722,3796,0.961012658228,3668,0.928607594937,NB09,Lincoln,37109NB09
Lincoln,3014,2838,0.941605839416,58,0.0192435301924,5,0.00165892501659,25,0.00829462508295,33,0.0109489051095,55,0.0182481751825,78,24,21,75,99,20,0.00663570006636,78,0.0258792302588,96,0.0318513603185,2918,0.968148639681,2778,0.921698739217,OB21,Lincoln,37109OB21
Lincoln,2512,2251,0.896098726115,84,0.0334394904459,2,0.000796178343949,12,0.00477707006369,138,0.0549363057325,25,0.00995222929936,92,10,9,91,101,8,0.0031847133758,92,0.0366242038217,273,0.108678343949,2239,0.891321656051,2132,0.84872611465,OG10,Lincoln,37109OG10
Lincoln,3444,3248,0.943089430894,63,0.0182926829268,7,0.0020325203252,10,0.00290360046458,61,0.0177119628339,55,0.0159698025552,90,22,19,87,109,27,0.00783972125436,90,0.0261324041812,157,0.0455865272938,3287,0.954413472706,3157,0.916666666667,PC22,Lincoln,37109PC22
Lincoln,2549,2246,0.881129854845,134,0.052569635151,5,0.00196155355041,16,0.00627697136132,99,0.0388387602982,49,0.019223224794,145,17,14,142,159,11,0.00431541781091,145,0.0568850529619,234,0.0918007061593,2315,0.908199293841,2126,0.834052569635,SL24,Lincoln,37109SL24
Lincoln,2228,2113,0.948384201077,32,0.0143626570916,6,0.00269299820467,28,0.0125673249551,36,0.016157989228,13,0.00583482944345,38,7,7,38,45,6,0.00269299820467,38,0.0170556552962,115,0.0516157989228,2113,0.948384201077,2038,0.914721723519,TE27,Lincoln,37109TE27
Lincoln,1462,1276,0.872777017784,115,0.078659370725,15,0.0102599179207,1,0.000683994528044,29,0.0198358413133,26,0.0177838577291,126,25,25,126,151,11,0.00752393980848,126,0.0861833105335,48,0.0328317373461,1414,0.967168262654,1255,0.858413132695,TR30,Lincoln,37109TR30
Lincoln,5105,4802,0.940646425073,147,0.0287952987267,8,0.00156709108717,46,0.00901077375122,56,0.0109696376102,46,0.00901077375122,158,24,23,157,181,11,0.00215475024486,158,0.0309500489716,131,0.0256611165524,4974,0.974338883448,4728,0.926150832517,WP32,Lincoln,37109WP32
Macon,3234,2986,0.923314780458,80,0.0247371675943,18,0.00556586270872,30,0.00927643784787,75,0.0231910946197,45,0.0139146567718,95,26,24,93,119,15,0.00463821892393,95,0.0293753865182,256,0.0791589363018,2978,0.920841063698,2827,0.874149659864,01,Macon,3711301
Macon,1940,1663,0.857216494845,39,0.0201030927835,21,0.010824742268,19,0.00979381443299,166,0.0855670103093,32,0.0164948453608,47,28,27,46,74,8,0.00412371134021,47,0.0242268041237,374,0.192783505155,1566,0.807216494845,1460,0.752577319588,02,Macon,3711302
Macon,3457,3203,0.9265258895,49,0.0141741394272,17,0.0049175585768,22,0.00636389933468,114,0.0329765692797,52,0.015041943882,65,38,35,62,100,16,0.00462829042522,65,0.0188024298525,304,0.0879375180793,3153,0.912062481921,3022,0.874168354064,03,Macon,3711303
Macon,2050,1976,0.963902439024,18,0.00878048780488,4,0.0019512195122,7,0.00341463414634,25,0.0121951219512,20,0.00975609756098,20,10,10,20,30,2,0.000975609756098,20,0.00975609756098,134,0.0653658536585,1916,0.934634146341,1875,0.914634146341,04,Macon,3711304
Macon,3828,3533,0.922936259143,28,0.0073145245559,25,0.00653082549634,33,0.00862068965517,158,0.0412748171369,51,0.0133228840125,33,41,41,33,74,5,0.00130616509927,33,0.00862068965517,348,0.0909090909091,3480,0.909090909091,3374,0.881400208986,05,Macon,3711305
Macon,2802,2693,0.961099214847,12,0.00428265524625,22,0.00785153461813,32,0.01142041399,31,0.0110635260528,12,0.00428265524625,16,28,28,16,44,4,0.00142755174875,16,0.005710206995,91,0.0324768022841,2711,0.967523197716,2634,0.940042826552,06,Macon,3711306
Macon,2691,2575,0.956893348198,9,0.00334448160535,6,0.00222965440357,35,0.0130063173541,53,0.0196952805648,13,0.0048309178744,14,13,12,13,26,5,0.00185804533631,14,0.00520252694166,134,0.049795615013,2557,0.950204384987,2502,0.929765886288,07,Macon,3711307
Macon,523,500,0.956022944551,1,0.0019120458891,2,0.0038240917782,2,0.0038240917782,12,0.0229445506692,6,0.0114722753346,2,5,5,2,7,1,0.0019120458891,2,0.0038240917782,17,0.0325047801147,506,0.967495219885,495,0.946462715105,08,Macon,3711308
Macon,2668,2528,0.947526236882,16,0.00599700149925,5,0.00187406296852,7,0.00262368815592,80,0.0299850074963,32,0.0119940029985,23,24,24,23,47,7,0.00262368815592,23,0.00862068965517,125,0.0468515742129,2543,0.953148425787,2488,0.932533733133,09,Macon,3711309
Macon,466,439,0.942060085837,9,0.019313304721,1,0.00214592274678,0,0.0,11,0.0236051502146,6,0.0128755364807,9,3,3,9,12,0,0.0,9,0.019313304721,36,0.0772532188841,430,0.922746781116,415,0.890557939914,10,Macon,3711310
Macon,3858,3617,0.937532400207,33,0.00855365474339,9,0.00233281493002,10,0.00259201658891,145,0.0375842405391,44,0.0114048729912,47,35,31,43,78,14,0.00362882322447,47,0.0121824779679,290,0.0751684810783,3568,0.924831518922,3478,0.901503369622,11,Macon,3711311
Macon,2436,2227,0.914203612479,145,0.0595238095238,9,0.00369458128079,9,0.00369458128079,17,0.00697865353038,29,0.0119047619048,155,15,15,155,170,10,0.00410509031199,155,0.0636288998358,46,0.0188834154351,2390,0.981116584565,2208,0.906403940887,12,Macon,3711312
Macon,802,787,0.981296758105,0,0.0,8,0.00997506234414,0,0.0,0,0.0,7,0.00872817955112,2,12,12,2,14,2,0.00249376558603,2,0.00249376558603,25,0.0311720698254,777,0.968827930175,768,0.957605985037,13,Macon,3711313
Macon,894,881,0.985458612975,0,0.0,6,0.00671140939597,1,0.00111856823266,1,0.00111856823266,5,0.00559284116331,2,8,8,2,10,2,0.00223713646532,2,0.00223713646532,8,0.0089485458613,886,0.991051454139,874,0.977628635347,14,Macon,3711314
Macon,2273,2203,0.969203695557,8,0.00351957765068,12,0.00527936647602,5,0.00219973603168,17,0.0074791025077,28,0.0123185217774,14,28,28,14,42,6,0.00263968323801,14,0.00615926088869,42,0.0184777826661,2231,0.981522217334,2179,0.958644962604,15,Macon,3711315
Madison,3169,3071,0.969075418113,9,0.00284001262228,6,0.00189334174819,11,0.00347112653834,17,0.00536446828653,55,0.0173556326917,15,51,50,14,65,6,0.00189334174819,15,0.00473335437046,91,0.0287156831808,3078,0.971284316819,3002,0.947301988009,BEECH,Madison,37115BEECH
Madison,1264,1231,0.973892405063,12,0.00949367088608,1,0.000791139240506,1,0.000791139240506,5,0.00395569620253,14,0.0110759493671,18,11,7,14,25,6,0.00474683544304,18,0.0142405063291,14,0.0110759493671,1250,0.988924050633,1223,0.967563291139,EBBS-C,Madison,37115EBBS-C
Madison,1498,1469,0.980640854473,8,0.00534045393858,0,0.0,4,0.00267022696929,0,0.0,17,0.0113484646195,13,9,4,8,17,5,0.00333778371162,13,0.0086782376502,24,0.0160213618158,1474,0.983978638184,1446,0.965287049399,GRAPEV,Madison,37115GRAPEV
Madison,1248,1225,0.981570512821,5,0.00400641025641,0,0.0,0,0.0,5,0.00400641025641,13,0.0104166666667,5,10,10,5,15,0,0.0,5,0.00400641025641,21,0.0168269230769,1227,0.983173076923,1212,0.971153846154,HOT-SP,Madison,37115HOT-SP
Madison,1174,1149,0.97870528109,1,0.000851788756388,11,0.00936967632027,0,0.0,3,0.00255536626917,10,0.00851788756388,2,18,18,2,20,1,0.000851788756388,2,0.00170357751278,22,0.0187393526405,1152,0.981260647359,1133,0.965076660988,LAUREL,Madison,37115LAUREL
Madison,4654,4345,0.933605500645,186,0.0399656209712,11,0.00236355822948,33,0.00709067468844,24,0.00515685431887,55,0.0118177911474,207,39,34,202,241,21,0.00451224752901,207,0.0444778685002,101,0.0217017619252,4553,0.978298238075,4270,0.917490330898,MARS-H,Madison,37115MARS-H
Madison,3078,3007,0.976933073424,4,0.00129954515919,5,0.00162443144899,8,0.00259909031839,23,0.00747238466537,31,0.0100714749838,6,27,25,4,31,2,0.000649772579597,6,0.00194931773879,95,0.0308641975309,2983,0.969135802469,2942,0.955815464587,NORTH,Madison,37115NORTH
Madison,316,304,0.962025316456,8,0.0253164556962,1,0.00316455696203,1,0.00316455696203,1,0.00316455696203,1,0.00316455696203,8,1,1,8,9,0,0.0,8,0.0253164556962,5,0.0158227848101,311,0.98417721519,300,0.949367088608,REVERE,Madison,37115REVERE
Madison,543,530,0.97605893186,1,0.00184162062615,0,0.0,1,0.00184162062615,3,0.00552486187845,8,0.0147329650092,3,3,3,3,6,2,0.0036832412523,3,0.00552486187845,2,0.0036832412523,541,0.996316758748,530,0.97605893186,SANDY,Madison,37115SANDY
Madison,1268,1213,0.956624605678,4,0.00315457413249,5,0.00394321766562,1,0.000788643533123,7,0.00552050473186,38,0.0299684542587,9,28,28,9,37,5,0.00394321766562,9,0.00709779179811,31,0.0244479495268,1237,0.975552050473,1198,0.944794952681,SOUTH,Madison,37115SOUTH
Madison,917,896,0.977099236641,2,0.00218102508179,2,0.00218102508179,3,0.00327153762268,2,0.00218102508179,12,0.0130861504907,2,5,5,2,7,0,0.0,2,0.00218102508179,8,0.00872410032715,909,0.991275899673,890,0.970556161396,SPRING,Madison,37115SPRING
Madison,1635,1595,0.975535168196,0,0.0,6,0.00366972477064,15,0.00917431192661,4,0.00244648318043,15,0.00917431192661,3,17,16,2,19,3,0.00183486238532,3,0.00183486238532,9,0.00550458715596,1626,0.994495412844,1588,0.97125382263,WALNUT,Madison,37115WALNUT
Martin,2065,1753,0.848910411622,273,0.132203389831,4,0.00193704600484,0,0.0,18,0.00871670702179,17,0.00823244552058,280,8,8,280,288,7,0.00338983050847,280,0.135593220339,34,0.0164648910412,2031,0.983535108959,1739,0.842130750605,BG,Martin,37117BG
Martin,1515,954,0.629702970297,486,0.320792079208,2,0.0013201320132,4,0.0026402640264,57,0.0376237623762,12,0.00792079207921,494,3,3,494,497,8,0.00528052805281,494,0.326072607261,74,0.0488448844884,1441,0.951155115512,940,0.620462046205,CR,Martin,37117CR
Martin,1100,400,0.363636363636,662,0.601818181818,3,0.00272727272727,0,0.0,31,0.0281818181818,4,0.00363636363636,664,5,5,664,669,2,0.00181818181818,664,0.603636363636,55,0.05,1045,0.95,381,0.346363636364,GN,Martin,37117GN
Martin,1262,1019,0.807448494453,211,0.167194928685,2,0.00158478605388,1,0.000792393026941,16,0.0126782884311,13,0.0103011093502,213,6,6,213,219,2,0.00158478605388,213,0.168779714739,31,0.0245641838352,1231,0.975435816165,1016,0.805071315372,GR,Martin,37117GR
Martin,1177,464,0.39422259983,694,0.589634664401,3,0.00254885301614,4,0.00339847068819,3,0.00254885301614,9,0.00764655904843,700,6,3,697,703,6,0.00509770603229,700,0.594732370433,17,0.0144435004248,1160,0.985556499575,455,0.386576040782,HM,Martin,37117HM
Martin,367,137,0.373297002725,230,0.626702997275,0,0.0,0,0.0,0,0.0,0,0.0,230,0,0,230,230,0,0.0,230,0.626702997275,1,0.00272479564033,366,0.99727520436,136,0.370572207084,HS,Martin,37117HS
Martin,2689,1870,0.695425808851,730,0.271476385273,11,0.00409074005206,2,0.000743770918557,32,0.0119003346969,44,0.0163629602083,764,29,13,748,777,34,0.0126441056155,764,0.284120490889,69,0.0256600966902,2620,0.97433990331,1843,0.68538490145,J,Martin,37117J
Martin,511,320,0.626223091977,154,0.301369863014,3,0.00587084148728,3,0.00587084148728,20,0.0391389432485,11,0.0215264187867,160,6,6,160,166,6,0.0117416829746,160,0.313111545988,26,0.0508806262231,485,0.949119373777,317,0.620352250489,PP,Martin,37117PP
Martin,1516,504,0.332453825858,922,0.608179419525,7,0.00461741424802,9,0.00593667546174,64,0.0422163588391,10,0.0065963060686,930,8,8,930,938,8,0.00527704485488,930,0.61345646438,92,0.0606860158311,1424,0.939313984169,485,0.319920844327,R1,Martin,37117R1
Martin,1935,626,0.323514211886,1256,0.649095607235,4,0.00206718346253,3,0.0015503875969,29,0.0149870801034,17,0.00878552971576,1264,15,8,1257,1272,8,0.00413436692506,1264,0.65322997416,54,0.0279069767442,1881,0.972093023256,609,0.314728682171,R2,Martin,37117R2
Martin,1256,918,0.730891719745,296,0.235668789809,18,0.0143312101911,1,0.000796178343949,15,0.0119426751592,8,0.00636942675159,298,20,19,297,317,2,0.0015923566879,298,0.237261146497,23,0.0183121019108,1233,0.981687898089,913,0.726910828025,W,Martin,37117W
Martin,4726,2131,0.450909860347,2386,0.504866694879,5,0.00105797714769,36,0.00761743546339,111,0.0234870926788,57,0.0120609394837,2423,20,11,2414,2434,37,0.00782903089293,2423,0.512695725772,208,0.0440118493441,4518,0.955988150656,2068,0.437579348286,W1,Martin,37117W1
Martin,4386,1923,0.438440492476,2351,0.53602371181,11,0.00250797993616,18,0.00410396716826,38,0.00866393068855,45,0.0102599179207,2383,26,19,2376,2402,32,0.00729594163247,2383,0.543319653443,85,0.0193798449612,4301,0.980620155039,1888,0.430460556316,W2,Martin,37117W2
McDowell,2415,2333,0.966045548654,26,0.0107660455487,16,0.00662525879917,7,0.00289855072464,9,0.00372670807453,24,0.00993788819876,34,28,25,31,59,8,0.00331262939959,34,0.0140786749482,21,0.00869565217391,2394,0.991304347826,2323,0.961904761905,CCREEK,McDowell,37111CCREEK
McDowell,3447,3135,0.909486510009,47,0.0136350449666,19,0.0055120394546,122,0.0353930954453,93,0.0269799825936,31,0.00899332753119,64,29,28,63,92,17,0.00493182477517,64,0.0185668697418,138,0.0400348128808,3309,0.959965187119,3099,0.899042645779,DYSART,McDowell,37111DYSART
McDowell,1951,1803,0.924141465915,106,0.0543311122501,6,0.00307534597642,4,0.00205023065095,21,0.0107637109175,11,0.00563813429011,111,10,10,111,121,5,0.00256278831369,111,0.0568939005638,68,0.0348539210661,1883,0.965146078934,1756,0.900051255766,FORT-1,McDowell,37111FORT-1
McDowell,2561,2361,0.921905505662,123,0.048028114018,3,0.00117141741507,9,0.00351425224522,22,0.0085903943772,43,0.0167903162827,141,17,13,137,154,18,0.00702850449043,141,0.0550566185084,56,0.0218664584147,2505,0.978133541585,2335,0.911753221398,FORT-2,McDowell,37111FORT-2
McDowell,2478,2424,0.978208232446,10,0.00403551251009,5,0.00201775625504,12,0.00484261501211,8,0.00322841000807,19,0.00766747376917,15,13,13,15,28,5,0.00201775625504,15,0.00605326876513,47,0.0189669087974,2431,0.981033091203,2387,0.963276836158,GLENWD,McDowell,37111GLENWD
McDowell,3144,2639,0.839376590331,351,0.111641221374,14,0.00445292620865,25,0.00795165394402,99,0.0314885496183,16,0.00508905852417,355,16,16,355,371,4,0.00127226463104,355,0.112913486005,135,0.0429389312977,3009,0.957061068702,2605,0.828562340967,HIGGIN,McDowell,37111HIGGIN
McDowell,2447,2374,0.970167552105,14,0.0057212913772,12,0.0049039640376,1,0.0004086636698,29,0.0118512464242,17,0.0069472823866,18,20,20,18,38,4,0.0016346546792,18,0.0073559460564,63,0.0257458111974,2384,0.974254188803,2346,0.95872496935,M.COVE,McDowell,37111M.COVE
McDowell,4285,3844,0.897082847141,127,0.0296382730455,21,0.0049008168028,36,0.00840140023337,206,0.0480746791132,51,0.0119019836639,144,42,42,144,186,17,0.00396732788798,144,0.0336056009335,325,0.0758459743291,3960,0.924154025671,3756,0.876546091015,MAR-1,McDowell,37111MAR-1
McDowell,2350,1730,0.736170212766,400,0.170212765957,10,0.00425531914894,19,0.00808510638298,133,0.0565957446809,58,0.0246808510638,434,28,20,426,454,34,0.0144680851064,434,0.184680851064,189,0.0804255319149,2161,0.919574468085,1687,0.717872340426,MAR-2,McDowell,37111MAR-2
McDowell,1605,1413,0.880373831776,34,0.0211838006231,7,0.00436137071651,6,0.00373831775701,125,0.0778816199377,20,0.01246105919,35,23,23,35,58,1,0.000623052959502,35,0.0218068535826,185,0.115264797508,1420,0.884735202492,1370,0.853582554517,MAR-3,McDowell,37111MAR-3
McDowell,2294,1884,0.821272885789,35,0.0152571926765,20,0.00871839581517,9,0.00392327811683,289,0.125980819529,57,0.0248474280732,58,44,42,56,100,23,0.0100261551874,58,0.025283347864,403,0.175675675676,1891,0.824324324324,1789,0.779860505667,MAR-4,McDowell,37111MAR-4
McDowell,1868,1693,0.906316916488,32,0.017130620985,3,0.00160599571734,9,0.00481798715203,99,0.0529978586724,32,0.017130620985,40,19,19,40,59,8,0.00428265524625,40,0.0214132762313,177,0.0947537473233,1691,0.905246252677,1617,0.865631691649,MAR-5,McDowell,37111MAR-5
McDowell,1046,1015,0.970363288719,2,0.0019120458891,0,0.0,8,0.00764818355641,1,0.000956022944551,20,0.019120458891,6,15,15,6,21,4,0.0038240917782,6,0.0057361376673,5,0.00478011472275,1041,0.995219885277,1010,0.965583173996,N.COVE,McDowell,37111N.COVE
McDowell,3425,3210,0.937226277372,125,0.036496350365,9,0.00262773722628,27,0.00788321167883,31,0.00905109489051,23,0.00671532846715,130,20,20,130,150,5,0.0014598540146,130,0.0379562043796,89,0.0259854014599,3336,0.97401459854,3161,0.922919708029,NEBO,McDowell,37111NEBO
McDowell,2922,2724,0.932238193018,40,0.0136892539357,11,0.00376454483231,20,0.00684462696783,99,0.0338809034908,28,0.00958247775496,56,19,19,56,75,16,0.00547570157426,56,0.0191649555099,156,0.0533880903491,2766,0.946611909651,2673,0.914784394251,PLEASA,McDowell,37111PLEASA
McDowell,1213,1158,0.954657873042,4,0.00329760923331,7,0.00577081615829,3,0.00247320692498,27,0.0222588623248,14,0.0115416323166,14,10,9,13,23,10,0.00824402308326,14,0.0115416323166,43,0.035449299258,1170,0.964550700742,1144,0.943116240725,T.COVE,McDowell,37111T.COVE
McDowell,5545,5014,0.904238052299,232,0.0418394950406,26,0.00468890892696,35,0.00631199278629,151,0.0272317403066,87,0.0156898106402,275,59,55,271,330,43,0.00775473399459,275,0.0495942290352,292,0.0526600541028,5253,0.947339945897,4924,0.888007213706,WEST-M,McDowell,37111WEST-M
Mecklenburg,1950,1831,0.938974358974,77,0.0394871794872,1,0.000512820512821,22,0.0112820512821,7,0.00358974358974,12,0.00615384615385,84,6,4,82,88,7,0.00358974358974,84,0.0430769230769,37,0.0189743589744,1913,0.981025641026,1802,0.924102564103,001,Mecklenburg,37119001
Mecklenburg,3049,2345,0.769104624467,549,0.180059035749,8,0.0026238110856,65,0.0213184650705,34,0.0111511971138,48,0.0157428665136,568,14,12,566,580,19,0.0062315513283,568,0.186290587078,70,0.022958346999,2979,0.977041653001,2315,0.759265332896,002,Mecklenburg,37119002
Mecklenburg,4870,718,0.147433264887,2902,0.595893223819,37,0.00759753593429,181,0.0371663244353,865,0.177618069815,167,0.0342915811088,3007,98,57,2966,3064,105,0.0215605749487,3007,0.617453798768,1344,0.275975359343,3526,0.724024640657,383,0.0786447638604,003,Mecklenburg,37119003
Mecklenburg,3781,1353,0.357841840783,1688,0.446442740016,11,0.0029092832584,129,0.0341179582121,485,0.128272943666,115,0.0304152340651,1737,47,27,1717,1764,49,0.0129595345147,1737,0.459402274531,812,0.214758000529,2969,0.785241999471,1091,0.288548003174,004,Mecklenburg,37119004
Mecklenburg,3703,1170,0.315960032406,1323,0.357277882798,11,0.00297056440724,119,0.0321361058601,982,0.265190386173,98,0.0264650283554,1384,39,17,1362,1401,61,0.0164731298947,1384,0.373751012692,1462,0.394815014853,2241,0.605184985147,766,0.206859303268,005,Mecklenburg,37119005
Mecklenburg,4861,1381,0.284097922238,2526,0.519646163341,59,0.0121374202839,67,0.0137831721868,662,0.136185969965,166,0.0341493519852,2623,93,72,2602,2695,97,0.0199547418227,2623,0.539600905164,1170,0.240691215799,3691,0.759308784201,1022,0.210244805596,006,Mecklenburg,37119006
Mecklenburg,2673,1700,0.635989524878,698,0.261129816685,8,0.00299289188178,48,0.0179573512907,146,0.0546202768425,73,0.0273101384212,740,32,20,728,760,42,0.0157126823793,740,0.276842499065,291,0.1088664422,2382,0.8911335578,1587,0.593714927048,007,Mecklenburg,37119007
Mecklenburg,3117,2914,0.934873275585,120,0.0384985563041,1,0.000320821302534,42,0.0134744947064,12,0.00384985563041,28,0.00898299647097,136,9,4,131,140,16,0.00513314084055,136,0.0436316971447,62,0.0198909207571,3055,0.980109079243,2866,0.919473853064,008,Mecklenburg,37119008
Mecklenburg,3305,2626,0.794553706505,546,0.165204236006,2,0.000605143721634,71,0.021482602118,19,0.00574886535552,41,0.0124054462935,562,13,10,559,572,16,0.00484114977307,562,0.170045385779,52,0.0157337367625,3253,0.984266263238,2589,0.783358547655,009,Mecklenburg,37119009
Mecklenburg,2719,2525,0.928650239058,71,0.0261125413755,14,0.00514895182052,53,0.0194924604634,9,0.00331004045605,47,0.017285766826,83,23,22,82,105,12,0.00441338727473,83,0.0305259286502,62,0.0228025009195,2657,0.977197499081,2476,0.910628907687,010,Mecklenburg,37119010
Mecklenburg,8175,5322,0.651009174312,2298,0.281100917431,22,0.00269113149847,279,0.034128440367,73,0.00892966360856,181,0.0221406727829,2379,81,59,2357,2438,81,0.00990825688073,2379,0.291009174312,270,0.0330275229358,7905,0.966972477064,5167,0.632048929664,011,Mecklenburg,37119011
Mecklenburg,3608,304,0.0842572062084,3013,0.835088691796,13,0.00360310421286,56,0.0155210643016,72,0.019955654102,150,0.0415742793792,3098,112,75,3061,3173,85,0.0235587583149,3098,0.858647450111,245,0.0679046563193,3363,0.932095343681,234,0.0648558758315,012,Mecklenburg,37119012
Mecklenburg,6575,2497,0.379771863118,3679,0.559543726236,9,0.00136882129278,244,0.0371102661597,51,0.0077566539924,95,0.0144486692015,3746,31,19,3734,3765,67,0.0101901140684,3746,0.569733840304,286,0.0434980988593,6289,0.956501901141,2310,0.351330798479,013,Mecklenburg,37119013
Mecklenburg,3063,454,0.148220698661,2373,0.774730656219,10,0.00326477309827,91,0.0297094351943,54,0.0176297747307,81,0.026444662096,2441,28,14,2427,2455,68,0.0222004570682,2441,0.796931113288,103,0.0336271629122,2960,0.966372837088,431,0.140711720535,014,Mecklenburg,37119014
Mecklenburg,3059,2638,0.862373324616,249,0.081399150049,9,0.00294213795358,45,0.0147106897679,43,0.0140568813338,75,0.0245178162798,283,34,25,274,308,34,0.0111147433802,283,0.0925138934292,95,0.0310559006211,2964,0.968944099379,2585,0.845047401111,015,Mecklenburg,37119015
Mecklenburg,3927,71,0.0180799592564,3670,0.934555640438,12,0.00305576776165,15,0.00381970970206,71,0.0180799592564,88,0.0224089635854,3741,51,16,3706,3757,71,0.0180799592564,3741,0.952635599694,184,0.0468551056786,3743,0.953144894321,23,0.00585688820983,016,Mecklenburg,37119016
Mecklenburg,3280,662,0.201829268293,2335,0.711890243902,15,0.00457317073171,47,0.0143292682927,148,0.0451219512195,73,0.022256097561,2393,34,19,2378,2412,58,0.0176829268293,2393,0.729573170732,333,0.101524390244,2947,0.898475609756,539,0.164329268293,017,Mecklenburg,37119017
Mecklenburg,1978,1957,0.989383215369,3,0.00151668351871,0,0.0,4,0.00202224469161,5,0.00252780586451,9,0.00455005055612,5,0,0,5,5,2,0.0010111223458,5,0.00252780586451,27,0.0136501516684,1951,0.986349848332,1931,0.976238624874,018,Mecklenburg,37119018
Mecklenburg,2293,2178,0.949847361535,41,0.0178805058875,2,0.000872219799389,31,0.0135194068905,13,0.00566942869603,28,0.0122110771915,53,7,5,51,58,12,0.00523331879634,53,0.0231138246838,38,0.0165721761884,2255,0.983427823812,2151,0.938072394243,019,Mecklenburg,37119019
Mecklenburg,2822,2631,0.932317505315,68,0.0240963855422,1,0.000354358610914,64,0.0226789510985,13,0.00460666194189,45,0.0159461374911,83,10,7,80,90,15,0.00531537916371,83,0.0294117647059,40,0.0141743444366,2782,0.985825655563,2597,0.920269312544,020,Mecklenburg,37119020
Mecklenburg,2813,2095,0.744756487736,464,0.164948453608,11,0.00391041592606,80,0.0284393885531,108,0.0383931745467,55,0.0195520796303,500,20,14,494,514,36,0.0127977248489,500,0.177746178457,194,0.0689655172414,2619,0.931034482759,2008,0.713828652684,021,Mecklenburg,37119021
Mecklenburg,4935,1810,0.366767983789,2857,0.578926038501,23,0.00466058763931,103,0.0208713272543,61,0.0123606889564,81,0.0164133738602,2917,54,28,2891,2945,60,0.0121580547112,2917,0.591084093212,186,0.0376899696049,4749,0.962310030395,1737,0.351975683891,022,Mecklenburg,37119022
Mecklenburg,2398,400,0.166805671393,1853,0.772727272727,22,0.00917431192661,22,0.00917431192661,47,0.0195996663887,54,0.022518765638,1896,33,24,1887,1920,43,0.0179316096747,1896,0.790658882402,81,0.033778148457,2317,0.966221851543,364,0.151793160967,023,Mecklenburg,37119023
Mecklenburg,3455,670,0.193921852388,2631,0.761505065123,15,0.00434153400868,49,0.0141823444284,21,0.00607814761216,69,0.0199710564399,2673,44,31,2660,2704,42,0.0121562952243,2673,0.773661360347,107,0.0309696092619,3348,0.969030390738,632,0.182923299566,024,Mecklenburg,37119024
Mecklenburg,3040,55,0.0180921052632,2884,0.948684210526,7,0.00230263157895,24,0.00789473684211,24,0.00789473684211,46,0.0151315789474,2923,26,10,2907,2933,39,0.0128289473684,2923,0.961513157895,50,0.0164473684211,2990,0.983552631579,36,0.0118421052632,025,Mecklenburg,37119025
Mecklenburg,5210,848,0.162763915547,3728,0.715547024952,38,0.00729366602687,161,0.0309021113244,337,0.0646833013436,98,0.0188099808061,3799,63,45,3781,3844,71,0.0136276391555,3799,0.729174664107,553,0.106142034549,4657,0.893857965451,702,0.134740882917,026,Mecklenburg,37119026
Mecklenburg,5326,668,0.125422455877,3642,0.683815245963,33,0.00619601952685,105,0.0197146075854,749,0.140630867443,129,0.024220803605,3720,70,48,3698,3768,78,0.0146451370635,3720,0.698460383027,1078,0.202403304544,4248,0.797596695456,422,0.0792339466767,027,Mecklenburg,37119027
Mecklenburg,3625,980,0.270344827586,2147,0.592275862069,17,0.00468965517241,133,0.0366896551724,233,0.064275862069,115,0.031724137931,2215,63,42,2194,2257,68,0.0187586206897,2215,0.611034482759,381,0.105103448276,3244,0.894896551724,881,0.243034482759,028,Mecklenburg,37119028
Mecklenburg,4306,1883,0.43729679517,975,0.226428239666,47,0.0109150023223,394,0.0915002322341,898,0.208546214584,109,0.0253135160242,1016,65,58,1009,1074,41,0.00952159777055,1016,0.235949837436,1371,0.318392940084,2935,0.681607059916,1497,0.347654435671,029,Mecklenburg,37119029
Mecklenburg,2781,1892,0.680330816253,663,0.238403451996,15,0.00539374325782,90,0.0323624595469,59,0.0212153901474,62,0.022294138799,693,31,24,686,717,30,0.0107874865156,693,0.249190938511,154,0.0553757641136,2627,0.944624235886,1822,0.655160014383,030,Mecklenburg,37119030
Mecklenburg,3797,127,0.0334474585199,3498,0.92125362128,32,0.00842770608375,23,0.0060574137477,22,0.00579404793258,95,0.0250197524361,3588,61,33,3560,3621,90,0.0237029233605,3588,0.944956544641,103,0.0271266789571,3694,0.972873321043,102,0.026863313142,031,Mecklenburg,37119031
Mecklenburg,2423,2334,0.963268675196,14,0.00577796120512,3,0.00123813454395,39,0.0160957490714,2,0.000825423029303,31,0.0127940569542,24,5,3,22,27,10,0.00412711514651,24,0.00990507635163,38,0.0156830375567,2385,0.984316962443,2299,0.948823772183,032,Mecklenburg,37119032
Mecklenburg,4140,1761,0.425362318841,1174,0.283574879227,42,0.0101449275362,106,0.0256038647343,929,0.224396135266,128,0.0309178743961,1224,61,53,1216,1277,50,0.012077294686,1224,0.295652173913,1469,0.354830917874,2671,0.645169082126,1320,0.31884057971,033,Mecklenburg,37119033
Mecklenburg,4109,2177,0.529812606474,1140,0.277439766367,19,0.00462399610611,251,0.0610854222439,394,0.0958870771477,128,0.0311511316622,1209,56,46,1199,1255,69,0.0167924069117,1209,0.294232173278,675,0.164273545875,3434,0.835726454125,1952,0.475054757849,034,Mecklenburg,37119034
Mecklenburg,2124,1751,0.824387947269,249,0.117231638418,4,0.00188323917137,54,0.0254237288136,21,0.00988700564972,45,0.021186440678,278,13,10,275,288,29,0.0136534839925,278,0.130885122411,84,0.0395480225989,2040,0.960451977401,1706,0.803201506591,035,Mecklenburg,37119035
Mecklenburg,3152,2778,0.881345177665,136,0.0431472081218,6,0.00190355329949,168,0.0532994923858,26,0.00824873096447,38,0.0120558375635,159,9,7,157,166,23,0.00729695431472,159,0.0504441624365,81,0.0256979695431,3071,0.974302030457,2722,0.863578680203,036,Mecklenburg,37119036
Mecklenburg,2699,2234,0.827713968136,116,0.0429788810671,10,0.00370507595406,71,0.0263060392738,227,0.0841052241571,41,0.0151908114116,131,22,19,128,150,15,0.00555761393109,131,0.0485364949981,416,0.154131159689,2283,0.845868840311,2060,0.763245646536,037,Mecklenburg,37119037
Mecklenburg,3685,2203,0.597829036635,781,0.211940298507,36,0.00976933514247,85,0.0230664857531,495,0.134328358209,85,0.0230664857531,819,66,51,804,870,38,0.0103120759837,819,0.222252374491,907,0.246132971506,2778,0.753867028494,1863,0.505563093623,038,Mecklenburg,37119038
Mecklenburg,4860,323,0.0664609053498,4135,0.850823045267,12,0.00246913580247,179,0.0368312757202,131,0.0269547325103,80,0.0164609053498,4210,35,14,4189,4224,75,0.0154320987654,4210,0.866255144033,248,0.0510288065844,4612,0.948971193416,264,0.0543209876543,039,Mecklenburg,37119039
Mecklenburg,4257,713,0.167488841907,2826,0.663847780127,36,0.00845665961945,377,0.0885600187926,209,0.0490956072351,96,0.0225510923185,2895,78,47,2864,2942,69,0.0162085976039,2895,0.680056377731,305,0.0716466995537,3952,0.928353300446,688,0.161616161616,040,Mecklenburg,37119040
Mecklenburg,4555,656,0.144017563117,3338,0.732821075741,38,0.00834248079034,261,0.0572996706915,176,0.0386388583974,86,0.0188803512623,3390,61,49,3378,3439,52,0.0114160263447,3390,0.744237102086,310,0.0680570801317,4245,0.931942919868,571,0.125356750823,041,Mecklenburg,37119041
Mecklenburg,4950,406,0.0820202020202,3563,0.719797979798,20,0.0040404040404,81,0.0163636363636,784,0.158383838384,96,0.0193939393939,3637,52,20,3605,3657,74,0.0149494949495,3637,0.734747474747,1054,0.212929292929,3896,0.787070707071,210,0.0424242424242,042,Mecklenburg,37119042
Mecklenburg,5964,1215,0.203722334004,3193,0.535378940309,60,0.010060362173,172,0.028839704896,1071,0.179577464789,253,0.0424211938296,3314,137,87,3264,3401,121,0.020288397049,3314,0.555667337357,1806,0.302816901408,4158,0.697183098592,752,0.126089872569,043,Mecklenburg,37119043
Mecklenburg,2111,1542,0.730459497868,389,0.184272856466,17,0.00805305542397,56,0.0265277119848,69,0.0326859308385,38,0.0180009474183,416,28,22,410,438,27,0.0127901468498,416,0.197063003316,172,0.0814779725249,1939,0.918522027475,1456,0.689720511606,044,Mecklenburg,37119044
Mecklenburg,4162,1454,0.349351273426,991,0.238106679481,26,0.00624699663623,387,0.0929841422393,1190,0.285920230658,114,0.0273906775589,1026,55,37,1008,1063,35,0.00840941854877,1026,0.24651609803,1596,0.383469485824,2566,0.616530514176,1148,0.2758289284,045,Mecklenburg,37119045
Mecklenburg,4740,1818,0.383544303797,1727,0.364345991561,33,0.00696202531646,428,0.0902953586498,577,0.121729957806,157,0.0331223628692,1809,58,44,1795,1853,82,0.0172995780591,1809,0.38164556962,916,0.193248945148,3824,0.806751054852,1557,0.328481012658,046,Mecklenburg,37119046
Mecklenburg,3248,2885,0.888238916256,233,0.071736453202,5,0.001539408867,54,0.0166256157635,37,0.0113916256158,34,0.0104679802956,253,6,6,253,259,20,0.00615763546798,253,0.07789408867,75,0.0230911330049,3173,0.976908866995,2856,0.879310344828,047,Mecklenburg,37119047
Mecklenburg,2377,2263,0.952040387042,36,0.015145140934,7,0.00294488851493,40,0.0168279343711,7,0.00294488851493,24,0.0100967606226,46,9,8,45,54,10,0.00420698359276,46,0.0193521245267,40,0.0168279343711,2337,0.983172065629,2237,0.941102229701,048,Mecklenburg,37119048
Mecklenburg,2644,2304,0.871406959153,145,0.0548411497731,3,0.00113464447806,40,0.0151285930408,108,0.0408472012103,44,0.0166414523449,158,11,9,156,167,13,0.00491679273828,158,0.0597579425113,230,0.0869894099849,2414,0.913010590015,2198,0.831316187595,049,Mecklenburg,37119049
Mecklenburg,3012,1879,0.623837981408,412,0.136786188579,5,0.00166002656042,88,0.0292164674635,570,0.189243027888,58,0.0192563081009,432,24,21,429,453,20,0.0066401062417,432,0.143426294821,758,0.25166002656,2254,0.74833997344,1724,0.572377158035,050,Mecklenburg,37119050
Mecklenburg,3675,2692,0.732517006803,383,0.104217687075,17,0.00462585034014,84,0.0228571428571,420,0.114285714286,79,0.0214965986395,414,23,18,409,432,31,0.00843537414966,414,0.112653061224,688,0.187210884354,2987,0.812789115646,2466,0.671020408163,051,Mecklenburg,37119051
Mecklenburg,3514,230,0.065452475811,3069,0.873363688105,16,0.00455321570859,6,0.00170745589072,128,0.0364257256688,65,0.0184974388162,3121,38,19,3102,3140,52,0.0147979510529,3121,0.888161639158,246,0.0700056915196,3268,0.92999430848,147,0.0418326693227,052,Mecklenburg,37119052
Mecklenburg,5684,1017,0.178923293455,3630,0.638634764251,18,0.00316678395496,219,0.0385292047854,626,0.110133708656,174,0.030612244898,3738,49,29,3718,3767,108,0.0190007037298,3738,0.65763546798,1057,0.185960591133,4627,0.814039408867,704,0.123856439127,053,Mecklenburg,37119053
Mecklenburg,3505,137,0.0390870185449,3249,0.926961483595,26,0.0074179743224,19,0.00542082738944,20,0.00570613409415,54,0.0154065620542,3300,36,26,3290,3326,51,0.0145506419401,3300,0.941512125535,70,0.0199714693295,3435,0.98002853067,120,0.0342368045649,054,Mecklenburg,37119054
Mecklenburg,2269,92,0.0405464962539,2005,0.883649184663,4,0.00176289114147,35,0.0154252974879,89,0.0392243278978,44,0.0193918025562,2028,14,6,2020,2034,23,0.0101366240635,2028,0.893785808726,197,0.0868223887175,2072,0.913177611283,31,0.0136624063464,055,Mecklenburg,37119055
Mecklenburg,2340,113,0.0482905982906,2030,0.867521367521,3,0.00128205128205,86,0.0367521367521,78,0.0333333333333,30,0.0128205128205,2057,18,4,2043,2061,27,0.0115384615385,2057,0.87905982906,139,0.0594017094017,2201,0.940598290598,74,0.0316239316239,056,Mecklenburg,37119056
Mecklenburg,3183,2810,0.882814954445,222,0.0697455230914,13,0.00408419729815,89,0.0279610430412,13,0.00408419729815,36,0.0113100848256,240,27,17,230,257,18,0.00565504241282,240,0.0754005655042,91,0.028589381087,3092,0.971410618913,2743,0.861765629909,057,Mecklenburg,37119057
Mecklenburg,2192,1540,0.702554744526,305,0.139142335766,7,0.00319343065693,125,0.0570255474453,173,0.0789233576642,42,0.0191605839416,320,13,12,319,332,15,0.00684306569343,320,0.14598540146,343,0.15647810219,1849,0.84352189781,1371,0.62545620438,058,Mecklenburg,37119058
Mecklenburg,2197,1391,0.633136094675,277,0.126081019572,13,0.00591715976331,80,0.0364132908512,379,0.172507965407,57,0.0259444697315,301,26,26,301,327,24,0.0109239872553,301,0.137005006827,554,0.252162039144,1643,0.747837960856,1260,0.573509330906,059,Mecklenburg,37119059
Mecklenburg,2903,281,0.0967964174991,2355,0.811229762315,9,0.00310024112987,50,0.0172235618326,143,0.0492593868412,65,0.0223906303824,2402,22,9,2389,2411,47,0.0161901481226,2402,0.827419910437,254,0.0874956941095,2649,0.91250430589,208,0.0716500172236,060,Mecklenburg,37119060
Mecklenburg,4234,2021,0.477326405291,1479,0.349315068493,21,0.0049598488427,201,0.047472838923,399,0.0942371280113,113,0.0266887104393,1532,37,30,1525,1562,53,0.0125177137459,1532,0.361832782239,690,0.162966461974,3544,0.837033538026,1806,0.426547000472,061,Mecklenburg,37119061
Mecklenburg,5117,1272,0.248583154192,2019,0.394567129177,41,0.00801250732851,236,0.046120773891,1400,0.273597811218,149,0.0291186241939,2099,68,53,2084,2152,80,0.015634160641,2099,0.410201289818,2140,0.418213797147,2977,0.581786202853,685,0.133867500489,062,Mecklenburg,37119062
Mecklenburg,4226,1429,0.338144817795,1737,0.411026975864,43,0.0101751064837,234,0.0553715097018,665,0.157359204922,118,0.0279223852343,1791,65,50,1776,1841,54,0.0127780407004,1791,0.423805016564,1362,0.322290582111,2864,0.677709417889,857,0.202792238523,063,Mecklenburg,37119063
Mecklenburg,1965,1090,0.554707379135,580,0.295165394402,13,0.00661577608142,83,0.0422391857506,123,0.0625954198473,76,0.0386768447837,608,15,14,607,622,28,0.0142493638677,608,0.30941475827,389,0.19796437659,1576,0.80203562341,876,0.445801526718,064,Mecklenburg,37119064
Mecklenburg,1810,1489,0.822651933702,160,0.0883977900552,3,0.00165745856354,80,0.0441988950276,45,0.024861878453,33,0.0182320441989,173,7,7,173,180,13,0.00718232044199,173,0.0955801104972,86,0.0475138121547,1724,0.952486187845,1444,0.797790055249,065,Mecklenburg,37119065
Mecklenburg,1933,1657,0.857216761511,158,0.0817382307294,9,0.00465597516813,45,0.0232798758407,17,0.00879461976203,47,0.0243145369891,173,19,13,167,186,15,0.00775995861355,173,0.089498189343,72,0.0372478013451,1861,0.962752198655,1614,0.834971546818,066,Mecklenburg,37119066
Mecklenburg,1846,1739,0.942036836403,55,0.0297941495125,3,0.00162513542795,13,0.00704225352113,17,0.0092091007584,19,0.010292524377,65,8,7,64,72,10,0.00541711809317,65,0.0352112676056,48,0.0260021668472,1798,0.973997833153,1707,0.924702058505,067,Mecklenburg,37119067
Mecklenburg,3088,1465,0.474417098446,1196,0.387305699482,6,0.00194300518135,73,0.0236398963731,210,0.0680051813472,138,0.044689119171,1281,52,17,1246,1298,85,0.0275259067358,1281,0.414831606218,380,0.123056994819,2708,0.876943005181,1350,0.437176165803,068,Mecklenburg,37119068
Mecklenburg,5121,4512,0.88107791447,195,0.0380785002929,10,0.00195274360476,244,0.0476469439563,71,0.0138644795938,89,0.0173794180824,225,28,19,216,244,30,0.00585823081429,225,0.0439367311072,178,0.0347588361648,4943,0.965241163835,4391,0.857449716852,069,Mecklenburg,37119069
Mecklenburg,2599,2458,0.945748364756,41,0.0157752981916,5,0.00192381685264,60,0.0230858022316,8,0.00307810696422,27,0.0103886110042,47,13,12,46,59,6,0.00230858022316,47,0.0180838784148,50,0.0192381685264,2549,0.980761831474,2414,0.928818776452,070,Mecklenburg,37119070
Mecklenburg,3035,2317,0.763426688633,323,0.106425041186,8,0.00263591433278,274,0.0902800658979,58,0.0191103789127,55,0.0181219110379,356,27,21,350,377,33,0.0108731466227,356,0.117298187809,200,0.0658978583196,2835,0.93410214168,2214,0.729489291598,071,Mecklenburg,37119071
Mecklenburg,1921,1729,0.900052056221,69,0.0359187922957,7,0.00364393545029,40,0.0208224882874,41,0.0213430504945,35,0.0182196772514,79,18,16,77,95,10,0.00520562207184,79,0.0411244143675,122,0.0635085892764,1799,0.936491410724,1664,0.866215512754,072,Mecklenburg,37119072
Mecklenburg,2253,1954,0.867288060364,169,0.075011096316,6,0.00266311584554,64,0.0284065690191,23,0.0102086107412,37,0.0164225477142,184,16,15,183,199,15,0.00665778961385,184,0.0816688859299,92,0.0408344429649,2161,0.959165557035,1893,0.840213049268,073,Mecklenburg,37119073
Mecklenburg,3259,2883,0.884627186253,148,0.0454127032832,9,0.00276158330776,123,0.0377416385394,36,0.0110463332311,60,0.0184105553851,170,15,14,169,184,22,0.00675053697453,170,0.0521632402577,129,0.0395826940779,3130,0.960417305922,2808,0.861613992022,074,Mecklenburg,37119074
Mecklenburg,3873,3539,0.913761941647,133,0.0343403046734,10,0.00258197779499,82,0.0211722179189,42,0.010844306739,67,0.0172992512264,156,28,19,147,175,23,0.00593854892848,156,0.0402788536019,137,0.0353730957914,3736,0.964626904209,3449,0.890524141492,075,Mecklenburg,37119075
Mecklenburg,3480,3153,0.906034482759,144,0.0413793103448,1,0.000287356321839,69,0.0198275862069,46,0.0132183908046,67,0.0192528735632,169,19,13,163,182,25,0.00718390804598,169,0.0485632183908,136,0.0390804597701,3344,0.96091954023,3070,0.882183908046,076,Mecklenburg,37119076
Mecklenburg,4690,674,0.143710021322,2731,0.582302771855,53,0.0113006396588,46,0.00980810234542,1036,0.220895522388,150,0.0319829424307,2786,78,65,2773,2851,55,0.0117270788913,2786,0.594029850746,1730,0.368869936034,2960,0.631130063966,180,0.0383795309168,077,Mecklenburg,37119077
Mecklenburg,3509,1025,0.292106013109,1290,0.367626104303,34,0.00968937019094,731,0.208321459105,335,0.0954687945284,94,0.0267882587632,1337,64,44,1317,1381,47,0.0133941293816,1337,0.381020233685,600,0.170988885722,2909,0.829011114278,829,0.236249643773,078.1,Mecklenburg,37119078.1
Mecklenburg,3004,1209,0.402463382157,978,0.325565912117,33,0.0109853528628,424,0.141145139814,263,0.0875499334221,97,0.0322902796272,1024,47,42,1019,1066,46,0.0153129161119,1024,0.340878828229,473,0.157456724368,2531,0.842543275632,1054,0.35086551265,079,Mecklenburg,37119079
Mecklenburg,4647,1763,0.379384549172,2148,0.462233699161,19,0.00408865935012,321,0.0690768237573,253,0.0544437271358,143,0.0307725414246,2225,105,54,2174,2279,77,0.0165698299978,2225,0.478803529159,565,0.121583817517,4082,0.878416182483,1529,0.329029481386,080,Mecklenburg,37119080
Mecklenburg,6799,1686,0.247977643771,4110,0.604500661862,68,0.0100014708045,394,0.0579496984851,370,0.0544197676129,171,0.0251507574643,4228,147,98,4179,4326,118,0.0173554934549,4228,0.621856155317,785,0.115458155611,6014,0.884541844389,1393,0.20488307104,081,Mecklenburg,37119081
Mecklenburg,7304,1310,0.179353778751,3822,0.523274917853,57,0.00780394304491,75,0.0102683461117,1805,0.247124863089,235,0.0321741511501,3928,132,87,3883,4015,106,0.0145125958379,3928,0.537787513691,2887,0.39526286966,4417,0.60473713034,429,0.058734939759,082,Mecklenburg,37119082
Mecklenburg,5110,2485,0.486301369863,1732,0.338943248532,31,0.00606653620352,197,0.0385518590998,471,0.0921722113503,194,0.0379647749511,1850,80,54,1824,1904,118,0.0230919765166,1850,0.362035225049,904,0.176908023483,4206,0.823091976517,2146,0.419960861057,083,Mecklenburg,37119083
Mecklenburg,5016,1410,0.281100478469,2153,0.429226475279,55,0.0109649122807,155,0.0309011164274,1083,0.215909090909,160,0.0318979266348,2237,104,77,2210,2314,84,0.0167464114833,2237,0.445972886762,1619,0.322767145136,3397,0.677232854864,1016,0.202551834131,084,Mecklenburg,37119084
Mecklenburg,3317,2357,0.71058185107,681,0.205305999397,15,0.00452215857703,72,0.0217063611697,109,0.0328610189931,83,0.0250226107929,732,43,23,712,755,51,0.0153753391619,732,0.220681338559,247,0.0744648779017,3070,0.925535122098,2220,0.6692794694,085,Mecklenburg,37119085
Mecklenburg,2517,2379,0.945172824791,37,0.0147000397298,0,0.0,69,0.0274135876043,2,0.000794596742153,30,0.0119189511323,48,4,3,47,51,11,0.00437028208184,48,0.0190703218117,32,0.0127135478745,2485,0.987286452126,2351,0.934048470401,086,Mecklenburg,37119086
Mecklenburg,4248,3128,0.736346516008,551,0.129708097928,13,0.00306026365348,129,0.0303672316384,297,0.0699152542373,130,0.0306026365348,605,44,35,596,640,54,0.0127118644068,605,0.142419962335,648,0.152542372881,3600,0.847457627119,2804,0.660075329567,087,Mecklenburg,37119087
Mecklenburg,4301,3353,0.779586142757,409,0.0950941641479,16,0.00372006510114,180,0.0418507323878,209,0.0485933503836,134,0.031155545222,472,49,39,462,511,63,0.0146477563357,472,0.109741920484,569,0.132294815159,3732,0.867705184841,3068,0.713322483143,088,Mecklenburg,37119088
Mecklenburg,8936,3969,0.444158460161,3996,0.447179946285,57,0.00637869292748,186,0.0208146821844,513,0.0574082363474,215,0.0240599820949,4152,127,86,4111,4238,156,0.0174574753805,4152,0.464637421665,955,0.106871083259,7981,0.893128916741,3663,0.409914950761,089,Mecklenburg,37119089
Mecklenburg,2043,1804,0.883015173764,106,0.0518844836025,4,0.00195790504161,54,0.0264317180617,33,0.0161527165932,42,0.0205580029369,115,19,17,113,132,9,0.00440528634361,115,0.0562897699462,140,0.0685266764562,1903,0.931473323544,1714,0.838962310328,090,Mecklenburg,37119090
Mecklenburg,5864,5016,0.855388813097,263,0.0448499317872,20,0.00341064120055,394,0.0671896316508,50,0.00852660300136,121,0.0206343792633,308,43,36,301,344,45,0.00767394270123,308,0.0525238744884,231,0.0393929058663,5633,0.960607094134,4840,0.825375170532,091,Mecklenburg,37119091
Mecklenburg,4247,3441,0.810218978102,400,0.0941841299741,10,0.00235460324935,195,0.0459147633624,118,0.0277843183424,83,0.0195432069696,431,28,22,425,453,31,0.00729927007299,431,0.101483400047,333,0.0784082882034,3914,0.921591711797,3246,0.76430421474,092,Mecklenburg,37119092
Mecklenburg,2373,1998,0.841972187105,123,0.0518331226296,8,0.00337126000843,118,0.0497260851243,80,0.0337126000843,46,0.0193847450485,145,30,21,136,166,22,0.00927096502318,145,0.0611040876528,193,0.0813316477033,2180,0.918668352297,1888,0.795617361989,093,Mecklenburg,37119093
Mecklenburg,3355,1440,0.429210134128,1303,0.388375558867,44,0.0131147540984,118,0.0351713859911,318,0.09478390462,132,0.0393442622951,1383,87,58,1354,1441,80,0.0238450074516,1383,0.412220566319,609,0.181520119225,2746,0.818479880775,1208,0.360059612519,094,Mecklenburg,37119094
Mecklenburg,3466,1044,0.301211771495,1703,0.491344489325,27,0.00778995960762,124,0.0357761107905,439,0.126658972879,129,0.0372186959031,1783,61,40,1762,1823,80,0.0230813618003,1783,0.514425851125,709,0.204558568956,2757,0.795441431044,842,0.242931332949,095,Mecklenburg,37119095
Mecklenburg,2454,2131,0.868378158109,164,0.0668296658517,5,0.00203748981255,41,0.0167074164629,60,0.0244498777506,53,0.021597392013,184,12,11,183,195,20,0.0081499592502,184,0.0749796251019,155,0.0631621841891,2299,0.936837815811,2033,0.828443357783,096,Mecklenburg,37119096
Mecklenburg,2366,910,0.384615384615,1168,0.493660185968,12,0.0050718512257,47,0.019864750634,156,0.0659340659341,73,0.030853761623,1219,38,21,1202,1240,51,0.0215553677092,1219,0.515215553677,337,0.142434488588,2029,0.857565511412,767,0.324175824176,097,Mecklenburg,37119097
Mecklenburg,7567,2288,0.302365534558,2491,0.329192546584,65,0.00858992995903,182,0.0240518038853,2170,0.286771507863,371,0.0490286771508,2597,121,104,2580,2701,106,0.0140081934717,2597,0.343200740056,4313,0.569974890974,3254,0.430025109026,612,0.0808774943835,098,Mecklenburg,37119098
Mecklenburg,4866,1669,0.342992190711,2119,0.435470612413,32,0.006576243321,157,0.0322646937937,679,0.139539662968,210,0.0431565967941,2259,96,53,2216,2312,140,0.0287710645294,2259,0.464241676942,1031,0.211878339499,3835,0.788121660501,1325,0.27229757501,099,Mecklenburg,37119099
Mecklenburg,3853,3052,0.792110044121,321,0.0833117051648,9,0.00233584220088,314,0.0814949390086,65,0.0168699714508,92,0.0238774980535,364,36,26,354,390,43,0.0111601349598,364,0.0944718401246,214,0.0555411367765,3639,0.944458863223,2903,0.753438878796,100,Mecklenburg,37119100
Mecklenburg,3804,2962,0.77865404837,382,0.100420609884,16,0.00420609884332,163,0.0428496319664,211,0.0554679284963,70,0.0184016824395,399,32,27,394,426,17,0.00446898002103,399,0.104889589905,443,0.116456361725,3361,0.883543638275,2759,0.725289169295,101,Mecklenburg,37119101
Mecklenburg,7502,3564,0.475073313783,2534,0.337776592909,29,0.00386563583045,268,0.0357238069848,819,0.109170887763,288,0.0383897627299,2687,105,63,2645,2750,153,0.0203945614503,2687,0.358171154359,1456,0.194081578246,6046,0.805918421754,3060,0.407891229006,102,Mecklenburg,37119102
Mecklenburg,4050,3673,0.906913580247,115,0.0283950617284,8,0.00197530864198,163,0.0402469135802,35,0.00864197530864,56,0.0138271604938,128,24,23,127,151,13,0.00320987654321,128,0.0316049382716,179,0.0441975308642,3871,0.955802469136,3528,0.871111111111,103,Mecklenburg,37119103
Mecklenburg,5121,754,0.147236867799,3469,0.677406756493,29,0.00566295645382,177,0.0345635618043,513,0.100175746924,179,0.0349541105253,3582,83,49,3548,3631,113,0.0220660027338,3582,0.699472759227,946,0.184729545011,4175,0.815270454989,425,0.0829916032025,104,Mecklenburg,37119104
Mecklenburg,6212,2591,0.417095943335,2626,0.422730199614,36,0.00579523502898,372,0.0598840952994,366,0.0589182227946,221,0.0355763039279,2760,99,51,2712,2811,134,0.0215711526079,2760,0.444301352222,703,0.113168061816,5509,0.886831938184,2352,0.378622021893,105,Mecklenburg,37119105
Mecklenburg,2115,1863,0.88085106383,155,0.0732860520095,13,0.00614657210402,28,0.0132387706856,32,0.0151300236407,24,0.0113475177305,171,20,16,167,187,16,0.00756501182033,171,0.0808510638298,86,0.0406619385343,2029,0.959338061466,1818,0.859574468085,106,Mecklenburg,37119106
Mecklenburg,4998,1707,0.341536614646,2567,0.513605442177,14,0.00280112044818,293,0.0586234493798,275,0.0550220088035,142,0.0284113645458,2664,57,30,2637,2694,97,0.0194077631052,2664,0.533013205282,500,0.100040016006,4498,0.899959983994,1537,0.307523009204,107.1,Mecklenburg,37119107.1
Mecklenburg,5619,1149,0.204484783769,2717,0.483537996085,64,0.0113899270333,344,0.0612208578039,1142,0.2032390105,203,0.0361274248087,2832,117,83,2798,2915,115,0.0204662751379,2832,0.504004271223,1867,0.332265527674,3752,0.667734472326,627,0.111585691404,108,Mecklenburg,37119108
Mecklenburg,2456,2249,0.915716612378,99,0.0403094462541,5,0.00203583061889,32,0.0130293159609,33,0.0134364820847,38,0.0154723127036,114,13,10,111,124,15,0.00610749185668,114,0.0464169381107,80,0.0325732899023,2376,0.967426710098,2207,0.898615635179,109,Mecklenburg,37119109
Mecklenburg,1782,1550,0.869809203143,106,0.0594837261504,4,0.00224466891134,54,0.030303030303,33,0.0185185185185,35,0.0196408529742,121,6,5,120,126,15,0.00841750841751,121,0.0679012345679,114,0.0639730639731,1668,0.936026936027,1485,0.833333333333,110,Mecklenburg,37119110
Mecklenburg,3118,2812,0.901860166774,123,0.0394483643361,3,0.00096215522771,107,0.0343168697883,28,0.00898011545863,45,0.0144323284157,141,16,9,134,150,18,0.00577293136626,141,0.0452212957024,79,0.0253367543297,3039,0.97466324567,2767,0.887427838358,111,Mecklenburg,37119111
Mecklenburg,2888,2563,0.887465373961,115,0.0398199445983,5,0.00173130193906,141,0.0488227146814,25,0.00865650969529,39,0.0135041551247,139,8,7,138,146,24,0.00831024930748,139,0.0481301939058,108,0.0373961218837,2780,0.962603878116,2487,0.861149584488,112,Mecklenburg,37119112
Mecklenburg,4472,3948,0.88282647585,234,0.0523255813953,9,0.00201252236136,194,0.0433810375671,37,0.00827370304114,50,0.0111806797853,251,22,15,244,266,17,0.00380143112701,251,0.0561270125224,154,0.0344364937388,4318,0.965563506261,3840,0.858676207513,113,Mecklenburg,37119113
Mecklenburg,3736,3416,0.914346895075,166,0.0444325481799,12,0.00321199143469,56,0.0149892933619,30,0.00802997858672,56,0.0149892933619,189,16,13,186,202,23,0.00615631691649,189,0.0505888650964,124,0.0331905781585,3612,0.966809421842,3340,0.894004282655,114,Mecklenburg,37119114
Mecklenburg,2764,1273,0.460564399421,973,0.352026049204,39,0.0141099855282,42,0.0151953690304,344,0.124457308249,93,0.0336468885673,1015,66,51,1000,1066,42,0.0151953690304,1015,0.367221418234,627,0.226845151954,2137,0.773154848046,1046,0.378437047757,115,Mecklenburg,37119115
Mecklenburg,2781,813,0.292340884574,1405,0.505213951816,36,0.0129449838188,69,0.024811218986,349,0.125494426465,109,0.0391945343402,1476,77,51,1450,1527,71,0.0255303847537,1476,0.53074433657,670,0.240920532183,2111,0.759079467817,576,0.2071197411,116,Mecklenburg,37119116
Mecklenburg,3578,1387,0.387646730017,1714,0.479038569033,10,0.00279485746227,73,0.0204024594746,274,0.0765790944662,120,0.0335382895472,1790,37,20,1773,1810,76,0.0212409167132,1790,0.500279485746,528,0.147568474008,3050,0.852431525992,1180,0.329793180548,117,Mecklenburg,37119117
Mecklenburg,4558,3581,0.78565160158,427,0.0936814392277,12,0.00263273365511,343,0.0752523036419,99,0.0217200526547,96,0.0210618692409,468,39,26,455,494,41,0.00899517332163,468,0.102676612549,278,0.0609916630101,4280,0.93900833699,3416,0.749451513822,118,Mecklenburg,37119118
Mecklenburg,2103,1813,0.862101759391,207,0.0984308131241,3,0.00142653352354,40,0.0190204469805,17,0.00808368996671,23,0.0109367570138,214,9,7,212,221,7,0.00332857822159,214,0.101759391346,51,0.0242510699001,2052,0.9757489301,1778,0.845458868283,119,Mecklenburg,37119119
Mecklenburg,6414,2003,0.312285625195,2486,0.387589647646,35,0.00545681322108,248,0.0386654193951,1340,0.208917991893,302,0.0470845026505,2601,95,76,2582,2677,115,0.017929529155,2601,0.405519176801,2600,0.405363267852,3814,0.594636732148,1022,0.159338946056,120,Mecklenburg,37119120
Mecklenburg,4633,4078,0.880207209152,232,0.0500755450032,9,0.00194258579754,198,0.0427368875459,38,0.00820202892294,78,0.0168357435787,273,21,17,269,290,41,0.00884955752212,273,0.0589251025254,160,0.0345348586229,4473,0.965465141377,3954,0.853442693719,121,Mecklenburg,37119121
Mecklenburg,7980,4707,0.58984962406,2110,0.264411027569,35,0.00438596491228,396,0.0496240601504,459,0.0575187969925,273,0.0342105263158,2269,90,52,2231,2321,159,0.0199248120301,2269,0.284335839599,1157,0.144987468672,6823,0.855012531328,4131,0.517669172932,122,Mecklenburg,37119122
Mecklenburg,3481,1038,0.298190175237,1782,0.511921861534,14,0.00402183280666,118,0.0338983050847,373,0.10715311692,156,0.0448147084171,1867,61,37,1843,1904,85,0.0244182706119,1867,0.536340132146,644,0.185004309107,2837,0.814995690893,863,0.247917265154,123,Mecklenburg,37119123
Mecklenburg,4056,848,0.209072978304,2534,0.624753451677,36,0.00887573964497,84,0.0207100591716,393,0.0968934911243,161,0.0396942800789,2631,98,62,2595,2693,97,0.0239151873767,2631,0.648668639053,704,0.173570019724,3352,0.826429980276,639,0.157544378698,124,Mecklenburg,37119124
Mecklenburg,2356,969,0.411290322581,975,0.413837011885,11,0.00466893039049,73,0.0309847198642,251,0.106536502547,77,0.0326825127334,1023,28,15,1010,1038,48,0.0203735144312,1023,0.434210526316,553,0.234719864177,1803,0.765280135823,703,0.298387096774,125,Mecklenburg,37119125
Mecklenburg,4710,1033,0.21932059448,2769,0.587898089172,20,0.00424628450106,536,0.113800424628,234,0.0496815286624,118,0.0250530785563,2857,56,24,2825,2881,88,0.0186836518047,2857,0.606581740977,395,0.083864118896,4315,0.916135881104,896,0.190233545648,126,Mecklenburg,37119126
Mecklenburg,4976,4630,0.930466237942,98,0.0196945337621,8,0.0016077170418,87,0.0174839228296,67,0.0134646302251,86,0.0172829581994,132,24,24,132,156,34,0.00683279742765,132,0.0265273311897,195,0.0391881028939,4781,0.960811897106,4513,0.906953376206,127,Mecklenburg,37119127
Mecklenburg,4131,2564,0.620672960542,1130,0.273541515372,12,0.00290486564996,237,0.0573710965868,82,0.0198499152748,106,0.0256596465747,1189,35,21,1175,1210,59,0.0142822561123,1189,0.287823771484,244,0.0590656015493,3887,0.940934398451,2431,0.588477366255,128,Mecklenburg,37119128
Mecklenburg,2756,1638,0.594339622642,643,0.233309143687,11,0.00399129172714,84,0.0304789550073,290,0.105224963716,90,0.0326560232221,694,25,23,692,717,51,0.0185050798258,694,0.251814223512,728,0.264150943396,2028,0.735849056604,1237,0.448838896952,129,Mecklenburg,37119129
Mecklenburg,2786,1088,0.390524048816,1060,0.380473797559,21,0.00753768844221,150,0.0538406317301,365,0.131012203877,102,0.0366116295765,1120,44,32,1108,1152,60,0.021536252692,1120,0.402010050251,604,0.2167982771,2182,0.7832017229,910,0.326633165829,130,Mecklenburg,37119130
Mecklenburg,2134,1930,0.904404873477,65,0.0304592314902,2,0.000937207122774,108,0.0506091846298,7,0.00328022492971,22,0.0103092783505,74,8,6,72,80,9,0.00421743205248,74,0.0346766635426,57,0.0267104029991,2077,0.973289597001,1880,0.880974695408,131,Mecklenburg,37119131
Mecklenburg,4003,1557,0.388958281289,1086,0.271296527604,62,0.0154883837122,174,0.0434673994504,997,0.249063202598,127,0.031726205346,1153,79,68,1142,1221,67,0.0167374469148,1153,0.288033974519,1567,0.391456407694,2436,0.608543592306,1100,0.274793904572,132,Mecklenburg,37119132
Mecklenburg,5961,5268,0.883744338198,346,0.058043952357,10,0.00167757087737,182,0.0305317899681,46,0.0077168260359,109,0.0182855225633,392,17,16,391,408,46,0.0077168260359,392,0.0657607783929,253,0.0424425431975,5708,0.957557456803,5092,0.854219090757,133,Mecklenburg,37119133
Mecklenburg,8939,7189,0.804228660924,898,0.10045866428,36,0.00402729611813,194,0.0217026513033,394,0.0440765186262,228,0.0255062087482,1006,78,56,984,1062,108,0.0120818883544,1006,0.112540552635,793,0.0887123839356,8146,0.911287616064,6844,0.765633739792,134,Mecklenburg,37119134
Mecklenburg,10926,3427,0.313655500641,5934,0.543108182317,69,0.0063152114223,330,0.0302031850632,859,0.0786198059674,307,0.0280981145891,6163,130,89,6122,6252,229,0.0209591799378,6163,0.564067362255,1703,0.155866739887,9223,0.844133260113,2803,0.25654402343,135,Mecklenburg,37119135
Mecklenburg,2879,2617,0.908996179229,111,0.0385550538381,28,0.00972559916638,65,0.0225772837791,12,0.00416811392845,46,0.015977770059,137,37,37,137,174,26,0.00903091351164,137,0.0475859673498,92,0.0319555401181,2787,0.968044459882,2539,0.881903438694,136,Mecklenburg,37119136
Mecklenburg,7505,6001,0.799600266489,448,0.0596935376416,12,0.00159893404397,858,0.114323784144,65,0.00866089273817,121,0.0161225849434,496,34,25,487,521,48,0.00639573617588,496,0.0660892738175,354,0.0471685542971,7151,0.952831445703,5747,0.765756162558,137,Mecklenburg,37119137
Mecklenburg,4922,1742,0.353921170256,2135,0.433766761479,34,0.00690776107273,333,0.0676554246241,525,0.106663957741,153,0.0310849248273,2254,67,45,2232,2299,119,0.0241771637546,2254,0.457943925234,1042,0.211702559935,3880,0.788297440065,1298,0.263713937424,138,Mecklenburg,37119138
Mecklenburg,4969,4148,0.834775608774,355,0.0714429462669,12,0.00241497283156,308,0.0619843026766,48,0.00965989132622,98,0.0197222781244,390,30,17,377,407,35,0.0070436707587,390,0.0784866170256,290,0.0583618434293,4679,0.941638156571,3934,0.791708593278,139.1,Mecklenburg,37119139.1
Mecklenburg,8225,5998,0.729240121581,829,0.100790273556,23,0.00279635258359,977,0.118784194529,208,0.0252887537994,190,0.0231003039514,910,63,40,887,950,81,0.00984802431611,910,0.110638297872,531,0.0645592705167,7694,0.935440729483,5707,0.693860182371,140,Mecklenburg,37119140
Mecklenburg,6990,4096,0.585979971388,1518,0.217167381974,29,0.00414878397711,825,0.118025751073,327,0.0467811158798,195,0.0278969957082,1637,84,40,1593,1677,119,0.0170243204578,1637,0.234191702432,641,0.0917024320458,6349,0.908297567954,3859,0.552074391989,141,Mecklenburg,37119141
Mecklenburg,6765,5764,0.852032520325,539,0.079674796748,15,0.00221729490022,236,0.0348854397635,92,0.0135994087214,119,0.0175905395418,578,44,34,568,612,39,0.00576496674058,578,0.0854397634885,331,0.0489283074649,6434,0.951071692535,5550,0.820399113082,142,Mecklenburg,37119142
Mecklenburg,8009,6886,0.859782744413,525,0.0655512548383,9,0.00112373579723,315,0.039330752903,106,0.0132351105007,168,0.0209764015483,589,52,36,573,625,64,0.00799101011362,589,0.0735422649519,423,0.0528155824697,7586,0.94718441753,6596,0.823573479835,143,Mecklenburg,37119143
Mecklenburg,4763,3884,0.815452445937,359,0.0753726642872,13,0.00272937224438,364,0.0764224228427,44,0.00923787528868,99,0.0207852193995,396,29,26,393,422,37,0.00776821331094,396,0.0831408775982,179,0.0375813562881,4584,0.962418643712,3772,0.791937854294,144,Mecklenburg,37119144
Mecklenburg,13193,8616,0.653073599636,3222,0.24422041992,40,0.00303191086182,691,0.052376260138,283,0.0214507693474,341,0.025847040097,3405,134,73,3344,3478,183,0.0138709921928,3405,0.258091412112,770,0.05836428409,12423,0.94163571591,8228,0.623664064277,145,Mecklenburg,37119145
Mecklenburg,7725,2156,0.279093851133,3444,0.445825242718,32,0.00414239482201,1526,0.197540453074,281,0.0363754045307,286,0.0370226537217,3610,91,48,3567,3658,166,0.0214886731392,3610,0.467313915858,666,0.086213592233,7059,0.913786407767,1901,0.246084142395,146,Mecklenburg,37119146
Mecklenburg,6607,2019,0.305584985621,2895,0.438171636143,47,0.00711366732254,579,0.0876343272287,847,0.12819736643,220,0.0332980172544,3000,97,65,2968,3065,105,0.0158922355078,3000,0.454063871651,1605,0.242924171333,5002,0.757075828667,1412,0.213712728924,147,Mecklenburg,37119147
Mecklenburg,12572,8881,0.706411072224,1299,0.103324848871,37,0.00294304804327,1800,0.143175310213,249,0.0198059179128,306,0.0243398027362,1413,78,60,1395,1473,114,0.00906776964683,1413,0.112392618517,942,0.0749284123449,11630,0.925071587655,8272,0.657970092269,148,Mecklenburg,37119148
Mecklenburg,6349,2152,0.338951015908,3097,0.487793353284,25,0.00393762797291,389,0.0612694912585,487,0.0767049929123,199,0.0313435186644,3228,46,30,3212,3258,131,0.020633170578,3228,0.508426523862,932,0.14679477083,5417,0.85320522917,1840,0.289809418806,149,Mecklenburg,37119149
Mecklenburg,4743,2427,0.511701454775,1896,0.399746995572,23,0.00484925152857,137,0.0288846721484,158,0.033312249631,102,0.0215053763441,1963,48,32,1947,1995,67,0.0141260805397,1963,0.413873076112,327,0.0689437065149,4416,0.931056293485,2289,0.482605945604,150,Mecklenburg,37119150
Mecklenburg,5479,2427,0.442964044534,2335,0.426172659244,13,0.0023726957474,233,0.0425260083957,274,0.0500091257529,197,0.035955466326,2457,53,35,2439,2492,122,0.0222668370141,2457,0.448439496258,595,0.108596459208,4884,0.891403540792,2185,0.398795400621,151,Mecklenburg,37119151
Mecklenburg,3181,1899,0.596982081107,506,0.159069475008,21,0.00660169757938,179,0.0562716127004,465,0.146180446401,111,0.0348946872053,547,52,42,537,589,41,0.0128890286074,547,0.171958503615,775,0.243634077334,2406,0.756365922666,1646,0.517447343603,200,Mecklenburg,37119200
Mecklenburg,8996,4452,0.494886616274,3320,0.369052912406,53,0.00589150733659,158,0.017563361494,742,0.0824811027123,271,0.0301244997777,3491,118,71,3444,3562,171,0.0190084481992,3491,0.388061360605,1291,0.143508225878,7705,0.856491774122,4027,0.447643397065,201,Mecklenburg,37119201
Mecklenburg,9696,7947,0.819616336634,956,0.098597359736,37,0.00381600660066,250,0.0257838283828,290,0.0299092409241,216,0.0222772277228,1046,82,69,1033,1115,90,0.00928217821782,1046,0.107879537954,859,0.0885932343234,8837,0.911406765677,7449,0.768254950495,202,Mecklenburg,37119202
Mecklenburg,8109,2986,0.368232827722,4030,0.49697866568,29,0.00357627327661,209,0.0257738315452,520,0.0641262794426,335,0.0413121223332,4259,112,59,4206,4318,229,0.0282402269084,4259,0.525218892588,1206,0.1487236404,6903,0.8512763596,2468,0.304353187816,203,Mecklenburg,37119203
Mecklenburg,6639,2193,0.330320831451,3637,0.54782346739,22,0.0033137520711,311,0.0468444042778,282,0.0424762765477,194,0.0292212682633,3758,61,26,3723,3784,121,0.018225636391,3758,0.566049103781,684,0.103027564392,5955,0.896972435608,1913,0.288145805091,204.1,Mecklenburg,37119204.1
Mecklenburg,4489,2192,0.488304744932,1552,0.345734016485,13,0.00289596792159,177,0.0394297170862,417,0.092893740254,138,0.0307418133215,1621,42,29,1608,1650,69,0.0153709066607,1621,0.361104923145,792,0.176431276454,3697,0.823568723546,1893,0.421697482736,205,Mecklenburg,37119205
Mecklenburg,6672,5614,0.841426858513,603,0.0903776978417,18,0.00269784172662,213,0.0319244604317,111,0.0166366906475,113,0.0169364508393,647,37,30,640,677,44,0.00659472422062,647,0.0969724220624,315,0.0472122302158,6357,0.952787769784,5434,0.814448441247,206,Mecklenburg,37119206
Mecklenburg,7416,6084,0.820388349515,649,0.0875134843581,54,0.00728155339806,148,0.0199568500539,346,0.0466558791802,135,0.0182038834951,703,94,84,693,787,54,0.00728155339806,703,0.0947950377562,994,0.134034519957,6422,0.865965480043,5519,0.744201725998,207,Mecklenburg,37119207
Mecklenburg,5644,5285,0.936392629341,142,0.0251594613749,9,0.00159461374911,97,0.0171863926293,49,0.0086817859674,62,0.0109851169383,163,19,18,162,181,21,0.0037207654146,163,0.0288802267895,132,0.0233876683203,5512,0.97661233168,5212,0.923458540043,208,Mecklenburg,37119208
Mecklenburg,6263,5027,0.802650486987,800,0.12773431263,34,0.00542870828676,100,0.0159667890787,165,0.0263452019799,137,0.0218745010378,858,84,69,843,927,58,0.00926073766566,858,0.136995050295,415,0.0662621746767,5848,0.933737825323,4803,0.766884879451,209,Mecklenburg,37119209
Mecklenburg,8605,1399,0.16257989541,6274,0.729110981987,30,0.00348634514817,156,0.0181289947705,485,0.0563625798954,261,0.0303312027891,6450,133,64,6381,6514,176,0.0204532248693,6450,0.749564206856,902,0.104822777455,7703,0.895177222545,1122,0.130389308542,210,Mecklenburg,37119210
Mecklenburg,10353,4897,0.473002994301,4231,0.408673814353,46,0.00444315657297,438,0.0423065778035,449,0.0433690717666,292,0.0282043852024,4411,134,79,4356,4490,180,0.0173862648508,4411,0.426060079204,1062,0.10257896262,9291,0.89742103738,4418,0.426736211726,211,Mecklenburg,37119211
Mecklenburg,15216,6109,0.401485278654,5909,0.388341219769,70,0.00460042060988,2233,0.146753417455,403,0.026485278654,492,0.032334384858,6135,163,97,6069,6232,226,0.0148527865405,6135,0.403194006309,1034,0.0679547844374,14182,0.932045215563,5631,0.370070977918,212,Mecklenburg,37119212
Mecklenburg,6977,1404,0.201232621471,4351,0.62362046725,60,0.00859968467823,343,0.0491615307439,634,0.0908700014333,185,0.0265156944245,4488,103,68,4453,4556,137,0.019635946682,4488,0.643256413931,975,0.139744876021,6002,0.860255123979,1183,0.169557116239,213,Mecklenburg,37119213
Mecklenburg,4469,2228,0.498545535914,1805,0.403893488476,21,0.00469903781607,208,0.0465428507496,83,0.0185723875587,124,0.0277466994853,1889,52,36,1873,1925,84,0.0187961512643,1889,0.42268963974,215,0.0481091966883,4254,0.951890803312,2137,0.478183038711,214,Mecklenburg,37119214
Mecklenburg,5010,3933,0.78502994012,550,0.109780439122,10,0.00199600798403,314,0.0626746506986,85,0.0169660678643,118,0.0235528942116,619,31,24,612,643,69,0.0137724550898,619,0.123552894212,236,0.0471057884232,4774,0.952894211577,3790,0.756487025948,215,Mecklenburg,37119215
Mecklenburg,6378,4634,0.726560050172,948,0.14863593603,27,0.00423330197554,347,0.0544057698338,257,0.0402947632487,165,0.0258701787394,1040,54,47,1033,1087,92,0.0144245845093,1040,0.163060520539,593,0.0929758544998,5785,0.9070241455,4352,0.682345562872,216,Mecklenburg,37119216
Mecklenburg,4186,3179,0.759436215958,644,0.153846153846,10,0.00238891543239,163,0.038939321548,110,0.0262780697563,80,0.0191113234591,681,27,19,673,700,37,0.00883898709986,681,0.162685140946,343,0.0819397993311,3843,0.918060200669,2972,0.709985666507,217,Mecklenburg,37119217
Mecklenburg,3636,3160,0.869086908691,244,0.0671067106711,13,0.00357535753575,58,0.0159515951595,100,0.027502750275,61,0.0167766776678,269,29,29,269,298,25,0.00687568756876,269,0.0739823982398,216,0.0594059405941,3420,0.940594059406,3057,0.840759075908,218,Mecklenburg,37119218
Mecklenburg,3234,2434,0.752628324057,366,0.113172541744,33,0.0102040816327,140,0.04329004329,204,0.0630797773655,57,0.0176252319109,401,42,35,394,436,35,0.0108225108225,401,0.123995052566,320,0.0989486703772,2914,0.901051329623,2338,0.722943722944,219,Mecklenburg,37119219
Mecklenburg,3764,3230,0.858129649309,284,0.0754516471838,15,0.00398512221041,102,0.0270988310308,86,0.0228480340064,47,0.0124867162593,306,26,24,304,330,22,0.00584484590861,306,0.0812964930925,197,0.0523379383634,3567,0.947662061637,3133,0.832359192349,220,Mecklenburg,37119220
Mecklenburg,5710,5041,0.882837127846,340,0.0595446584939,25,0.00437828371278,141,0.0246935201401,86,0.015061295972,77,0.0134851138354,356,58,56,354,412,16,0.00280210157618,356,0.0623467600701,273,0.0478108581436,5437,0.952189141856,4873,0.853415061296,221,Mecklenburg,37119221
Mecklenburg,9269,2916,0.31459704391,5318,0.573740425073,54,0.00582587118351,310,0.0334448160535,371,0.0400258927608,300,0.0323659510195,5521,150,89,5460,5610,203,0.0219009601899,5521,0.595641385263,711,0.0767073039163,8558,0.923292696084,2699,0.291185672672,222,Mecklenburg,37119222
Mecklenburg,8790,4862,0.553128555176,3178,0.361547212742,20,0.00227531285552,272,0.030944254835,219,0.0249146757679,239,0.0271899886234,3330,101,49,3278,3379,152,0.0172923777019,3330,0.378839590444,500,0.0568828213879,8290,0.943117178612,4643,0.528213879408,223.1,Mecklenburg,37119223.1
Mecklenburg,4037,2279,0.564528114937,1163,0.288085211791,29,0.00718355214268,220,0.0544959128065,223,0.0552390388903,123,0.0304681694327,1239,56,40,1223,1279,76,0.0188258607877,1239,0.306911072579,418,0.103542234332,3619,0.896457765668,2111,0.522913054248,224,Mecklenburg,37119224
Mecklenburg,2274,1720,0.7563764292,291,0.127968337731,17,0.00747581354442,76,0.0334212840809,135,0.0593667546174,35,0.0153913808267,313,25,22,310,335,22,0.00967458223395,313,0.137642919965,289,0.127088830255,1985,0.872911169745,1574,0.692172383465,225,Mecklenburg,37119225
Mecklenburg,5273,4080,0.773753081737,646,0.122510904608,17,0.0032239711739,258,0.0489285036981,149,0.0282571591125,123,0.02332637967,707,48,30,689,737,61,0.0115683671534,707,0.134079271762,402,0.0762374359947,4871,0.923762564005,3849,0.729945002845,226,Mecklenburg,37119226
Mecklenburg,7842,6308,0.804386636062,582,0.0742157612854,30,0.00382555470543,658,0.0839071665391,86,0.0109665901556,178,0.0226982912522,658,68,52,642,710,76,0.00969140525376,658,0.0839071665391,523,0.0666921703647,7319,0.933307829635,5902,0.752614129049,227,Mecklenburg,37119227
Mecklenburg,6081,2902,0.477224140766,1894,0.311461930604,10,0.00164446637066,530,0.0871567176451,566,0.0930767965795,179,0.0294359480349,2003,55,29,1977,2032,109,0.0179246834402,2003,0.329386614044,1228,0.201940470317,4853,0.798059529683,2332,0.383489557639,228,Mecklenburg,37119228
Mecklenburg,8598,5589,0.650034891835,1843,0.214352174924,43,0.00500116306118,518,0.0602465689695,349,0.0405908350779,256,0.0297743661317,1965,97,61,1929,2026,122,0.0141893463596,1965,0.228541521284,1030,0.119795301233,7568,0.880204698767,5050,0.587345894394,229,Mecklenburg,37119229
Mecklenburg,9345,4343,0.464740502943,2935,0.314071696094,52,0.0055644729802,903,0.0966292134831,818,0.0875334403424,294,0.0314606741573,3078,106,74,3046,3152,143,0.0153023006956,3078,0.32937399679,1751,0.187372926699,7594,0.812627073301,3584,0.383520599251,230,Mecklenburg,37119230
Mecklenburg,6473,4121,0.636644523405,1175,0.181523250425,23,0.00355322107215,451,0.0696740305886,514,0.0794067665688,189,0.0291982079407,1238,62,52,1228,1290,63,0.00973273598023,1238,0.191255986405,1053,0.162675729955,5420,0.837324270045,3672,0.567279468562,231,Mecklenburg,37119231
Mecklenburg,6793,5373,0.790961283674,470,0.0691888708965,19,0.00279699690858,639,0.0940674223465,114,0.0167819814515,178,0.0262034447225,536,56,38,518,574,66,0.00971588399823,536,0.0789047548947,488,0.0718386574415,6305,0.928161342559,5046,0.742823494774,232,Mecklenburg,37119232
Mecklenburg,5109,4712,0.922293990996,112,0.021922098258,2,0.000391466040321,217,0.0424740653748,21,0.00411039342337,45,0.00880798590722,122,4,4,122,126,10,0.00195733020161,122,0.0238794284596,99,0.0193775689959,5010,0.980622431004,4634,0.907026815424,233,Mecklenburg,37119233
Mecklenburg,5638,3624,0.64278112806,1131,0.200603050727,40,0.00709471443774,93,0.0164952110678,565,0.100212841433,185,0.0328130542746,1242,79,62,1225,1304,111,0.0196878325647,1242,0.220290883292,978,0.173465768003,4660,0.826534231997,3267,0.579460801703,234,Mecklenburg,37119234
Mecklenburg,5194,3039,0.585098190219,1385,0.266653831344,45,0.00866384289565,102,0.0196380438968,446,0.085868309588,177,0.0340777820562,1492,81,58,1469,1550,107,0.0206006931074,1492,0.287254524451,845,0.162687716596,4349,0.837312283404,2725,0.524643819792,235,Mecklenburg,37119235
Mecklenburg,5192,4631,0.891949152542,281,0.0541217257319,39,0.00751155624037,90,0.0173343605547,76,0.0146379044684,75,0.0144453004622,297,66,64,295,361,16,0.00308166409861,297,0.0572033898305,213,0.0410246533128,4979,0.958975346687,4512,0.869029275809,236,Mecklenburg,37119236
Mecklenburg,6335,2559,0.403946329913,2782,0.439147592739,23,0.00363062352013,266,0.0419889502762,480,0.0757695343331,225,0.0355169692186,2922,84,50,2888,2972,140,0.0220994475138,2922,0.461247040253,817,0.128966061563,5518,0.871033938437,2322,0.366535122336,237,Mecklenburg,37119237
Mecklenburg,4160,2723,0.654567307692,1065,0.256009615385,12,0.00288461538462,192,0.0461538461538,66,0.0158653846154,102,0.0245192307692,1131,33,17,1115,1148,66,0.0158653846154,1131,0.271875,264,0.0634615384615,3896,0.936538461538,2550,0.612980769231,238.1,Mecklenburg,37119238.1
Mecklenburg,4584,2134,0.465532286213,1556,0.339441535777,12,0.00261780104712,628,0.136998254799,100,0.021815008726,154,0.033595113438,1636,47,24,1613,1660,80,0.0174520069808,1636,0.356893542757,315,0.0687172774869,4269,0.931282722513,1994,0.434991273997,239,Mecklenburg,37119239
Mecklenburg,6751,6095,0.902829210487,282,0.0417715893942,20,0.00296252407051,164,0.0242926973782,107,0.0158495037772,83,0.0122944748926,312,40,35,307,347,30,0.00444378610576,312,0.0462153754999,286,0.0423640942083,6465,0.957635905792,5942,0.880165901348,240,Mecklenburg,37119240
Mecklenburg,5961,4608,0.773024660292,902,0.151316893139,16,0.00268411340379,159,0.0266733769502,152,0.025499077336,124,0.0208018788794,959,43,29,945,988,57,0.00956215400101,959,0.16087904714,379,0.0635799362523,5582,0.936420063748,4409,0.739640999832,241,Mecklenburg,37119241
Mecklenburg,3341,3112,0.931457647411,111,0.0332235857528,10,0.00299311583358,68,0.0203531876684,12,0.0035917390003,28,0.00838072433403,118,21,21,118,139,7,0.00209518108351,118,0.0353187668363,59,0.0176593834181,3282,0.982340616582,3067,0.91798862616,242,Mecklenburg,37119242
Mecklenburg,11571,6488,0.56071212514,3173,0.274220032841,53,0.00458041655864,696,0.0601503759398,782,0.0675827499784,379,0.032754299542,3354,124,90,3320,3444,181,0.0156425546625,3354,0.289862587503,1847,0.159623195921,9724,0.840376804079,5666,0.489672457005,243,Mecklenburg,37119243
Mitchell,1810,1749,0.966298342541,9,0.00497237569061,6,0.00331491712707,0,0.0,17,0.00939226519337,29,0.0160220994475,10,20,20,10,30,1,0.000552486187845,10,0.00552486187845,31,0.0171270718232,1779,0.982872928177,1742,0.962430939227,01,Mitchell,3712101
Mitchell,399,397,0.994987468672,0,0.0,0,0.0,0,0.0,0,0.0,2,0.00501253132832,0,2,2,0,2,0,0.0,0,0.0,0,0.0,399,1.0,397,0.994987468672,02,Mitchell,3712102
Mitchell,771,757,0.981841763943,1,0.00129701686122,0,0.0,1,0.00129701686122,0,0.0,12,0.0155642023346,1,7,7,1,8,0,0.0,1,0.00129701686122,2,0.00259403372244,769,0.997405966278,755,0.97924773022,03,Mitchell,3712103
Mitchell,8267,7763,0.939034716342,41,0.00495947744043,47,0.00568525462683,40,0.00483851457603,311,0.0376194508286,65,0.00786258618604,55,80,79,54,134,14,0.00169348010161,55,0.00665295754203,475,0.0574573605903,7792,0.94254263941,7629,0.922825692512,04,Mitchell,3712104
Mitchell,1179,1158,0.982188295165,1,0.000848176420696,1,0.000848176420696,3,0.00254452926209,8,0.00678541136556,8,0.00678541136556,1,7,7,1,8,0,0.0,1,0.000848176420696,14,0.0118744698897,1165,0.98812553011,1152,0.977099236641,05,Mitchell,3712105
Mitchell,774,724,0.935400516796,3,0.00387596899225,7,0.00904392764858,2,0.00258397932817,27,0.0348837209302,11,0.0142118863049,5,15,15,5,20,2,0.00258397932817,5,0.00645994832041,41,0.0529715762274,733,0.947028423773,714,0.922480620155,06,Mitchell,3712106
Mitchell,239,237,0.991631799163,0,0.0,0,0.0,0,0.0,0,0.0,2,0.00836820083682,0,2,2,0,2,0,0.0,0,0.0,3,0.0125523012552,236,0.987447698745,234,0.979079497908,07,Mitchell,3712107
Mitchell,361,356,0.986149584488,0,0.0,0,0.0,0,0.0,1,0.00277008310249,4,0.01108033241,3,1,1,3,4,3,0.00831024930748,3,0.00831024930748,8,0.0221606648199,353,0.97783933518,350,0.969529085873,08,Mitchell,3712108
Mitchell,1779,1703,0.957279370433,3,0.00168634064081,4,0.00224845418775,5,0.00281056773468,33,0.0185497470489,31,0.017425519955,5,24,24,5,29,2,0.00112422709387,5,0.00281056773468,57,0.0320404721754,1722,0.967959527825,1683,0.946037099494,09,Mitchell,3712109
Montgomery,2885,1649,0.57157712305,490,0.169844020797,6,0.00207972270364,21,0.00727902946274,674,0.233622183709,45,0.0155979202773,513,12,8,509,521,23,0.00797227036395,513,0.177816291161,961,0.333102253033,1924,0.666897746967,1390,0.481802426343,BIS,Montgomery,37123BIS
Montgomery,3326,1852,0.556825015033,505,0.151834034877,31,0.00932050511124,13,0.00390859891762,825,0.248045700541,100,0.0300661455201,557,45,35,547,592,52,0.0156343956705,557,0.167468430547,1294,0.389055923031,2032,0.610944076969,1466,0.440769693325,CAN,Montgomery,37123CAN
Montgomery,993,795,0.800604229607,131,0.13192346425,3,0.00302114803625,0,0.0,52,0.0523665659617,12,0.012084592145,142,5,4,141,146,11,0.0110775427996,142,0.143001007049,86,0.0866062437059,907,0.913393756294,771,0.776435045317,CHE,Montgomery,37123CHE
Montgomery,1873,1830,0.977042178324,16,0.00854244527496,5,0.00266951414842,5,0.00266951414842,3,0.00160170848905,14,0.00747463961559,17,8,8,17,25,1,0.000533902829685,17,0.00907634810464,5,0.00266951414842,1868,0.997330485852,1828,0.975974372664,ELD,Montgomery,37123ELD
Montgomery,826,786,0.951573849879,19,0.0230024213075,1,0.00121065375303,6,0.00726392251816,7,0.00847457627119,7,0.00847457627119,24,2,2,24,26,5,0.00605326876513,24,0.0290556900726,12,0.0145278450363,814,0.985472154964,781,0.945520581114,LIT,Montgomery,37123LIT
Montgomery,2279,911,0.399736726634,1269,0.556823168056,10,0.00438788942519,39,0.0171127687582,23,0.0100921456779,27,0.011847301448,1285,19,18,1284,1303,16,0.0070206230803,1285,0.563843791136,48,0.0210618692409,2231,0.978938130759,902,0.395787626152,MTG,Montgomery,37123MTG
Montgomery,453,445,0.98233995585,0,0.0,1,0.00220750551876,4,0.00883002207506,1,0.00220750551876,2,0.00441501103753,1,1,1,1,2,1,0.00220750551876,1,0.00220750551876,6,0.0132450331126,447,0.986754966887,440,0.971302428256,OPH,Montgomery,37123OPH
Montgomery,1420,1180,0.830985915493,141,0.0992957746479,6,0.00422535211268,63,0.0443661971831,15,0.0105633802817,15,0.0105633802817,152,13,10,149,162,11,0.00774647887324,152,0.107042253521,24,0.0169014084507,1396,0.983098591549,1174,0.82676056338,PEE,Montgomery,37123PEE
Montgomery,1941,693,0.357032457496,781,0.402369912416,7,0.00360638845956,15,0.00772797527048,415,0.213807315817,30,0.015455950541,802,13,8,797,810,21,0.0108191653787,802,0.413189077795,624,0.321483771252,1317,0.678516228748,500,0.257599175683,ROC,Montgomery,37123ROC
Montgomery,2929,2588,0.883578012974,155,0.0529190850119,7,0.00238989416183,16,0.00546261522704,113,0.038579720041,50,0.0170706725845,171,19,17,169,188,16,0.00546261522704,171,0.058381700239,346,0.118129054285,2583,0.881870945715,2387,0.814953909184,STA,Montgomery,37123STA
Montgomery,3410,2241,0.657184750733,838,0.245747800587,8,0.00234604105572,70,0.0205278592375,195,0.0571847507331,58,0.017008797654,881,20,14,875,895,43,0.0126099706745,881,0.258357771261,344,0.100879765396,3066,0.899120234604,2105,0.617302052786,T1,Montgomery,37123T1
Montgomery,2883,2114,0.733263961152,598,0.207422823448,27,0.00936524453694,21,0.00728407908429,102,0.0353798126951,21,0.00728407908429,612,35,30,607,642,14,0.00485605272286,612,0.212278876171,143,0.0496011099549,2740,0.950398890045,2070,0.718002081165,T2,Montgomery,37123T2
Montgomery,1839,1725,0.938009787928,31,0.0168569874932,7,0.00380641653072,56,0.0304513322458,9,0.00489396411093,11,0.00598151169114,33,9,9,33,42,2,0.00108754758021,33,0.0179445350734,21,0.0114192495922,1818,0.988580750408,1714,0.932028276237,UWH,Montgomery,37123UWH
Montgomery,741,353,0.476383265857,257,0.346828609987,1,0.00134952766532,115,0.155195681511,5,0.00674763832659,10,0.0134952766532,260,8,7,259,267,3,0.00404858299595,260,0.350877192982,12,0.0161943319838,729,0.983805668016,347,0.468286099865,WAD,Montgomery,37123WAD
Moore,3319,2346,0.706839409461,586,0.17655920458,20,0.0060259114191,14,0.00421813799337,313,0.0943055137089,40,0.0120518228382,605,38,31,598,636,19,0.00572461584815,605,0.182283820428,422,0.127146730943,2897,0.872853269057,2249,0.677613739078,BEN,Moore,37125BEN
Moore,3877,3233,0.833892184679,414,0.106783595564,48,0.012380706732,15,0.00386897085375,68,0.017539334537,99,0.0255352076348,464,86,81,459,545,50,0.0128965695125,464,0.119680165076,211,0.0544235233428,3666,0.945576476657,3116,0.80371421202,CAM,Moore,37125CAM
Moore,7093,5659,0.79782884534,1137,0.160298886226,62,0.00874101226561,47,0.00662625123361,53,0.00747215564641,135,0.019032849288,1199,121,110,1188,1309,62,0.00874101226561,1199,0.169039898491,196,0.0276328774848,6897,0.972367122515,5548,0.782179613704,CAR,Moore,37125CAR
Moore,2754,2348,0.852578068264,236,0.0856935366739,12,0.00435729847495,17,0.00617283950617,108,0.0392156862745,33,0.0119825708061,251,18,18,251,269,15,0.00544662309368,251,0.0911401597676,279,0.101307189542,2475,0.898692810458,2207,0.801379811184,DHR,Moore,37125DHR
Moore,3398,2263,0.665979988228,858,0.252501471454,91,0.0267804590936,62,0.0182460270747,48,0.014125956445,76,0.0223660977045,898,112,102,888,1000,40,0.0117716303708,898,0.264273101825,166,0.0488522660388,3232,0.951147733961,2171,0.638905238376,EAB,Moore,37125EAB
Moore,4164,3894,0.935158501441,97,0.0232949087416,11,0.00264169068204,56,0.0134486071085,33,0.00792507204611,73,0.0175312199808,112,31,29,110,141,15,0.0036023054755,112,0.0268972142171,153,0.0367435158501,4011,0.96325648415,3800,0.912584053794,EUR,Moore,37125EUR
Moore,2137,1627,0.761347683669,352,0.16471689284,24,0.0112306972391,10,0.00467945718297,56,0.0262049602246,68,0.0318203088442,379,43,34,370,413,27,0.012634534394,379,0.177351427234,123,0.0575573233505,2014,0.94244267665,1582,0.740290126345,EWD,Moore,37125EWD
Moore,3892,3582,0.920349434738,187,0.0480472764645,15,0.00385405960946,30,0.00770811921891,33,0.0084789311408,45,0.0115621788284,202,29,27,200,229,15,0.00385405960946,202,0.051901336074,103,0.0264645426516,3789,0.973535457348,3518,0.903905447071,KWD,Moore,37125KWD
Moore,3760,3030,0.80585106383,383,0.101861702128,45,0.0119680851064,42,0.011170212766,128,0.0340425531915,132,0.0351063829787,432,101,90,421,522,49,0.0130319148936,432,0.114893617021,291,0.0773936170213,3469,0.922606382979,2912,0.774468085106,LTR,Moore,37125LTR
Moore,3081,2586,0.839337877313,313,0.10159039273,15,0.00486854917235,19,0.00616682895164,107,0.0347289840961,41,0.0133073677377,335,26,20,329,355,22,0.00714053878611,335,0.108730931516,214,0.0694579681921,2867,0.930542031808,2488,0.80753002272,NSP,Moore,37125NSP
Moore,3486,2215,0.635398737808,860,0.246701090075,79,0.0226620768789,35,0.0100401606426,202,0.0579460699943,95,0.0272518646013,915,105,94,904,1009,55,0.0157773952955,915,0.26247848537,308,0.0883534136546,3178,0.911646586345,2129,0.610728628801,PBF,Moore,37125PBF
Moore,4176,3700,0.88601532567,282,0.0675287356322,13,0.00311302681992,65,0.0155651340996,43,0.0102969348659,73,0.0174808429119,302,27,22,297,324,20,0.00478927203065,302,0.0723180076628,141,0.0337643678161,4035,0.966235632184,3613,0.865181992337,PDN,Moore,37125PDN
Moore,5597,5152,0.920493121315,271,0.0484187957835,26,0.00464534572092,63,0.0112560300161,30,0.00536001429337,55,0.00982669287118,293,43,37,287,330,22,0.00393067714847,293,0.0523494729319,103,0.0184027157406,5494,0.981597284259,5085,0.908522422726,PHA,Moore,37125PHA
Moore,3056,2813,0.920484293194,145,0.0474476439791,14,0.00458115183246,42,0.0137434554974,7,0.00229057591623,35,0.0114528795812,160,32,28,156,188,15,0.00490837696335,160,0.0523560209424,51,0.0166884816754,3005,0.983311518325,2771,0.906740837696,PHB1,Moore,37125PHB1
Moore,2539,2415,0.951161874754,56,0.0220559275305,8,0.00315084679007,36,0.0141788105553,7,0.00275699094132,17,0.00669554942891,59,15,14,58,73,3,0.00118156754628,59,0.0232374950768,30,0.0118156754628,2509,0.988184324537,2394,0.94289090193,PHB2,Moore,37125PHB2
Moore,4426,3948,0.892001807501,294,0.066425666516,26,0.00587437867149,55,0.0124265702666,36,0.0081337550836,67,0.0151378219611,318,46,38,310,356,24,0.00542250338906,318,0.0718481699051,131,0.0295978309986,4295,0.970402169001,3862,0.872571170357,PHC,Moore,37125PHC
Moore,2923,2059,0.704413274034,190,0.0650017105713,16,0.00547382825864,26,0.00889497092029,589,0.201505302771,43,0.0147109134451,217,27,24,214,241,27,0.00923708518645,217,0.0742387957578,1066,0.364693807732,1857,0.635306192268,1614,0.55217242559,RBN,Moore,37125RBN
Moore,4841,4566,0.943193555051,138,0.0285065069201,9,0.00185912001653,36,0.0074364800661,40,0.008262755629,52,0.0107415823177,157,35,21,143,178,19,0.00392480892378,157,0.0324313158438,107,0.0221028713076,4734,0.977897128692,4500,0.929560008263,SLS,Moore,37125SLS
Moore,4347,1777,0.408787669657,2400,0.552104899931,44,0.0101219231654,34,0.00782148608236,24,0.00552104899931,68,0.0156429721647,2457,74,46,2429,2503,57,0.0131124913734,2457,0.565217391304,125,0.0287554635381,4222,0.971244536462,1702,0.391534391534,SSP,Moore,37125SSP
Moore,808,305,0.377475247525,485,0.600247524752,3,0.00371287128713,6,0.00742574257426,2,0.00247524752475,7,0.00866336633663,488,5,5,488,493,3,0.00371287128713,488,0.60396039604,7,0.00866336633663,801,0.991336633663,299,0.37004950495,TLT,Moore,37125TLT
Moore,3128,2439,0.779731457801,356,0.113810741688,51,0.0163043478261,10,0.00319693094629,205,0.065537084399,67,0.0214194373402,384,76,70,378,454,28,0.00895140664962,384,0.122762148338,373,0.119245524297,2755,0.880754475703,2294,0.733375959079,VSS,Moore,37125VSS
Moore,5447,3908,0.717459151827,1135,0.208371580687,63,0.0115659996328,83,0.015237745548,112,0.020561777125,146,0.0268037451808,1210,111,89,1188,1299,75,0.0137690471819,1210,0.222140627869,339,0.0622360932623,5108,0.937763906738,3717,0.682393978337,WAB,Moore,37125WAB
Moore,2982,2710,0.908786049631,159,0.0533199195171,6,0.00201207243461,5,0.00167672702884,93,0.0311871227364,9,0.00301810865191,163,8,8,163,171,4,0.00134138162307,163,0.0546613011402,137,0.0459423205902,2845,0.95405767941,2670,0.8953722334,WEM,Moore,37125WEM
Moore,3016,2338,0.775198938992,505,0.167440318302,31,0.0102785145889,10,0.00331564986737,89,0.0295092838196,43,0.0142572944297,518,52,47,513,565,13,0.00431034482759,518,0.17175066313,185,0.0613395225464,2831,0.938660477454,2246,0.744694960212,WND,Moore,37125WND
Nash,4397,2834,0.64453036161,935,0.212644985217,19,0.00432112804185,10,0.00227427791676,506,0.115078462588,93,0.0211507846259,990,35,26,981,1016,55,0.0125085285422,990,0.225153513759,754,0.171480554924,3643,0.828519445076,2652,0.603138503525,0001,Nash,371270001
Nash,1525,738,0.48393442623,726,0.47606557377,8,0.00524590163934,1,0.000655737704918,22,0.0144262295082,30,0.0196721311475,748,30,15,733,763,22,0.0144262295082,748,0.490491803279,56,0.0367213114754,1469,0.963278688525,727,0.476721311475,0002,Nash,371270002
Nash,2030,1265,0.62315270936,642,0.316256157635,18,0.00886699507389,11,0.00541871921182,55,0.0270935960591,39,0.0192118226601,673,32,21,662,694,31,0.0152709359606,673,0.331527093596,90,0.0443349753695,1940,0.955665024631,1252,0.616748768473,0003,Nash,371270003
Nash,3625,3206,0.884413793103,216,0.0595862068966,15,0.00413793103448,3,0.000827586206897,146,0.040275862069,39,0.0107586206897,224,29,28,223,252,8,0.00220689655172,224,0.0617931034483,254,0.0700689655172,3371,0.929931034483,3124,0.861793103448,0004,Nash,371270004
Nash,3702,2296,0.620205294435,931,0.251485683414,37,0.00999459751486,14,0.00378173960022,351,0.0948136142626,73,0.0197190707726,970,63,49,956,1019,39,0.0105348460292,970,0.262020529444,560,0.151269584009,3142,0.848730415991,2132,0.575904916261,0005,Nash,371270005
Nash,2946,2087,0.708418194162,531,0.180244399185,11,0.00373387644263,6,0.0020366598778,257,0.0872369314325,54,0.0183299389002,559,43,29,545,588,28,0.00950441276307,559,0.189748811948,362,0.122878479294,2584,0.877121520706,1988,0.674813306178,0006,Nash,371270006
Nash,2890,1090,0.377162629758,1624,0.561937716263,63,0.0217993079585,2,0.000692041522491,58,0.0200692041522,53,0.018339100346,1670,89,67,1648,1737,46,0.0159169550173,1670,0.57785467128,78,0.0269896193772,2812,0.973010380623,1077,0.372664359862,0007,Nash,371270007
Nash,3143,1891,0.601654470251,499,0.158765510659,22,0.00699968183264,2,0.000636334712059,677,0.215399300032,52,0.0165447025135,520,39,33,514,553,21,0.00668151447661,520,0.165447025135,1033,0.328666878778,2110,0.671333121222,1577,0.501749920458,0008,Nash,371270008
Nash,4246,2259,0.53203014602,1661,0.391191709845,28,0.0065944418276,13,0.00306170513424,203,0.0478097032501,82,0.0193122939237,1711,67,46,1690,1757,50,0.0117757889779,1711,0.402967498822,288,0.0678285445125,3958,0.932171455488,2197,0.517428167687,0011,Nash,371270011
Nash,1103,833,0.755213055304,212,0.192203082502,2,0.00181323662738,3,0.00271985494107,42,0.038077969175,11,0.00997280145059,217,5,5,217,222,5,0.00453309156845,217,0.196736174071,48,0.0435176790571,1055,0.956482320943,829,0.751586582049,0012,Nash,371270012
Nash,10238,6000,0.586051963274,3890,0.379957022856,61,0.00595819495995,41,0.00400468841571,113,0.011037311975,133,0.0129908185192,3998,128,74,3944,4072,108,0.0105489353389,3998,0.390505958195,222,0.0216839226411,10016,0.978316077359,5926,0.57882398906,0015,Nash,371270015
Nash,1097,349,0.318140382862,704,0.641750227894,2,0.00182315405652,3,0.00273473108478,21,0.0191431175934,18,0.0164083865087,721,11,3,713,724,17,0.0154968094804,721,0.657247037375,27,0.024612579763,1070,0.975387420237,349,0.318140382862,0021,Nash,371270021
Nash,1374,629,0.457787481805,700,0.509461426492,17,0.0123726346434,3,0.00218340611354,3,0.00218340611354,22,0.0160116448326,711,23,23,711,734,11,0.0080058224163,711,0.517467248908,15,0.0109170305677,1359,0.989082969432,623,0.453420669578,0022,Nash,371270022
Nash,5931,4284,0.722306525038,1404,0.236722306525,23,0.00387792952285,49,0.00826167593998,104,0.0175349856685,67,0.0112965773057,1436,46,44,1434,1480,32,0.0053953802057,1436,0.242117686731,199,0.0335525206542,5732,0.966447479346,4194,0.707132018209,0025,Nash,371270025
Nash,3922,3426,0.87353391127,374,0.0953595104539,43,0.0109637939827,17,0.00433452320245,31,0.00790413054564,31,0.00790413054564,388,62,52,378,440,14,0.00356960734319,388,0.098929117797,66,0.0168281489036,3856,0.983171851096,3395,0.865629780724,0026,Nash,371270026
Nash,1942,566,0.291452111226,1250,0.643666323378,26,0.0133882595263,44,0.0226570545829,11,0.00566426364573,45,0.0231719876416,1274,45,34,1263,1308,24,0.0123583934089,1274,0.656024716787,41,0.0211122554068,1901,0.978887744593,544,0.280123583934,0031,Nash,371270031
Nash,2536,1012,0.39905362776,1423,0.561119873817,14,0.00552050473186,19,0.00749211356467,51,0.0201104100946,17,0.00670347003155,1437,19,16,1434,1453,14,0.00552050473186,1437,0.566640378549,74,0.0291798107256,2462,0.970820189274,993,0.391561514196,0032,Nash,371270032
Nash,3265,498,0.152526799387,2684,0.822052067381,19,0.00581929555896,23,0.00704441041348,10,0.00306278713629,31,0.00949464012251,2708,37,25,2696,2733,24,0.00735068912711,2708,0.829402756508,46,0.014088820827,3219,0.985911179173,482,0.147626339969,0033,Nash,371270033
Nash,5422,1134,0.209147915898,4083,0.753043157506,26,0.00479527849502,24,0.00442641091848,62,0.0114348948727,93,0.0171523423091,4157,57,32,4132,4189,74,0.013648100332,4157,0.766691257838,109,0.0201032829214,5313,0.979896717079,1109,0.204537071191,0034,Nash,371270034
Nash,4419,3136,0.709662819642,1075,0.243267707626,10,0.00226295541978,49,0.0110884815569,85,0.0192351210681,64,0.0144829146866,1114,21,15,1108,1129,39,0.00882552613714,1114,0.252093233763,161,0.0364335822584,4258,0.963566417742,3084,0.69789545146,0035,Nash,371270035
Nash,3665,2247,0.61309686221,1228,0.335061391542,17,0.00463847203274,36,0.00982264665757,61,0.0166439290587,76,0.0207366984993,1279,44,26,1261,1305,51,0.0139154160982,1279,0.34897680764,119,0.0324693042292,3546,0.967530695771,2205,0.601637107776,0036,Nash,371270036
Nash,4865,2716,0.558273381295,1776,0.365056526208,38,0.00781089414183,120,0.0246659815005,146,0.0300102774923,69,0.0141829393628,1815,61,49,1803,1864,39,0.00801644398767,1815,0.373072970195,269,0.0552929085303,4596,0.94470709147,2630,0.540596094553,0037,Nash,371270037
Nash,4048,1803,0.44540513834,1981,0.489377470356,46,0.0113636363636,81,0.0200098814229,41,0.010128458498,96,0.0237154150198,2039,78,55,2016,2094,58,0.0143280632411,2039,0.503705533597,132,0.0326086956522,3916,0.967391304348,1749,0.432065217391,0038,Nash,371270038
Nash,3304,2311,0.699455205811,775,0.234564164649,13,0.00393462469734,25,0.00756658595642,120,0.0363196125908,60,0.0181598062954,802,29,25,798,827,27,0.00817191283293,802,0.242736077482,230,0.069612590799,3074,0.930387409201,2223,0.672820823245,0039,Nash,371270039
Nash,8533,3714,0.435251377007,3947,0.462557131138,72,0.00843782960272,156,0.0182819641392,462,0.0541427399508,182,0.0213289581624,4061,122,88,4027,4149,114,0.013359896871,4061,0.475917028009,701,0.0821516465487,7832,0.917848353451,3544,0.415328723778,0040,Nash,371270040
Nash,1672,1207,0.721889952153,379,0.226674641148,7,0.00418660287081,11,0.00657894736842,39,0.0233253588517,29,0.0173444976077,399,23,13,389,412,20,0.011961722488,399,0.238636363636,81,0.0484449760766,1591,0.951555023923,1165,0.696770334928,0041,Nash,371270041
New Hanover,5118,3240,0.63305978898,1500,0.293083235639,47,0.00918327471669,33,0.00644783118406,168,0.0328253223916,130,0.0254005470887,1569,100,79,1548,1648,69,0.0134818288394,1569,0.306565064478,325,0.0635013677218,4793,0.936498632278,3119,0.609417741305,CF01,New Hanover,37129CF01
New Hanover,4559,3444,0.75542882211,791,0.173502961176,51,0.011186663742,18,0.0039482342619,175,0.0383856108796,80,0.0175477078307,831,74,68,825,899,40,0.00877385391533,831,0.182276815091,361,0.0791840315859,4198,0.920815968414,3279,0.719236674709,CF02,New Hanover,37129CF02
New Hanover,8711,6829,0.78395132591,1415,0.162438296407,51,0.0058546665136,122,0.0140052806796,108,0.0123981173229,186,0.0213523131673,1522,97,84,1509,1606,107,0.0122833199403,1522,0.174721616347,343,0.0393755022385,8368,0.960624497761,6643,0.762599012743,CF03,New Hanover,37129CF03
New Hanover,11361,10277,0.90458586392,552,0.0485872722472,72,0.00633747029311,129,0.0113546342752,128,0.0112666138544,203,0.0178681454097,622,121,108,609,730,70,0.00616142945163,622,0.0547487016988,365,0.0321274535692,10996,0.967872546431,10089,0.888038024822,FP01,New Hanover,37129FP01
New Hanover,3341,3212,0.961388805747,22,0.00658485483388,27,0.00808141275067,15,0.00448967375037,23,0.00688416641724,42,0.012571086501,36,44,44,36,80,14,0.00419036216702,36,0.0107752170009,65,0.0194552529183,3276,0.980544747082,3180,0.951810835079,FP02,New Hanover,37129FP02
New Hanover,2012,1952,0.970178926441,17,0.00844930417495,7,0.00347912524851,12,0.00596421471173,7,0.00347912524851,17,0.00844930417495,23,14,13,22,36,6,0.00298210735586,23,0.0114314115308,36,0.0178926441352,1976,0.982107355865,1923,0.955765407555,FP03,New Hanover,37129FP03
New Hanover,5387,4915,0.912381659551,296,0.054947094858,30,0.00556896231669,30,0.00556896231669,41,0.00761091516614,75,0.0139224057917,328,49,47,326,375,32,0.00594022647113,328,0.0608873213291,97,0.0180063114906,5290,0.981993688509,4863,0.902728791535,FP04,New Hanover,37129FP04
New Hanover,2372,2278,0.960370994941,19,0.00801011804384,13,0.00548060708263,10,0.00421585160202,13,0.00548060708263,39,0.0164418212479,32,32,30,30,62,13,0.00548060708263,32,0.0134907251265,31,0.0130691399663,2341,0.986930860034,2260,0.952782462057,FP05,New Hanover,37129FP05
New Hanover,2556,1830,0.715962441315,456,0.178403755869,15,0.00586854460094,37,0.014475743349,164,0.0641627543036,54,0.0211267605634,483,28,24,479,507,27,0.0105633802817,483,0.18896713615,243,0.0950704225352,2313,0.904929577465,1765,0.690532081377,H01,New Hanover,37129H01
New Hanover,3841,3635,0.946368133299,67,0.0174433741213,12,0.00312418640979,34,0.0088518614944,60,0.0156209320489,33,0.00859151262692,68,21,20,67,88,1,0.000260348867482,68,0.0177037229888,140,0.0364488414475,3701,0.963551158552,3562,0.927362665972,H02,New Hanover,37129H02
New Hanover,6972,6104,0.875502008032,235,0.0337062535858,43,0.00616752725186,75,0.0107573149742,404,0.0579460699943,111,0.0159208261618,264,68,66,262,330,29,0.00415949512335,264,0.0378657487091,848,0.121629374641,6124,0.878370625359,5722,0.820711417097,H03,New Hanover,37129H03
New Hanover,4473,4056,0.906773977197,216,0.0482897384306,22,0.0049183992846,36,0.00804828973843,82,0.0183322155153,61,0.0136373798346,248,41,33,240,281,32,0.00715403532305,248,0.0554437737536,260,0.0581265369998,4213,0.941873463,3935,0.879722781131,H04,New Hanover,37129H04
New Hanover,4435,4020,0.906426155581,122,0.0275084554679,31,0.00698985343856,31,0.00698985343856,113,0.0254791431793,118,0.0266065388952,142,92,88,138,230,20,0.00450958286359,142,0.0320180383315,349,0.0786922209696,4086,0.92130777903,3850,0.86809470124,H05,New Hanover,37129H05
New Hanover,4155,3353,0.80697954272,512,0.123225030084,32,0.00770156438026,48,0.0115523465704,132,0.0317689530686,78,0.0187725631769,549,49,43,543,592,37,0.00890493381468,549,0.132129963899,241,0.0580024067389,3914,0.941997593261,3257,0.783874849579,H06,New Hanover,37129H06
New Hanover,13202,10421,0.78935009847,1869,0.141569459173,39,0.00295409786396,257,0.0194667474625,345,0.0261324041812,271,0.0205271928496,1999,83,68,1984,2067,130,0.00984699287987,1999,0.151416452053,742,0.0562036055143,12460,0.943796394486,10093,0.764505377973,H07,New Hanover,37129H07
New Hanover,6766,6388,0.94413242684,120,0.0177357375111,24,0.00354714750222,78,0.0115282293822,46,0.00679869937925,110,0.0162577593852,150,57,49,142,199,30,0.00443393437777,150,0.0221696718889,175,0.0258646172037,6591,0.974135382796,6287,0.929204847768,H08,New Hanover,37129H08
New Hanover,8401,7816,0.930365432687,269,0.0320199976193,15,0.00178550172599,153,0.018212117605,56,0.00666587311034,92,0.0109510772527,281,39,36,278,317,12,0.00142840138079,281,0.0334483990001,171,0.0203547196762,8230,0.979645280324,7710,0.917747887156,H09,New Hanover,37129H09
New Hanover,7516,6934,0.922565194252,237,0.0315327301756,24,0.00319318786589,131,0.017429483768,45,0.00598722724854,145,0.0192921766897,289,78,58,269,347,52,0.00691857370942,289,0.038451303885,185,0.0246141564662,7331,0.975385843534,6808,0.905800957956,M02,New Hanover,37129M02
New Hanover,5598,4356,0.778135048232,494,0.0882458020722,33,0.0058949624866,48,0.0085744908896,536,0.0957484816006,131,0.0234012147195,551,59,50,542,601,57,0.0101822079314,551,0.0984280100036,722,0.128974633798,4876,0.871025366202,4229,0.755448374419,M03,New Hanover,37129M03
New Hanover,8033,7001,0.871529939002,551,0.0685920577617,34,0.00423254076933,203,0.0252707581227,72,0.00896302751152,172,0.0214116768331,612,60,54,606,666,61,0.00759367608614,612,0.0761857338479,276,0.0343582721275,7757,0.965641727873,6826,0.849744802689,M04,New Hanover,37129M04
New Hanover,5924,5507,0.929608372721,162,0.027346387576,10,0.0016880486158,101,0.0170492910196,42,0.00708980418636,102,0.0172180958812,197,45,36,188,233,35,0.0059081701553,197,0.0332545577313,137,0.0231262660365,5787,0.976873733964,5427,0.916103983795,M05,New Hanover,37129M05
New Hanover,2640,1037,0.392803030303,1443,0.546590909091,18,0.00681818181818,11,0.00416666666667,40,0.0151515151515,91,0.0344696969697,1503,59,30,1474,1533,60,0.0227272727273,1503,0.569318181818,98,0.0371212121212,2542,0.962878787879,999,0.378409090909,W03,New Hanover,37129W03
New Hanover,2948,1486,0.504070556309,1307,0.443351424695,7,0.00237449118046,19,0.00644504748982,24,0.00814111261872,105,0.0356173677069,1371,57,40,1354,1411,64,0.0217096336499,1371,0.465061058345,106,0.0359565807327,2842,0.964043419267,1451,0.492198100407,W08,New Hanover,37129W08
New Hanover,2452,2003,0.816884176183,310,0.126427406199,13,0.00530179445351,33,0.0134584013051,33,0.0134584013051,60,0.0244698205546,336,35,25,326,361,26,0.010603588907,336,0.137030995106,92,0.0375203915171,2360,0.962479608483,1956,0.797716150082,W12,New Hanover,37129W12
New Hanover,3806,2040,0.535995796111,1123,0.295060430899,26,0.00683131897005,53,0.0139253809774,451,0.118497109827,113,0.029689963216,1183,63,41,1161,1224,60,0.0157645822386,1183,0.310825013137,807,0.212033631109,2999,0.787966368891,1761,0.462690488702,W13,New Hanover,37129W13
New Hanover,8267,3835,0.463892584976,3861,0.467037619451,49,0.00592718035563,82,0.00991895488085,199,0.0240716100157,241,0.0291520503206,4040,108,69,4001,4109,179,0.0216523527277,4040,0.488689972179,414,0.0500786258619,7853,0.949921374138,3687,0.445990081045,W15,New Hanover,37129W15
New Hanover,3865,3504,0.90659767141,164,0.0424320827943,8,0.00206985769728,96,0.0248382923674,32,0.00827943078913,61,0.0157826649418,189,17,16,188,205,25,0.00646830530401,189,0.0489003880983,79,0.0204398447607,3786,0.979560155239,3455,0.893919793014,W16,New Hanover,37129W16
New Hanover,3106,2504,0.806181584031,412,0.132646490663,3,0.000965872504829,91,0.0292981326465,19,0.00611719253059,77,0.024790727624,445,23,18,440,463,33,0.0106245975531,445,0.143271088216,81,0.0260785576304,3025,0.97392144237,2457,0.791049581455,W17,New Hanover,37129W17
New Hanover,2292,2075,0.905322862129,121,0.0527923211169,3,0.00130890052356,20,0.0087260034904,50,0.021815008726,23,0.010034904014,134,9,9,134,143,13,0.00567190226876,134,0.0584642233857,88,0.0383944153578,2204,0.961605584642,2050,0.894415357766,W18,New Hanover,37129W18
New Hanover,4959,4318,0.870740068562,389,0.0784432345231,11,0.00221818915104,77,0.0155273240573,65,0.013107481347,99,0.0199637023593,427,42,33,418,460,38,0.00766283524904,427,0.0861060697721,177,0.0356926799758,4782,0.964307320024,4225,0.851986287558,W21,New Hanover,37129W21
New Hanover,7784,6691,0.859583761562,606,0.077852004111,40,0.00513874614594,139,0.0178571428571,116,0.0149023638232,192,0.0246659815005,679,100,86,665,765,73,0.00937821171634,679,0.0872302158273,383,0.0492034943474,7401,0.950796505653,6467,0.830806783145,W24,New Hanover,37129W24
New Hanover,4313,2072,0.48040806863,2098,0.486436355205,11,0.00255042893578,27,0.00626014375145,22,0.00510085787155,83,0.0192441456063,2139,42,26,2123,2165,41,0.00950614421516,2139,0.49594249942,129,0.0299095757014,4184,0.970090424299,1993,0.462091351727,W25,New Hanover,37129W25
New Hanover,4036,3024,0.749256689792,636,0.157581764123,35,0.00867195242815,44,0.0109018830525,197,0.048810703667,100,0.0247770069376,681,68,60,673,741,45,0.0111496531219,681,0.168731417245,440,0.109018830525,3596,0.890981169475,2844,0.704658077304,W26,New Hanover,37129W26
New Hanover,3906,2472,0.63287250384,1291,0.330517153098,27,0.00691244239631,20,0.00512032770097,52,0.0133128520225,44,0.0112647209421,1319,38,34,1315,1353,28,0.00716845878136,1319,0.337685611879,128,0.0327700972862,3778,0.967229902714,2430,0.622119815668,W27,New Hanover,37129W27
New Hanover,4736,3610,0.762246621622,721,0.152238175676,41,0.00865709459459,81,0.0171030405405,153,0.0323057432432,130,0.0274493243243,788,77,64,775,852,67,0.0141469594595,788,0.166385135135,410,0.0865709459459,4326,0.913429054054,3417,0.721494932432,W28,New Hanover,37129W28
New Hanover,4956,774,0.15617433414,3973,0.801654560129,29,0.00585149313963,4,0.000807102502018,67,0.0135189669088,109,0.02199354318,4049,74,46,4021,4095,76,0.0153349475383,4049,0.816989507667,170,0.0343018563358,4786,0.965698143664,712,0.143664245359,W29,New Hanover,37129W29
New Hanover,6682,4507,0.674498653098,1323,0.197994612391,39,0.00583657587549,70,0.0104759054175,533,0.079766536965,210,0.0314277162526,1434,119,70,1385,1504,111,0.0166117928764,1434,0.214606405268,873,0.130649506136,5809,0.869350493864,4215,0.630799161928,W30,New Hanover,37129W30
New Hanover,4713,4357,0.924464247825,199,0.0422236367494,9,0.00190961171229,56,0.011882028432,31,0.00657755145343,61,0.0129429238277,223,20,18,221,241,24,0.00509229789943,223,0.0473159346488,102,0.0216422660726,4611,0.978357733927,4287,0.909611712285,W31,New Hanover,37129W31
New Hanover,2473,2421,0.9789729074,8,0.00323493732309,4,0.00161746866154,16,0.00646987464618,8,0.00323493732309,16,0.00646987464618,11,12,12,11,23,3,0.00121310149616,11,0.00444803881925,27,0.0109179134654,2446,0.989082086535,2398,0.969672462596,WB,New Hanover,37129WB
Northampton,1293,737,0.569992266048,524,0.405259087394,0,0.0,0,0.0,16,0.0123743232792,16,0.0123743232792,534,8,6,532,540,10,0.0077339520495,534,0.412993039443,31,0.0239752513534,1262,0.976024748647,723,0.559164733179,CONWAY,Northampton,37131CONWAY
Northampton,876,546,0.623287671233,319,0.364155251142,0,0.0,0,0.0,5,0.00570776255708,6,0.00684931506849,325,2,0,323,325,6,0.00684931506849,325,0.37100456621,13,0.0148401826484,863,0.985159817352,540,0.616438356164,CREEKS,Northampton,37131CREEKS
Northampton,935,465,0.497326203209,434,0.464171122995,2,0.00213903743316,0,0.0,24,0.0256684491979,10,0.0106951871658,442,6,4,440,446,8,0.00855614973262,442,0.472727272727,23,0.0245989304813,912,0.975401069519,465,0.497326203209,GALATI,Northampton,37131GALATI
Northampton,2219,219,0.0986931050023,1964,0.885083370888,10,0.00450653447499,3,0.0013519603425,2,0.000901306894998,21,0.00946372239748,1984,17,10,1977,1994,20,0.00901306894998,1984,0.894096439838,15,0.00675980171248,2204,0.993240198288,218,0.0982424515548,GARYSB,Northampton,37131GARYSB
Northampton,4259,1353,0.317680206621,2783,0.653439774595,23,0.00540032871566,14,0.00328715660953,47,0.011035454332,39,0.00915707912656,2815,31,26,2810,2841,32,0.00751350082179,2815,0.660953275417,65,0.0152617985443,4194,0.984738201456,1345,0.315801831416,GASTON,Northampton,37131GASTON
Northampton,993,416,0.418932527694,570,0.574018126888,1,0.00100704934542,0,0.0,3,0.00302114803625,3,0.00302114803625,573,2,1,572,574,3,0.00302114803625,573,0.577039274924,7,0.00704934541793,986,0.992950654582,414,0.416918429003,JACKSO,Northampton,37131JACKSO
Northampton,1611,1027,0.637492240844,543,0.337057728119,9,0.00558659217877,6,0.00372439478585,3,0.00186219739292,23,0.0142768466791,559,17,15,557,574,16,0.00993171942893,559,0.346989447548,15,0.00931098696462,1596,0.990689013035,1020,0.633147113594,LAKE-G,Northampton,37131LAKE-G
Northampton,335,240,0.716417910448,80,0.238805970149,1,0.00298507462687,4,0.0119402985075,4,0.0119402985075,6,0.0179104477612,82,4,3,81,85,2,0.00597014925373,82,0.244776119403,4,0.0119402985075,331,0.988059701493,240,0.716417910448,LASKER,Northampton,37131LASKER
Northampton,585,280,0.478632478632,291,0.497435897436,2,0.0034188034188,2,0.0034188034188,2,0.0034188034188,8,0.0136752136752,293,10,8,291,301,2,0.0034188034188,293,0.500854700855,2,0.0034188034188,583,0.996581196581,279,0.476923076923,MILWAU,Northampton,37131MILWAU
Northampton,873,536,0.613974799542,317,0.363115693013,8,0.00916380297824,0,0.0,6,0.00687285223368,6,0.00687285223368,322,12,9,319,331,5,0.0057273768614,322,0.368843069874,12,0.0137457044674,861,0.986254295533,530,0.607101947308,NEWTOW,Northampton,37131NEWTOW
Northampton,277,128,0.462093862816,146,0.527075812274,0,0.0,0,0.0,0,0.0,3,0.0108303249097,146,2,2,146,148,0,0.0,146,0.527075812274,1,0.00361010830325,276,0.996389891697,128,0.462093862816,PENDLE,Northampton,37131PENDLE
Northampton,591,184,0.311336717428,398,0.673434856176,7,0.0118443316413,0,0.0,0,0.0,2,0.00338409475465,400,8,7,399,407,2,0.00338409475465,400,0.676818950931,1,0.00169204737733,590,0.998307952623,184,0.311336717428,PLEASA,Northampton,37131PLEASA
Northampton,814,183,0.224815724816,568,0.697788697789,1,0.0012285012285,0,0.0,47,0.0577395577396,15,0.0184275184275,582,9,2,575,584,14,0.017199017199,582,0.714987714988,51,0.0626535626536,763,0.937346437346,179,0.219901719902,POTECA,Northampton,37131POTECA
Northampton,899,325,0.361512791991,555,0.617352614016,8,0.00889877641824,5,0.0055617352614,2,0.00222469410456,4,0.00444938820912,557,9,9,557,566,2,0.00222469410456,557,0.61957730812,8,0.00889877641824,891,0.991101223582,321,0.357063403782,REHOBE,Northampton,37131REHOBE
Northampton,2008,501,0.249501992032,1471,0.732569721116,16,0.00796812749004,0,0.0,1,0.000498007968127,19,0.00946215139442,1483,25,17,1475,1500,12,0.00597609561753,1483,0.738545816733,31,0.015438247012,1977,0.984561752988,492,0.245019920319,RICH-S,Northampton,37131RICH-S
Northampton,1531,525,0.342913128674,988,0.645329849771,4,0.00261267145656,1,0.000653167864141,3,0.00195950359242,10,0.00653167864141,996,8,6,994,1002,8,0.00522534291313,996,0.650555192685,5,0.00326583932071,1526,0.996734160679,524,0.34225996081,SEABOA,Northampton,37131SEABOA
Northampton,699,421,0.602288984263,273,0.390557939914,1,0.00143061516452,0,0.0,0,0.0,4,0.00572246065808,276,4,2,274,278,3,0.00429184549356,276,0.394849785408,6,0.00858369098712,693,0.991416309013,416,0.595135908441,SEVERN,Northampton,37131SEVERN
Northampton,1301,582,0.447348193697,671,0.515757109915,8,0.00614911606457,6,0.00461183704842,16,0.0122982321291,18,0.0138355111453,680,20,16,676,696,9,0.00691775557264,680,0.522674865488,15,0.0115295926211,1286,0.988470407379,578,0.444273635665,WOODLA,Northampton,37131WOODLA
Onslow,7922,6787,0.856728098965,468,0.0590759909114,46,0.00580661449129,156,0.0196919969705,167,0.0210805352184,298,0.0376167634436,554,108,105,551,659,86,0.0108558444837,554,0.0699318353951,640,0.0807876798788,7282,0.919212320121,6420,0.810401413784,BC21,Onslow,37133BC21
Onslow,14015,8475,0.6047092401,3412,0.24345344274,94,0.00670709953621,515,0.0367463432037,785,0.0560114163396,734,0.0523724580806,3828,216,157,3769,3985,416,0.0296824830539,3828,0.273135925794,1828,0.130431680342,12187,0.869568319658,7762,0.553835176597,BM08,Onslow,37133BM08
Onslow,4095,3466,0.846398046398,312,0.0761904761905,17,0.0041514041514,48,0.0117216117216,115,0.028083028083,137,0.0334554334554,382,41,38,379,420,70,0.017094017094,382,0.0932844932845,339,0.0827838827839,3756,0.917216117216,3295,0.80463980464,CL10,Onslow,37133CL10
Onslow,9396,6829,0.726798637718,1598,0.170072371222,61,0.00649212430822,132,0.0140485312899,346,0.0368241805023,430,0.0457641549596,1825,171,146,1800,1971,227,0.024159216688,1825,0.19423158791,853,0.0907833120477,8543,0.909216687952,6464,0.687952320136,CR07,Onslow,37133CR07
Onslow,17137,11122,0.649005076735,3737,0.218066172609,103,0.00601038688218,604,0.0352453755033,655,0.038221392309,916,0.053451595962,4256,305,198,4149,4454,519,0.0302853474937,4256,0.248351520103,2233,0.130302853475,14904,0.869697146525,9939,0.579973157495,EN03,Onslow,37133EN03
Onslow,3956,3711,0.93806875632,73,0.0184529828109,39,0.00985844287159,26,0.00657229524772,35,0.00884732052578,72,0.0182002022245,90,73,71,88,161,17,0.00429726996967,90,0.0227502527806,134,0.0338725985844,3822,0.966127401416,3632,0.91809908999,FS16,Onslow,37133FS16
Onslow,6284,4895,0.778962444303,887,0.1411521324,33,0.00525143220878,95,0.0151177593889,135,0.0214831317632,239,0.0380330999363,974,87,75,962,1049,87,0.0138446849141,974,0.154996817314,533,0.0848185868873,5751,0.915181413113,4624,0.735837046467,GB12,Onslow,37133GB12
Onslow,8258,5613,0.679704528942,1701,0.205982077985,56,0.00678130297893,223,0.0270041172197,232,0.0280939694841,433,0.0524340033907,1926,132,100,1894,2026,225,0.0272463066118,1926,0.233228384597,791,0.0957859045774,7467,0.904214095423,5224,0.632598692177,HM05,Onslow,37133HM05
Onslow,3701,2926,0.790597135909,482,0.130235071602,21,0.00567414212375,27,0.00729532558768,108,0.0291813023507,137,0.0370170224264,549,61,49,537,598,67,0.0181032153472,549,0.148338286949,319,0.0861929208322,3382,0.913807079168,2751,0.743312618211,HN14,Onslow,37133HN14
Onslow,2150,1911,0.888837209302,125,0.0581395348837,14,0.00651162790698,22,0.0102325581395,24,0.0111627906977,54,0.0251162790698,152,32,26,146,178,27,0.0125581395349,152,0.0706976744186,85,0.0395348837209,2065,0.960465116279,1855,0.862790697674,HR17,Onslow,37133HR17
Onslow,5339,4365,0.817568833115,421,0.0788537179247,45,0.00842854467129,88,0.0164824873572,126,0.0235999250796,294,0.0550664918524,537,109,103,531,640,116,0.0217269151527,537,0.100580633077,389,0.0728600861585,4950,0.927139913842,4167,0.780483236561,HU20,Onslow,37133HU20
Onslow,33387,25135,0.752837930931,4462,0.133644831821,308,0.0092251475125,717,0.0214754245664,1288,0.0385778895977,1477,0.0442387755713,5130,621,523,5032,5653,668,0.0200077874622,5130,0.153652619283,4731,0.141701860005,28656,0.858298139995,22466,0.672896636415,JA01,Onslow,37133JA01
Onslow,1828,1364,0.746170678337,354,0.193654266958,21,0.0114879649891,7,0.00382932166302,23,0.0125820568928,59,0.0322757111597,385,35,34,384,419,31,0.0169584245077,385,0.210612691466,83,0.0454048140044,1745,0.954595185996,1324,0.724288840263,ML23,Onslow,37133ML23
Onslow,2491,2163,0.868325973505,192,0.0770774789241,9,0.00361300682457,19,0.00762745885187,22,0.00883179446006,86,0.0345242874348,226,45,41,222,267,34,0.0136491368928,226,0.0907266158169,107,0.0429546366921,2384,0.957045363308,2103,0.844239261341,MT24,Onslow,37133MT24
Onslow,16026,10467,0.653126169974,3415,0.213091226757,127,0.00792462248846,475,0.0296393360789,621,0.0387495320105,921,0.0574691126919,3878,284,226,3820,4104,463,0.0288905528516,3878,0.241981779608,1872,0.116810183452,14154,0.883189816548,9578,0.597653812555,NE22,Onslow,37133NE22
Onslow,1854,1606,0.866235167206,131,0.0706580366775,17,0.0091693635383,4,0.00215749730313,41,0.0221143473571,55,0.029665587918,151,51,40,140,191,20,0.0107874865156,151,0.0814455231931,88,0.0474649406688,1766,0.952535059331,1569,0.846278317152,NM13,Onslow,37133NM13
Onslow,4492,1523,0.339047195013,2491,0.554541406946,23,0.00512021371327,92,0.0204808548531,164,0.0365093499555,199,0.0443009795191,2634,50,33,2617,2667,143,0.0318343722173,2634,0.586375779163,414,0.0921638468388,4078,0.907836153161,1379,0.306990204809,NR02,Onslow,37133NR02
Onslow,7974,6229,0.781163782292,1096,0.137446701781,44,0.00551793328317,61,0.00764986205167,245,0.0307248557813,299,0.0374968648106,1252,115,97,1234,1349,156,0.0195635816403,1252,0.157010283421,656,0.0822673689491,7318,0.917732631051,5941,0.745046400803,RL09,Onslow,37133RL09
Onslow,5213,4794,0.919624016881,179,0.0343372338385,17,0.00326107807405,55,0.0105505467101,49,0.00939957797813,119,0.0228275465183,215,49,45,211,260,36,0.0069058123921,215,0.0412430462306,204,0.0391329368885,5009,0.960867063111,4667,0.895261845387,SF18,Onslow,37133SF18
Onslow,6496,5843,0.899476600985,220,0.0338669950739,42,0.00646551724138,102,0.0157019704433,88,0.0135467980296,201,0.0309421182266,299,73,71,297,370,79,0.0121613300493,299,0.0460283251232,321,0.0494150246305,6175,0.950584975369,5662,0.871613300493,SW19,Onslow,37133SW19
Onslow,5665,4272,0.754104148279,863,0.152338923213,50,0.00882612533098,117,0.0206531332745,175,0.0308914386584,188,0.0331862312445,960,97,73,936,1033,97,0.0171226831421,960,0.169461606355,496,0.0875551632833,5169,0.912444836717,4054,0.715622241836,TL06,Onslow,37133TL06
Onslow,3509,2835,0.807922485038,326,0.0929039612425,19,0.00541464804788,54,0.015388999715,102,0.0290681105728,173,0.0493017953833,401,71,54,384,455,75,0.0213736107153,401,0.114277571958,296,0.0843545169564,3213,0.915645483044,2679,0.763465374751,VR15,Onslow,37133VR15
Onslow,6584,5259,0.798754556501,727,0.110419198056,32,0.0048602673147,203,0.0308323207776,133,0.0202004860267,230,0.0349331713244,822,71,60,811,882,95,0.0144289185905,822,0.124848116646,484,0.0735115431349,6100,0.926488456865,5003,0.759872417983,WN04,Onslow,37133WN04
Orange,2890,1770,0.612456747405,367,0.126989619377,6,0.00207612456747,620,0.214532871972,62,0.0214532871972,65,0.022491349481,392,19,18,391,410,25,0.00865051903114,392,0.135640138408,176,0.0608996539792,2714,0.939100346021,1668,0.577162629758,BC,Orange,37135BC
Orange,1044,919,0.880268199234,52,0.0498084291188,4,0.00383141762452,36,0.0344827586207,8,0.00766283524904,25,0.0239463601533,62,7,6,61,68,10,0.0095785440613,62,0.0593869731801,51,0.0488505747126,993,0.951149425287,878,0.840996168582,BP,Orange,37135BP
Orange,1458,1007,0.690672153635,366,0.251028806584,14,0.00960219478738,2,0.00137174211248,43,0.0294924554184,26,0.0178326474623,384,23,19,380,403,18,0.0123456790123,384,0.263374485597,100,0.0685871056241,1358,0.931412894376,968,0.663923182442,CA,Orange,37135CA
Orange,1863,1569,0.842190016103,113,0.0606548577563,5,0.00268384326355,59,0.0316693505099,66,0.0354267310789,51,0.0273752012882,126,19,15,122,141,13,0.00697799248524,126,0.0676328502415,130,0.0697799248524,1733,0.930220075148,1506,0.808373590982,CB,Orange,37135CB
Orange,2947,2309,0.783508652867,356,0.120800814388,12,0.00407193756362,180,0.0610790634544,33,0.0111978283,57,0.0193417034272,379,20,17,376,396,23,0.00780454699695,379,0.128605361384,107,0.0363081099423,2840,0.963691890058,2238,0.759416355616,CC,Orange,37135CC
Orange,3684,2265,0.614820846906,218,0.0591748099891,13,0.00352877307275,866,0.235070575461,192,0.0521172638436,130,0.0352877307275,256,52,36,240,292,38,0.0103148751357,256,0.0694896851249,503,0.136536373507,3181,0.863463626493,2005,0.544245385451,CF,Orange,37135CF
Orange,1998,1535,0.768268268268,336,0.168168168168,19,0.00950950950951,5,0.0025025025025,72,0.036036036036,31,0.0155155155155,347,31,27,343,374,11,0.00550550550551,347,0.173673673674,152,0.0760760760761,1846,0.923923923924,1477,0.739239239239,CG,Orange,37135CG
Orange,1476,1191,0.806910569106,147,0.099593495935,3,0.0020325203252,80,0.0542005420054,12,0.00813008130081,43,0.0291327913279,165,10,5,160,170,18,0.0121951219512,165,0.111788617886,75,0.0508130081301,1401,0.94918699187,1140,0.772357723577,CH,Orange,37135CH
Orange,3477,2590,0.744895024446,371,0.106701179177,19,0.00546448087432,320,0.0920333620938,53,0.0152430255968,124,0.0356629278113,421,48,37,410,458,50,0.0143802128271,421,0.121081392005,187,0.0537819959735,3290,0.946218004026,2479,0.71297095197,CO,Orange,37135CO
Orange,3562,3005,0.843627175744,393,0.110331274565,5,0.00140370578327,53,0.0148792813026,26,0.00729927007299,80,0.0224592925323,416,38,32,410,448,23,0.00645704660303,416,0.116788321168,111,0.0311622683885,3451,0.968837731611,2945,0.826782706345,CP,Orange,37135CP
Orange,1911,1768,0.925170068027,56,0.029304029304,11,0.00575614861329,27,0.0141287284144,15,0.00784929356358,34,0.0177917320774,65,32,24,57,89,9,0.00470957613815,65,0.0340136054422,75,0.0392464678179,1836,0.960753532182,1714,0.896912611198,CS1,Orange,37135CS1
Orange,3431,3055,0.890410958904,254,0.0740308947829,11,0.00320606237249,18,0.00524628388225,44,0.0128242494899,49,0.0142815505683,274,25,24,273,298,20,0.00582920431361,274,0.0798600990965,91,0.0265228796269,3340,0.973477120373,3017,0.879335470708,CW,Orange,37135CW
Orange,6680,4861,0.727694610778,1488,0.222754491018,24,0.00359281437126,53,0.00793413173653,107,0.0160179640719,147,0.022005988024,1586,79,56,1563,1642,98,0.0146706586826,1586,0.237425149701,385,0.0576347305389,6295,0.942365269461,4622,0.691916167665,CX,Orange,37135CX
Orange,3982,3261,0.818935208438,113,0.0283776996484,5,0.00125565042692,447,0.112255148167,37,0.00929181315922,119,0.0298844801607,138,19,16,135,154,25,0.00627825213461,138,0.034655951783,159,0.0399296835761,3823,0.960070316424,3144,0.789552988448,DA,Orange,37135DA
Orange,3437,2563,0.745708466686,332,0.09659586849,23,0.00669188245563,323,0.0939773057899,107,0.0311318009892,89,0.0258946755892,362,50,41,353,403,30,0.00872854233343,362,0.105324410823,262,0.076229269712,3175,0.923770730288,2438,0.709339540297,DM,Orange,37135DM
Orange,2788,2265,0.812410329986,229,0.082137733142,11,0.00394548063128,203,0.0728120516499,32,0.0114777618364,48,0.0172166427547,244,17,16,243,260,15,0.00538020086083,244,0.0875179340029,129,0.0462697274032,2659,0.953730272597,2170,0.778335724534,EA,Orange,37135EA
Orange,2633,2115,0.803266236232,351,0.133308013673,16,0.00607671857197,21,0.00797569312571,95,0.0360805165211,35,0.0132928218762,360,27,26,359,386,9,0.00341815419673,360,0.136726167869,196,0.0744398025066,2437,0.925560197493,2034,0.772502848462,EF,Orange,37135EF
Orange,2702,2104,0.778682457439,225,0.0832716506292,2,0.000740192450037,263,0.0973353071799,33,0.0122131754256,75,0.0277572168764,241,14,10,237,251,16,0.0059215396003,241,0.0891931902295,115,0.0425610658771,2587,0.957438934123,2027,0.750185048113,EH,Orange,37135EH
Orange,4367,3228,0.739180215251,274,0.062743302038,37,0.00847263567667,37,0.00847263567667,633,0.144950767117,158,0.0361804442409,327,100,85,312,412,53,0.0121364781314,327,0.0748797801695,950,0.217540645752,3417,0.782459354248,2987,0.683993588276,ENO,Orange,37135ENO
Orange,2270,1446,0.637004405286,297,0.130837004405,3,0.00132158590308,347,0.152863436123,120,0.0528634361233,57,0.0251101321586,319,9,8,318,327,22,0.00969162995595,319,0.140528634361,184,0.0810572687225,2086,0.918942731278,1387,0.611013215859,ES,Orange,37135ES
Orange,5525,4071,0.736832579186,803,0.145339366516,49,0.00886877828054,93,0.0168325791855,316,0.0571945701357,193,0.0349321266968,881,147,119,853,1000,78,0.0141176470588,881,0.159457013575,705,0.127601809955,4820,0.872398190045,3773,0.682895927602,GB,Orange,37135GB
Orange,2919,2425,0.83076396026,112,0.0383693045564,12,0.00411099691675,264,0.0904419321686,31,0.0106200753683,75,0.0256937307297,135,30,25,130,160,23,0.00787941075711,135,0.0462487153135,114,0.0390544707091,2805,0.960945529291,2344,0.803014731072,GL,Orange,37135GL
Orange,2972,2503,0.842193808883,185,0.0622476446837,13,0.00437415881561,165,0.0555181695828,24,0.00807537012113,82,0.0275908479139,219,25,24,218,243,34,0.0114401076716,219,0.0736877523553,107,0.03600269179,2865,0.96399730821,2427,0.816621803499,GR,Orange,37135GR
Orange,1271,914,0.719118804091,294,0.231313926042,14,0.0110149488592,6,0.00472069236821,25,0.0196695515342,18,0.0141620771046,304,16,16,304,320,10,0.00786782061369,304,0.239181746656,68,0.0535011801731,1203,0.946498819827,879,0.691581431943,H,Orange,37135H
Orange,4338,3251,0.749423697556,430,0.0991240202858,13,0.00299677270632,383,0.0882895343476,121,0.0278930382665,140,0.0322729368373,470,73,55,452,525,40,0.00922083909636,470,0.108344859382,354,0.0816044260028,3984,0.918395573997,3062,0.705855232826,HF,Orange,37135HF
Orange,2242,1967,0.877341659233,108,0.0481712756467,6,0.00267618198037,78,0.0347903657449,38,0.0169491525424,45,0.0200713648528,121,18,11,114,132,13,0.00579839429081,121,0.0539696699376,96,0.042818911686,2146,0.957181088314,1909,0.851471900089,KM,Orange,37135KM
Orange,3285,2222,0.676407914764,484,0.147336377473,11,0.00334855403349,230,0.0700152207002,254,0.0773211567732,84,0.0255707762557,515,22,17,510,532,31,0.00943683409437,515,0.156773211568,461,0.140334855403,2824,0.859665144597,2038,0.620395738204,LC,Orange,37135LC
Orange,2832,2216,0.782485875706,338,0.119350282486,7,0.00247175141243,144,0.0508474576271,57,0.0201271186441,70,0.0247175141243,372,26,15,361,387,34,0.0120056497175,372,0.131355932203,111,0.0391949152542,2721,0.960805084746,2169,0.765889830508,LI,Orange,37135LI
Orange,3703,2385,0.644072373751,520,0.140426681069,13,0.00351066702674,637,0.17202268431,57,0.0153929246557,91,0.0245746691871,561,27,23,557,584,41,0.0110721036997,561,0.151498784769,172,0.0464488252768,3531,0.953551174723,2271,0.61328652444,MF,Orange,37135MF
Orange,2918,2580,0.884167237834,44,0.0150788211103,2,0.000685400959561,184,0.0630568882796,28,0.00959561343386,80,0.0274160383825,58,23,22,57,80,14,0.00479780671693,58,0.0198766278273,112,0.0383824537354,2806,0.961617546265,2497,0.855723098012,NC,Orange,37135NC
Orange,2960,2031,0.686148648649,701,0.236824324324,7,0.00236486486486,88,0.0297297297297,76,0.0256756756757,57,0.0192567567568,716,21,18,713,734,15,0.00506756756757,716,0.241891891892,183,0.0618243243243,2777,0.938175675676,1934,0.653378378378,NS,Orange,37135NS
Orange,4220,3682,0.872511848341,265,0.0627962085308,8,0.00189573459716,43,0.0101895734597,140,0.0331753554502,82,0.0194312796209,286,47,43,282,329,21,0.00497630331754,286,0.0677725118483,242,0.057345971564,3978,0.942654028436,3598,0.852606635071,OG,Orange,37135OG
Orange,4066,2091,0.514264633546,659,0.162075750123,32,0.00787014264634,379,0.0932120019675,755,0.185686178062,150,0.0368912936547,731,66,54,719,785,72,0.0177078209543,731,0.179783571077,1354,0.333005410723,2712,0.666994589277,1578,0.388096409247,OW,Orange,37135OW
Orange,6097,4198,0.688535345252,345,0.0565852058389,19,0.00311628669838,1040,0.170575692964,334,0.0547810398557,161,0.0264064293915,387,53,36,370,423,42,0.00688863375431,387,0.0634738395932,535,0.0877480728227,5562,0.912251927177,4028,0.660652780056,PA,Orange,37135PA
Orange,2686,1933,0.719657483246,400,0.148920327625,15,0.00558451228593,177,0.0658972449739,81,0.030156366344,80,0.0297840655249,427,32,24,419,451,27,0.0100521221147,427,0.158972449739,200,0.0744601638124,2486,0.925539836188,1837,0.683916604617,RF,Orange,37135RF
Orange,3309,2390,0.722272589906,593,0.179208220006,13,0.00392867935932,93,0.0281051677244,164,0.0495618011484,56,0.0169235418555,614,28,24,610,638,21,0.00634632819583,614,0.185554548202,271,0.0818978543367,3038,0.918102145663,2304,0.696282864914,SJ,Orange,37135SJ
Orange,3134,2713,0.865666879387,282,0.0899808551372,11,0.00350989151244,24,0.00765794511806,36,0.0114869176771,68,0.0216975111678,305,39,27,293,332,23,0.00733886407147,305,0.0973197192087,104,0.0331844288449,3030,0.966815571155,2664,0.850031908105,SM,Orange,37135SM
Orange,2404,1621,0.674292845258,322,0.133943427621,14,0.00582362728785,143,0.0594841930116,251,0.104409317804,53,0.0220465890183,332,26,22,328,354,10,0.00415973377704,332,0.138103161398,357,0.14850249584,2047,0.85149750416,1518,0.631447587354,TH,Orange,37135TH
Orange,1793,1301,0.72559955382,390,0.217512548801,10,0.00557724484105,8,0.00446179587284,44,0.0245398773006,40,0.0223089793642,408,19,17,406,425,18,0.0100390407139,408,0.227551589515,64,0.0356943669827,1729,0.964305633017,1284,0.716118237591,TO,Orange,37135TO
Orange,2307,1797,0.778933680104,380,0.164716081491,13,0.00563502384049,5,0.00216731686173,65,0.0281751192024,47,0.0203727785002,396,36,27,387,423,16,0.00693541395752,396,0.171651495449,186,0.0806241872562,2121,0.919375812744,1700,0.736887732987,WC,Orange,37135WC
Orange,4510,3077,0.682261640798,361,0.080044345898,10,0.00221729490022,613,0.135920177384,325,0.0720620842572,124,0.0274944567627,396,28,19,387,415,35,0.00776053215078,396,0.0878048780488,512,0.113525498891,3998,0.886474501109,2917,0.646784922395,WD,Orange,37135WD
Orange,3451,1757,0.509127789047,1406,0.40741813967,29,0.00840336134454,34,0.00985221674877,146,0.0423065778035,79,0.0228919153868,1444,72,59,1431,1503,38,0.0110113010722,1444,0.418429440742,271,0.0785279629093,3180,0.921472037091,1651,0.478412054477,WH,Orange,37135WH
Orange,2259,1544,0.683488269146,168,0.074369189907,6,0.00265604249668,273,0.120849933599,183,0.0810092961487,85,0.037627268703,203,24,15,194,218,35,0.0154935812306,203,0.0898627711377,300,0.132802124834,1959,0.867197875166,1445,0.63966356795,WW,Orange,37135WW
Pamlico,2189,1857,0.848332571951,231,0.105527638191,10,0.00456829602558,9,0.00411146642302,58,0.0264961169484,24,0.0109639104614,247,18,18,247,265,16,0.00730927364093,247,0.112836911832,85,0.0388305162175,2104,0.961169483783,1839,0.840109639105,1AL,Pamlico,371371AL
Pamlico,1919,1666,0.868160500261,188,0.097967691506,14,0.00729546638874,7,0.00364773319437,16,0.00833767587285,28,0.0145909327775,210,22,19,207,229,22,0.0114643043252,210,0.109431995831,34,0.0177175612298,1885,0.98228243877,1650,0.859822824388,1RB,Pamlico,371371RB
Pamlico,2050,1788,0.872195121951,228,0.111219512195,5,0.00243902439024,3,0.00146341463415,6,0.00292682926829,20,0.00975609756098,243,11,9,241,252,15,0.00731707317073,243,0.118536585366,36,0.0175609756098,2014,0.98243902439,1758,0.85756097561,2OT,Pamlico,371372OT
Pamlico,803,571,0.711083437111,197,0.245330012453,2,0.00249066002491,3,0.00373599003736,8,0.00996264009963,22,0.027397260274,207,9,6,204,213,10,0.0124533001245,207,0.257783312578,33,0.041095890411,770,0.958904109589,555,0.691158156912,2SW,Pamlico,371372SW
Pamlico,2431,1252,0.515014397367,1106,0.454956807898,20,0.0082270670506,12,0.00493624023036,11,0.00452488687783,30,0.0123406005759,1117,23,22,1116,1139,11,0.00452488687783,1117,0.459481694776,54,0.0222130810366,2377,0.977786918963,1213,0.498971616619,3BY,Pamlico,371373BY
Pamlico,395,387,0.979746835443,2,0.00506329113924,0,0.0,1,0.00253164556962,1,0.00253164556962,4,0.0101265822785,3,2,2,3,5,1,0.00253164556962,3,0.00759493670886,3,0.00759493670886,392,0.992405063291,386,0.977215189873,4HB,Pamlico,371374HB
Pamlico,633,281,0.443917851501,315,0.497630331754,2,0.00315955766193,4,0.00631911532385,20,0.0315955766193,11,0.0173775671406,320,5,5,320,325,5,0.00789889415482,320,0.505529225908,23,0.0363349131122,610,0.963665086888,279,0.440758293839,4VM,Pamlico,371374VM
Pamlico,2724,2230,0.818649045521,365,0.133994126285,24,0.00881057268722,22,0.00807635829662,43,0.0157856093979,40,0.014684287812,379,34,32,377,411,14,0.00513950073421,379,0.139133627019,144,0.0528634361233,2580,0.947136563877,2148,0.788546255507,5AP,Pamlico,371375AP
Pasquotank,2067,1055,0.510401548137,900,0.435413642961,4,0.00193517174649,8,0.00387034349299,58,0.0280599903241,42,0.0203193033382,919,17,11,913,930,19,0.00919206579584,919,0.444605708757,125,0.0604741170779,1942,0.939525882922,993,0.480406386067,1-A,Pasquotank,371391-A
Pasquotank,2300,1431,0.622173913043,763,0.331739130435,7,0.00304347826087,47,0.0204347826087,12,0.00521739130435,40,0.0173913043478,790,20,12,782,802,27,0.0117391304348,790,0.34347826087,63,0.0273913043478,2237,0.972608695652,1389,0.603913043478,1-B,Pasquotank,371391-B
Pasquotank,2227,1239,0.556353839246,825,0.370453524921,8,0.0035922766053,62,0.0278401436911,52,0.0233497979344,41,0.0184104176022,852,14,10,848,862,27,0.0121239335429,852,0.382577458464,152,0.0682532555007,2075,0.931746744499,1152,0.517287831163,2-A,Pasquotank,371392-A
Pasquotank,1860,828,0.445161290323,862,0.463440860215,7,0.00376344086022,13,0.00698924731183,90,0.0483870967742,60,0.0322580645161,908,25,14,897,922,46,0.0247311827957,908,0.488172043011,139,0.0747311827957,1721,0.925268817204,803,0.431720430108,2-B,Pasquotank,371392-B
Pasquotank,2213,960,0.433800271125,1100,0.497062810664,5,0.00225937641211,55,0.0248531405332,37,0.0167193854496,56,0.0253050158156,1144,17,10,1137,1154,44,0.0198825124266,1144,0.516945323091,89,0.0402169001356,2124,0.959783099864,917,0.414369633981,3-A,Pasquotank,371393-A
Pasquotank,2325,217,0.0933333333333,1958,0.842150537634,16,0.00688172043011,9,0.00387096774194,75,0.0322580645161,50,0.0215053763441,2002,29,20,1993,2022,44,0.0189247311828,2002,0.861075268817,101,0.0434408602151,2224,0.956559139785,201,0.0864516129032,3-B,Pasquotank,371393-B
Pasquotank,2019,377,0.186726102031,1464,0.725111441308,10,0.00495294700347,30,0.0148588410104,91,0.0450718177316,47,0.0232788509163,1504,15,13,1502,1517,40,0.0198117880139,1504,0.744923229321,154,0.0762753838534,1865,0.923724616147,322,0.159484893512,4-A,Pasquotank,371394-A
Pasquotank,3165,967,0.305529225908,2052,0.648341232227,10,0.00315955766193,14,0.0044233807267,53,0.0167456556082,69,0.0218009478673,2086,24,18,2080,2104,34,0.0107424960506,2086,0.659083728278,102,0.0322274881517,3063,0.967772511848,938,0.296366508689,4-B,Pasquotank,371394-B
Pasquotank,5344,3579,0.669723053892,1473,0.275636227545,22,0.00411676646707,65,0.0121631736527,71,0.0132859281437,134,0.0250748502994,1536,55,47,1528,1583,63,0.0117889221557,1536,0.287425149701,191,0.0357410179641,5153,0.964258982036,3509,0.656624251497,MH,Pasquotank,37139MH
Pasquotank,2791,1632,0.584736653529,1054,0.377642422071,9,0.00322465066284,6,0.00214976710856,13,0.00465782873522,77,0.0275886778932,1097,31,29,1095,1126,43,0.015406664278,1097,0.393049086349,51,0.0182730204228,2740,0.981726979577,1625,0.582228591903,NEW,Pasquotank,37139NEW
Pasquotank,4787,3712,0.775433465636,841,0.175684144558,15,0.00313348652601,60,0.012533946104,68,0.0142051389179,91,0.0190098182578,886,35,30,881,916,45,0.00940045957802,886,0.185084604136,159,0.0332149571757,4628,0.966785042824,3622,0.75663254648,NIX,Pasquotank,37139NIX
Pasquotank,7882,5645,0.716188784572,1845,0.234077645268,28,0.00355239786856,91,0.0115452930728,103,0.0130677493022,170,0.0215681299163,1934,67,51,1918,1985,89,0.0112915503679,1934,0.245369195636,285,0.0361583354479,7597,0.963841664552,5501,0.69791930982,PRO,Pasquotank,37139PRO
Pasquotank,1681,1417,0.842950624628,218,0.129684711481,0,0.0,13,0.00773349196907,14,0.00832837596669,19,0.0113027959548,226,7,4,223,230,8,0.00475907198096,226,0.134443783462,31,0.0184414039262,1650,0.981558596074,1397,0.831052944676,SAL,Pasquotank,37139SAL
Pender,4409,3669,0.832161487866,436,0.0988886368791,33,0.00748469040599,13,0.00294851440236,129,0.0292583352234,129,0.0292583352234,489,84,74,479,563,53,0.0120208664096,489,0.110909503289,270,0.061238376049,4139,0.938761623951,3555,0.806305284645,CF11,Pender,37141CF11
Pender,2304,899,0.390190972222,1172,0.508680555556,11,0.00477430555556,5,0.00217013888889,183,0.0794270833333,34,0.0147569444444,1186,24,18,1180,1204,14,0.00607638888889,1186,0.514756944444,238,0.103298611111,2066,0.896701388889,867,0.376302083333,CL05,Pender,37141CL05
Pender,1418,993,0.700282087447,335,0.236248236953,2,0.00141043723554,3,0.00211565585331,58,0.0409026798307,27,0.0190409026798,348,12,5,341,353,13,0.00916784203103,348,0.245416078984,110,0.0775740479549,1308,0.922425952045,952,0.671368124118,CS04,Pender,37141CS04
Pender,370,204,0.551351351351,135,0.364864864865,1,0.0027027027027,0,0.0,19,0.0513513513514,11,0.0297297297297,146,5,1,142,147,11,0.0297297297297,146,0.394594594595,20,0.0540540540541,350,0.945945945946,203,0.548648648649,CT03,Pender,37141CT03
Pender,2368,1432,0.60472972973,797,0.336570945946,21,0.00886824324324,3,0.00126689189189,58,0.0244932432432,57,0.0240709459459,809,48,48,809,857,12,0.00506756756757,809,0.341638513514,112,0.0472972972973,2256,0.952702702703,1394,0.588682432432,GR06,Pender,37141GR06
Pender,2241,1723,0.76885319054,410,0.182954038376,14,0.00624721106649,9,0.00401606425703,56,0.024988844266,29,0.0129406514949,427,26,20,421,447,17,0.00758589915216,427,0.190539937528,135,0.0602409638554,2106,0.939759036145,1652,0.737170905846,LC09,Pender,37141LC09
Pender,4101,3789,0.923920994879,172,0.0419409900024,6,0.00146305779078,23,0.005608388198,51,0.0124359912217,60,0.0146305779078,202,21,20,201,222,30,0.00731528895391,202,0.0492562789564,123,0.029992684711,3978,0.970007315289,3717,0.90636430139,LT18,Pender,37141LT18
Pender,1746,1332,0.762886597938,311,0.178121420389,6,0.00343642611684,3,0.00171821305842,70,0.0400916380298,24,0.0137457044674,318,15,15,318,333,7,0.00400916380298,318,0.182130584192,122,0.069873997709,1624,0.930126002291,1297,0.742840778923,LU16,Pender,37141LU16
Pender,540,489,0.905555555556,33,0.0611111111111,5,0.00925925925926,1,0.00185185185185,9,0.0166666666667,3,0.00555555555556,34,7,7,34,41,1,0.00185185185185,34,0.062962962963,9,0.0166666666667,531,0.983333333333,488,0.903703703704,MH07,Pender,37141MH07
Pender,3080,2743,0.890584415584,240,0.0779220779221,18,0.00584415584416,31,0.0100649350649,13,0.00422077922078,35,0.0113636363636,252,29,25,248,277,12,0.0038961038961,252,0.0818181818182,52,0.0168831168831,3028,0.983116883117,2704,0.877922077922,MT19,Pender,37141MT19
Pender,3518,2306,0.655486071632,1017,0.28908470722,32,0.00909607731666,8,0.00227401932916,103,0.029277998863,52,0.0147811256396,1041,61,49,1029,1090,24,0.00682205798749,1041,0.295906765208,220,0.062535531552,3298,0.937464468448,2208,0.627629334849,NB01,Pender,37141NB01
Pender,619,540,0.872374798061,69,0.111470113086,0,0.0,0,0.0,2,0.0032310177706,8,0.0129240710824,73,4,4,73,77,4,0.0064620355412,73,0.117932148627,15,0.0242326332795,604,0.975767366721,527,0.851373182553,PL10,Pender,37141PL10
Pender,3668,2214,0.603598691385,698,0.190294438386,40,0.0109051254089,16,0.00436205016358,586,0.159760087241,114,0.0310796074155,739,101,86,724,825,41,0.0111777535442,739,0.20147219193,883,0.240730643402,2785,0.759269356598,1973,0.537895310796,RP20,Pender,37141RP20
Pender,4887,3042,0.622467771639,1510,0.308983016165,19,0.00388786576632,20,0.00409249028034,212,0.0433803969716,84,0.0171884591774,1557,53,44,1548,1601,47,0.00961735215879,1557,0.318600368324,360,0.073664825046,4527,0.926335174954,2914,0.596275833845,SB02,Pender,37141SB02
Pender,3568,3239,0.907791479821,194,0.0543721973094,24,0.0067264573991,29,0.00812780269058,34,0.00952914798206,48,0.0134529147982,213,36,35,212,248,19,0.00532511210762,213,0.059697309417,95,0.0266255605381,3473,0.973374439462,3187,0.893217488789,SC13,Pender,37141SC13
Pender,2065,2017,0.976755447942,18,0.00871670702179,1,0.000484261501211,15,0.00726392251816,0,0.0,14,0.00677966101695,23,8,8,23,31,5,0.00242130750605,23,0.0111380145278,22,0.0106537530266,2043,0.989346246973,1995,0.966101694915,SH12,Pender,37141SH12
Pender,3816,3393,0.889150943396,310,0.0812368972746,21,0.00550314465409,13,0.00340670859539,18,0.00471698113208,61,0.0159853249476,336,51,45,330,381,26,0.00681341719078,336,0.0880503144654,88,0.0230607966457,3728,0.976939203354,3334,0.873689727463,SP15,Pender,37141SP15
Pender,1009,288,0.285431119921,702,0.695738354807,5,0.00495540138751,0,0.0,5,0.00495540138751,9,0.00891972249752,710,9,6,707,716,8,0.00792864222002,710,0.703666997027,17,0.0168483647175,992,0.983151635282,284,0.281466798811,UH08,Pender,37141UH08
Pender,4623,4367,0.944624702574,94,0.0203331170236,28,0.00605667315596,27,0.00584036340039,22,0.00475881462254,85,0.0183863292234,132,54,49,127,181,38,0.00821977071166,132,0.0285528877352,109,0.0235777633571,4514,0.976422236643,4290,0.927968851395,UT14,Pender,37141UT14
Pender,1867,1077,0.576861274772,616,0.32994108195,4,0.00214247455811,6,0.00321371183717,114,0.0610605249063,50,0.0267809319764,638,15,9,632,647,22,0.0117836100696,638,0.341724692019,194,0.103910016069,1673,0.896089983931,1027,0.550080342796,UU17,Pender,37141UU17
Perquimans,980,786,0.802040816327,182,0.185714285714,0,0.0,1,0.00102040816327,1,0.00102040816327,10,0.0102040816327,189,3,3,189,192,7,0.00714285714286,189,0.192857142857,11,0.0112244897959,969,0.988775510204,779,0.794897959184,BELVID,Perquimans,37143BELVID
Perquimans,3508,2915,0.830957810718,503,0.14338654504,15,0.00427594070696,6,0.00171037628278,32,0.00912200684151,37,0.0105473204105,521,29,28,520,549,18,0.00513112884835,521,0.148517673888,54,0.015393386545,3454,0.984606613455,2902,0.827251995439,BETHEL,Perquimans,37143BETHEL
Perquimans,1518,649,0.427536231884,815,0.536890645586,2,0.00131752305665,7,0.00461133069829,23,0.0151515151515,22,0.0144927536232,825,9,5,821,830,10,0.00658761528327,825,0.54347826087,38,0.0250329380764,1480,0.974967061924,637,0.419631093544,EAST-H,Perquimans,37143EAST-H
Perquimans,3005,2387,0.794342762063,515,0.171381031614,17,0.00565723793677,15,0.00499168053245,20,0.00665557404326,51,0.0169717138103,549,29,25,545,574,34,0.0113144758735,549,0.182695507488,53,0.0176372712146,2952,0.982362728785,2363,0.786356073211,NEW-HO,Perquimans,37143NEW-HO
Perquimans,322,257,0.798136645963,56,0.173913043478,0,0.0,1,0.00310559006211,3,0.00931677018634,5,0.0155279503106,56,1,1,56,57,0,0.0,56,0.173913043478,7,0.0217391304348,315,0.978260869565,256,0.795031055901,NICANO,Perquimans,37143NICANO
Perquimans,2697,1745,0.647015202076,892,0.330737856878,2,0.00074156470152,8,0.00296625880608,17,0.00630329996292,33,0.0122358175751,906,15,13,904,919,14,0.00519095291064,906,0.335928809789,36,0.0133481646274,2661,0.986651835373,1731,0.641824249166,PARKVI,Perquimans,37143PARKVI
Perquimans,1423,955,0.671117357695,384,0.269852424455,5,0.00351370344343,2,0.00140548137737,61,0.0428671820098,16,0.011243851019,393,10,10,393,403,9,0.00632466619817,393,0.276177090654,87,0.0611384399157,1336,0.938861560084,940,0.660576247365,WEST-H,Perquimans,37143WEST-H
Person,3136,2007,0.639987244898,1034,0.329719387755,13,0.00414540816327,3,0.000956632653061,39,0.0124362244898,40,0.0127551020408,1063,26,23,1060,1086,29,0.00924744897959,1063,0.338966836735,66,0.0210459183673,3070,0.978954081633,1982,0.632015306122,ALVI,Person,37145ALVI
Person,1622,1300,0.801479654747,243,0.149815043157,7,0.00431565967941,0,0.0,42,0.0258939580764,30,0.0184956843403,253,16,15,252,268,10,0.00616522811344,253,0.15598027127,65,0.0400739827374,1557,0.959926017263,1286,0.792848335388,BFRK,Person,37145BFRK
Person,2591,1938,0.747973755307,590,0.227711308375,5,0.00192975685064,6,0.00231570822076,31,0.0119644924739,21,0.00810497877267,605,14,9,600,614,15,0.00578927055191,605,0.233500578927,54,0.0208413739869,2537,0.979158626013,1917,0.739868776534,CUCL,Person,37145CUCL
Person,7137,5840,0.818270982205,1007,0.141095698473,45,0.0063051702396,24,0.00336275746112,102,0.0142917192098,119,0.0166736724114,1079,85,75,1069,1154,72,0.0100882723834,1079,0.151183970856,177,0.0248003362757,6960,0.975199663724,5775,0.809163514082,FLRI,Person,37145FLRI
Person,1556,1163,0.747429305913,289,0.185732647815,79,0.0507712082262,2,0.0012853470437,8,0.00514138817481,15,0.00964010282776,296,84,83,295,379,7,0.00449871465296,296,0.190231362468,23,0.0147814910026,1533,0.985218508997,1156,0.74293059126,HLWY,Person,37145HLWY
Person,1048,740,0.706106870229,253,0.24141221374,0,0.0,1,0.000954198473282,31,0.0295801526718,23,0.0219465648855,273,9,1,265,274,20,0.0190839694656,273,0.260496183206,66,0.0629770992366,982,0.937022900763,705,0.672709923664,HUML,Person,37145HUML
Person,3340,2796,0.837125748503,439,0.131437125749,13,0.00389221556886,11,0.00329341317365,44,0.0131736526946,37,0.0110778443114,453,33,27,447,480,14,0.00419161676647,453,0.135628742515,78,0.0233532934132,3262,0.976646706587,2763,0.827245508982,MTTZ,Person,37145MTTZ
Person,2263,1886,0.833406981882,319,0.140963323023,9,0.00397702165267,5,0.00220945647371,22,0.00972160848431,22,0.00972160848431,331,15,14,330,345,12,0.0053026955369,331,0.146266018559,57,0.0251878038003,2206,0.9748121962,1851,0.817940786567,OLHI,Person,37145OLHI
Person,3300,1367,0.414242424242,1660,0.50303030303,15,0.00454545454545,4,0.00121212121212,188,0.0569696969697,66,0.02,1710,36,25,1699,1735,50,0.0151515151515,1710,0.518181818182,342,0.103636363636,2958,0.896363636364,1245,0.377272727273,ROX1,Person,37145ROX1
Person,3182,1959,0.615650534255,995,0.312696417348,26,0.00817096165933,36,0.0113136392206,103,0.0323695788812,63,0.0197988686361,1037,43,34,1028,1071,42,0.0131992457574,1037,0.325895663105,166,0.0521684475173,3016,0.947831552483,1910,0.600251414205,ROX2,Person,37145ROX2
Person,3674,1658,0.451279259662,1761,0.479314099075,23,0.00626020685901,6,0.00163309744148,140,0.0381056069679,86,0.0234077299946,1826,38,27,1815,1853,65,0.0176918889494,1826,0.497005988024,243,0.06614044638,3431,0.93385955362,1575,0.428688078389,ROX3,Person,37145ROX3
Person,2321,1376,0.592847910383,849,0.365790607497,8,0.00344679017665,6,0.00258509263249,45,0.0193881947436,37,0.015941404567,875,14,11,872,886,26,0.0112020680741,875,0.376992675571,128,0.0551486428264,2193,0.944851357174,1296,0.558380008617,ROX4,Person,37145ROX4
Person,2807,2067,0.736373352333,653,0.232632703954,11,0.00391877449234,10,0.00356252226576,42,0.0149625935162,24,0.00855005343783,666,13,13,666,679,13,0.00463127894549,666,0.2372639829,80,0.0285001781261,2727,0.971499821874,2033,0.72426077663,RX1A,Person,37145RX1A
Person,1487,871,0.585743106927,554,0.372562205783,12,0.00806993947545,6,0.00403496973773,31,0.0208473436449,13,0.00874243443174,562,17,17,562,579,8,0.0053799596503,562,0.377942165434,48,0.0322797579018,1439,0.967720242098,860,0.578345662408,WDSD,Person,37145WDSD
Pitt,5022,2683,0.534249303067,2097,0.417562724014,9,0.00179211469534,21,0.00418160095579,95,0.0189167662286,117,0.0232974910394,2154,45,31,2140,2185,57,0.0113500597372,2154,0.428912783751,182,0.0362405416169,4840,0.963759458383,2615,0.520708880924,0101,Pitt,371470101
Pitt,3963,2687,0.678021700732,1008,0.254352763058,33,0.00832702498107,16,0.00403734544537,146,0.036840777189,73,0.0184203885945,1060,59,47,1048,1107,52,0.0131213726975,1060,0.267474135756,247,0.0623265203129,3716,0.937673479687,2605,0.657330305324,0200A,Pitt,371470200A
Pitt,3562,1591,0.446659180236,1817,0.51010668164,8,0.00224592925323,7,0.00196518809657,92,0.0258281864121,47,0.0131948343627,1856,17,12,1851,1868,39,0.0109489051095,1856,0.521055586749,143,0.0401459854015,3419,0.959854014599,1554,0.43627175744,0200B,Pitt,371470200B
Pitt,8140,2770,0.340294840295,3946,0.484766584767,43,0.00528255528256,65,0.00798525798526,1075,0.132063882064,241,0.0296068796069,4070,70,59,4059,4129,124,0.0152334152334,4070,0.5,1584,0.194594594595,6556,0.805405405405,2439,0.299631449631,0301,Pitt,371470301
Pitt,2470,1016,0.411336032389,1369,0.554251012146,11,0.00445344129555,6,0.00242914979757,51,0.0206477732794,17,0.00688259109312,1379,20,15,1374,1394,10,0.00404858299595,1379,0.558299595142,74,0.02995951417,2396,0.97004048583,1002,0.405668016194,0401,Pitt,371470401
Pitt,2070,1276,0.616425120773,645,0.311594202899,12,0.00579710144928,4,0.00193236714976,100,0.048309178744,33,0.0159420289855,662,15,13,660,675,17,0.00821256038647,662,0.319806763285,138,0.0666666666667,1932,0.933333333333,1262,0.609661835749,0501,Pitt,371470501
Pitt,6606,5449,0.824856191341,764,0.115652437178,23,0.0034816833182,43,0.00650923402967,222,0.0336058128974,105,0.0158946412352,808,63,50,795,858,44,0.00666061156524,808,0.122313048744,350,0.0529821374508,6256,0.947017862549,5344,0.808961550106,0601,Pitt,371470601
Pitt,2633,1840,0.698822635777,654,0.248385871629,3,0.00113938473224,54,0.0205089251804,39,0.0148120015192,43,0.0163311811622,673,12,6,667,679,19,0.00721610330422,673,0.255601974934,109,0.0413976452716,2524,0.958602354728,1777,0.6748955564,0701,Pitt,371470701
Pitt,3648,1943,0.532620614035,1468,0.402412280702,7,0.00191885964912,14,0.00383771929825,187,0.0512609649123,29,0.00794956140351,1478,14,12,1476,1490,10,0.00274122807018,1478,0.405153508772,290,0.0794956140351,3358,0.920504385965,1862,0.510416666667,0800A,Pitt,371470800A
Pitt,3055,1533,0.501800327332,1412,0.462193126023,3,0.000981996726678,11,0.00360065466448,47,0.0153846153846,49,0.0160392798691,1448,10,5,1443,1453,36,0.0117839607201,1448,0.473977086743,99,0.0324058919804,2956,0.96759410802,1490,0.487725040917,0800B,Pitt,371470800B
Pitt,1356,862,0.635693215339,443,0.326696165192,0,0.0,0,0.0,21,0.0154867256637,30,0.0221238938053,465,10,3,458,468,22,0.0162241887906,465,0.342920353982,38,0.0280235988201,1318,0.97197640118,858,0.632743362832,0901,Pitt,371470901
Pitt,4900,2984,0.608979591837,1516,0.309387755102,22,0.00448979591837,15,0.0030612244898,232,0.0473469387755,131,0.0267346938776,1602,31,29,1600,1631,86,0.0175510204082,1602,0.32693877551,459,0.0936734693878,4441,0.906326530612,2828,0.577142857143,1001,Pitt,371471001
Pitt,2087,1228,0.588404408241,718,0.344034499281,6,0.00287494010541,4,0.00191662673694,98,0.0469573550551,33,0.0158121705798,737,18,13,732,750,19,0.00910397700048,737,0.353138476282,126,0.0603737422137,1961,0.939626257786,1196,0.573071394346,1101,Pitt,371471101
Pitt,3927,2917,0.742806213394,799,0.203463203463,19,0.00483829895595,37,0.00942195059842,88,0.0224089635854,67,0.0170613700025,841,34,25,832,866,42,0.0106951871658,841,0.214158390629,158,0.0402342755284,3769,0.959765724472,2865,0.729564553094,1102A,Pitt,371471102A
Pitt,5019,3875,0.772066148635,752,0.149830643554,12,0.00239091452481,44,0.00876668659095,256,0.0510061765292,80,0.0159394301654,786,38,29,777,815,34,0.00677425782028,786,0.156604901375,408,0.0812910938434,4611,0.918708906157,3729,0.742976688583,1102B,Pitt,371471102B
Pitt,7896,4289,0.543186423506,2818,0.356889564336,26,0.0032928064843,71,0.00899189463019,551,0.0697821681864,141,0.0178571428571,2910,62,43,2891,2953,92,0.0116514690983,2910,0.368541033435,824,0.104356636272,7072,0.895643363728,4061,0.514311043566,1201,Pitt,371471201
Pitt,1669,1483,0.88855602157,137,0.0820850808868,0,0.0,3,0.00179748352307,20,0.0119832234871,26,0.0155781905333,150,5,2,147,152,13,0.00778909526663,150,0.0898741761534,83,0.0497303774715,1586,0.950269622528,1423,0.852606351108,1301,Pitt,371471301
Pitt,4200,3014,0.717619047619,843,0.200714285714,19,0.00452380952381,117,0.0278571428571,123,0.0292857142857,84,0.02,886,34,31,883,917,43,0.0102380952381,886,0.210952380952,203,0.0483333333333,3997,0.951666666667,2950,0.702380952381,1402A,Pitt,371471402A
Pitt,3713,2799,0.753837866954,618,0.166442230003,10,0.00269323996768,52,0.0140048478319,139,0.0374360355508,95,0.025585779693,665,41,33,657,698,47,0.0126582278481,665,0.179100457851,242,0.0651764072179,3471,0.934823592782,2717,0.731753299219,1402B,Pitt,371471402B
Pitt,7871,5279,0.670689874222,2131,0.270740693686,34,0.00431965442765,92,0.0116884766866,186,0.0236310506924,149,0.0189302502859,2213,73,55,2195,2268,82,0.0104179900902,2213,0.281158683776,358,0.0454834201499,7513,0.95451657985,5152,0.654554694448,1403A,Pitt,371471403A
Pitt,6477,4486,0.692604600895,1629,0.25150532654,16,0.00247027945036,186,0.0287169986105,42,0.0064844835572,118,0.0182183109464,1689,35,20,1674,1709,60,0.00926354793886,1689,0.260768874479,195,0.0301065308013,6282,0.969893469199,4352,0.671916010499,1403B,Pitt,371471403B
Pitt,2326,300,0.128976784179,1750,0.752364574377,4,0.00171969045572,1,0.000429922613929,209,0.0898538263113,62,0.0266552020636,1787,18,13,1782,1800,37,0.0159071367154,1787,0.768271711092,263,0.113069647463,2063,0.886930352537,279,0.119948409286,1501,Pitt,371471501
Pitt,3982,958,0.240582621798,2836,0.71220492215,22,0.00552486187845,66,0.0165745856354,28,0.00703164239076,72,0.0180813661477,2886,55,29,2860,2915,50,0.0125565042692,2886,0.724761426419,91,0.02285283777,3891,0.97714716223,937,0.235308890005,1503,Pitt,371471503
Pitt,9389,3048,0.324635211418,5813,0.619128767707,24,0.00255618276707,261,0.0277984875919,78,0.00830759399297,165,0.0175737565236,5918,66,36,5888,5954,105,0.0111832996059,5918,0.630312067313,232,0.0247097667483,9157,0.975290233252,2947,0.313877942273,1504,Pitt,371471504
Pitt,5219,1793,0.343552404675,3057,0.585744395478,30,0.00574822762981,124,0.0237593408699,115,0.022034872581,100,0.019160758766,3127,56,44,3115,3171,70,0.0134125311362,3127,0.599156926614,296,0.0567158459475,4923,0.943284154053,1643,0.314811266526,1505A,Pitt,371471505A
Pitt,4250,441,0.103764705882,3631,0.854352941176,13,0.00305882352941,17,0.004,76,0.0178823529412,72,0.0169411764706,3687,39,19,3667,3706,56,0.0131764705882,3687,0.867529411765,171,0.0402352941176,4079,0.959764705882,406,0.0955294117647,1505B,Pitt,371471505B
Pitt,3099,1356,0.437560503388,1545,0.498547918683,6,0.00193610842207,43,0.0138754436915,55,0.0177476605357,94,0.0303323652791,1615,19,13,1609,1628,70,0.0225879315908,1615,0.521135850274,105,0.0338818973863,2994,0.966118102614,1324,0.427234591804,1506,Pitt,371471506
Pitt,6628,4534,0.684067592034,1645,0.248189499095,24,0.0036210018105,133,0.0200663850332,100,0.0150875075438,192,0.028968014484,1755,60,35,1730,1790,110,0.0165962582981,1755,0.264785757393,223,0.0336451418226,6405,0.966354858177,4432,0.668678334339,1507,Pitt,371471507
Pitt,3396,2535,0.746466431095,641,0.18875147232,9,0.00265017667845,118,0.0347467608952,38,0.0111896348645,55,0.0161955241461,659,15,12,656,671,18,0.00530035335689,659,0.194051825677,113,0.0332744405183,3283,0.966725559482,2471,0.727620730271,1507B,Pitt,371471507B
Pitt,2321,1890,0.814304179233,329,0.141749246015,12,0.00517018526497,27,0.0116329168462,21,0.0090478242137,42,0.0180956484274,352,21,17,348,369,23,0.00990952175786,352,0.151658767773,57,0.0245583800086,2264,0.975441619991,1860,0.801378716071,1508A,Pitt,371471508A
Pitt,3052,2540,0.832241153342,330,0.108125819135,18,0.00589777195282,50,0.0163826998689,25,0.00819134993447,89,0.0291612057667,376,40,27,363,403,46,0.0150720838794,376,0.123197903014,48,0.0157273918742,3004,0.984272608126,2517,0.824705111402,1508B,Pitt,371471508B
Pitt,7516,5326,0.708621607238,1671,0.222325705162,31,0.00412453432677,185,0.0246141564662,148,0.019691325173,155,0.0206226716338,1769,58,45,1756,1814,98,0.0130388504524,1769,0.235364555615,305,0.0405800957956,7211,0.959419904204,5203,0.692256519425,1509,Pitt,371471509
Pitt,3159,2528,0.800253244698,368,0.116492560937,19,0.00601456157012,85,0.0269072491295,108,0.034188034188,51,0.0161443494777,386,33,29,382,415,18,0.00569800569801,386,0.122190566635,196,0.0620449509338,2963,0.937955049066,2462,0.779360557138,1510A,Pitt,371471510A
Pitt,3422,2753,0.804500292227,484,0.141437755698,10,0.00292226767972,105,0.0306838106371,16,0.00467562828755,54,0.0157802454705,517,23,18,512,535,33,0.00964348334307,517,0.151081239041,71,0.020748100526,3351,0.979251899474,2718,0.794272355348,1510B,Pitt,371471510B
Pitt,4032,3228,0.800595238095,532,0.131944444444,5,0.00124007936508,173,0.0429067460317,33,0.00818452380952,61,0.015128968254,559,25,10,544,569,27,0.00669642857143,559,0.138640873016,85,0.0210813492063,3947,0.978918650794,3183,0.78943452381,1511A,Pitt,371471511A
Pitt,6076,4452,0.732718894009,1257,0.206879526004,14,0.00230414746544,156,0.0256747860434,69,0.0113561553654,128,0.0210664911126,1323,33,23,1313,1346,66,0.0108624094799,1323,0.217741935484,209,0.0343976300197,5867,0.96560236998,4359,0.71741277156,1511B,Pitt,371471511B
Pitt,6693,3426,0.511878081578,2715,0.405647691618,18,0.002689376961,168,0.025100851636,166,0.0248020319737,200,0.0298819662334,2854,68,33,2819,2887,139,0.0207679665322,2854,0.42641565815,331,0.0494546541162,6362,0.950545345884,3294,0.492155983864,1512A,Pitt,371471512A
Pitt,3304,1963,0.594128329298,1069,0.323547215496,7,0.0021186440678,136,0.0411622276029,41,0.0124092009685,88,0.0266343825666,1115,26,15,1104,1130,46,0.0139225181598,1115,0.337469733656,96,0.0290556900726,3208,0.970944309927,1922,0.581719128329,1512B,Pitt,371471512B
Polk,2206,2094,0.949229374433,23,0.0104261106074,18,0.00815956482321,3,0.00135992747053,37,0.0167724388033,31,0.0140525838622,28,36,36,28,64,5,0.00226654578422,28,0.0126926563917,87,0.0394378966455,2119,0.960562103354,2043,0.926110607434,CG05,Polk,37149CG05
Polk,3294,3008,0.913175470553,48,0.0145719489982,6,0.00182149362477,14,0.00425015179114,148,0.0449301760777,70,0.0212507589557,74,33,30,71,104,26,0.00789313904068,74,0.0224650880389,250,0.0758955676988,3044,0.924104432301,2930,0.88949605343,CL07,Polk,37149CL07
Polk,3180,2961,0.931132075472,68,0.0213836477987,29,0.00911949685535,21,0.00660377358491,76,0.0238993710692,25,0.00786163522013,79,41,38,76,117,11,0.00345911949686,79,0.0248427672956,165,0.0518867924528,3015,0.948113207547,2902,0.912578616352,CL08,Polk,37149CL08
Polk,3607,3115,0.863598558359,326,0.0903798170225,10,0.00277238702523,10,0.00277238702523,94,0.0260604380371,52,0.0144164125312,349,27,25,347,374,23,0.00637649015803,349,0.0967563071805,197,0.054616024397,3410,0.945383975603,3019,0.836983642917,GC09,Polk,37149GC09
Polk,1972,1919,0.973123732252,21,0.0106490872211,2,0.00101419878296,3,0.00152129817444,7,0.00354969574037,20,0.0101419878296,21,14,14,21,35,0,0.0,21,0.0106490872211,46,0.0233265720081,1926,0.976673427992,1887,0.956896551724,SA04,Polk,37149SA04
Polk,3747,3297,0.879903923139,329,0.0878035761943,3,0.00080064051241,11,0.00293568187884,55,0.0146784093942,52,0.0138777688818,357,19,15,353,372,28,0.00747264478249,357,0.0952762209768,153,0.0408326661329,3594,0.959167333867,3211,0.856952228449,TR123,Polk,37149TR123
Polk,2504,2239,0.894169329073,103,0.0411341853035,4,0.00159744408946,8,0.00319488817891,111,0.0443290734824,39,0.0155750798722,115,27,27,115,142,12,0.00479233226837,115,0.0459265175719,224,0.0894568690096,2280,0.91054313099,2134,0.852236421725,WO06,Polk,37149WO06
Randolph,3351,3001,0.8955535661,99,0.0295434198747,18,0.0053715308863,142,0.0423754103253,52,0.0155177558938,39,0.0116383169203,113,20,20,113,133,14,0.00417785735601,113,0.0337212772307,137,0.0408833184124,3214,0.959116681588,2924,0.872575350642,01,Randolph,3715101
Randolph,2852,2593,0.909186535764,105,0.0368162692847,13,0.00455820476858,80,0.0280504908836,20,0.0070126227209,41,0.0143758765778,118,26,23,115,141,13,0.00455820476858,118,0.0413744740533,77,0.0269985974755,2775,0.973001402525,2540,0.890603085554,02,Randolph,3715102
Randolph,5536,4799,0.866871387283,256,0.0462427745665,29,0.00523843930636,276,0.0498554913295,92,0.0166184971098,84,0.0151734104046,297,57,56,296,353,41,0.00740606936416,297,0.0536488439306,248,0.0447976878613,5288,0.955202312139,4672,0.843930635838,03,Randolph,3715103
Randolph,2947,2590,0.878859857482,143,0.0485239226332,13,0.00441126569393,45,0.0152697658636,122,0.0413980318968,34,0.0115371564303,151,34,34,151,185,8,0.00271462504242,151,0.0512385476756,223,0.0756701730573,2724,0.924329826943,2508,0.851034950797,04,Randolph,3715104
Randolph,4152,2172,0.523121387283,1261,0.303709055877,21,0.00505780346821,66,0.0158959537572,508,0.122350674374,124,0.0298651252408,1336,48,43,1331,1379,75,0.018063583815,1336,0.321772639692,933,0.224710982659,3219,0.775289017341,1828,0.440269749518,05,Randolph,3715105
Randolph,3005,2379,0.791680532446,284,0.0945091514143,17,0.00565723793677,24,0.00798668885191,247,0.0821963394343,54,0.0179700499168,310,36,35,309,345,26,0.00865224625624,310,0.103161397671,401,0.133444259567,2604,0.866555740433,2234,0.743427620632,06,Randolph,3715106
Randolph,3360,2417,0.719345238095,303,0.0901785714286,29,0.00863095238095,68,0.0202380952381,443,0.131845238095,100,0.0297619047619,339,51,40,328,379,36,0.0107142857143,339,0.100892857143,683,0.203273809524,2677,0.796726190476,2229,0.663392857143,07,Randolph,3715107
Randolph,3563,2244,0.629806342969,413,0.115913555992,24,0.00673589671625,60,0.0168397417906,725,0.203480213303,97,0.0272242492282,462,37,32,457,494,49,0.0137524557957,462,0.129666011788,1256,0.35251192815,2307,0.64748807185,1778,0.499017681729,08,Randolph,3715108
Randolph,3313,2424,0.731663145186,227,0.0685179595533,30,0.00905523694537,21,0.00633866586176,500,0.150920615756,111,0.0335043766979,276,45,37,268,313,49,0.0147902203441,276,0.0833081798974,1008,0.304255961364,2305,0.695744038636,2007,0.605795351645,09,Randolph,3715109
Randolph,4859,3200,0.658571722577,419,0.0862317349249,69,0.0142004527681,98,0.0201687590039,924,0.190162584894,149,0.0306647458325,476,87,79,468,555,57,0.0117308088084,476,0.0979625437333,1860,0.382794813748,2999,0.617205186252,2416,0.497221650545,10,Randolph,3715110
Randolph,2963,2307,0.778602767465,296,0.0998987512656,24,0.00809989875127,38,0.0128248396895,239,0.0806614917314,59,0.0199122510969,320,35,35,320,355,24,0.00809989875127,320,0.107998650017,366,0.123523455957,2597,0.876476544043,2202,0.743165710429,11,Randolph,3715111
Randolph,1942,1620,0.834191555098,161,0.0829042224511,5,0.00257466529351,37,0.019052523172,91,0.0468589083419,28,0.0144181256437,177,15,7,169,184,16,0.00823892893924,177,0.0911431513903,138,0.0710607621009,1804,0.928939237899,1584,0.815653964985,12,Randolph,3715112
Randolph,4368,4156,0.951465201465,54,0.0123626373626,16,0.003663003663,15,0.00343406593407,77,0.0176282051282,50,0.0114468864469,69,37,36,68,105,15,0.00343406593407,69,0.0157967032967,227,0.0519688644689,4141,0.948031135531,4025,0.921474358974,13,Randolph,3715113
Randolph,1409,1238,0.878637331441,128,0.0908445706175,1,0.000709723207949,7,0.00496806245564,17,0.0120652945351,18,0.0127750177431,134,12,9,131,143,6,0.00425833924769,134,0.0951029098652,27,0.0191625266146,1382,0.980837473385,1230,0.872959545777,14,Randolph,3715114
Randolph,4580,3682,0.803930131004,120,0.0262008733624,28,0.0061135371179,7,0.00152838427948,686,0.149781659389,57,0.0124454148472,132,32,32,132,164,12,0.00262008733624,132,0.0288209606987,1150,0.251091703057,3430,0.748908296943,3272,0.714410480349,15,Randolph,3715115
Randolph,3127,2975,0.95139110969,55,0.0175887432043,13,0.00415733930285,22,0.00703549728174,25,0.0079948832747,37,0.0118324272466,67,25,24,66,91,12,0.00383754397186,67,0.0214262871762,94,0.0300607611129,3033,0.969939238887,2911,0.930924208507,16,Randolph,3715116
Randolph,2290,2130,0.930131004367,86,0.0375545851528,9,0.00393013100437,10,0.00436681222707,27,0.0117903930131,28,0.0122270742358,102,18,17,101,119,16,0.00698689956332,102,0.0445414847162,76,0.0331877729258,2214,0.966812227074,2088,0.911790393013,17,Randolph,3715117
Randolph,2613,2502,0.957520091848,27,0.0103329506315,6,0.00229621125144,34,0.0130118637581,16,0.00612323000383,28,0.0107156525067,42,13,13,42,55,15,0.00574052812859,42,0.01607347876,43,0.0164561806353,2570,0.983543819365,2476,0.947569843092,18,Randolph,3715118
Randolph,3448,3208,0.930394431555,63,0.0182714617169,19,0.00551044083527,17,0.00493039443155,95,0.0275522041763,46,0.0133410672854,81,37,35,79,116,18,0.00522041763341,81,0.0234918793503,174,0.050464037123,3274,0.949535962877,3145,0.912122969838,19,Randolph,3715119
Randolph,3801,3231,0.850039463299,246,0.0647198105762,27,0.00710339384373,1,0.000263088660879,203,0.0534069981584,93,0.0244672454617,306,51,40,295,346,60,0.0157853196527,306,0.0805051302289,495,0.130228887135,3306,0.869771112865,2972,0.781899500132,20,Randolph,3715120
Randolph,5927,5099,0.860300320567,280,0.0472414374895,43,0.00725493504302,31,0.00523030200776,420,0.0708621562342,54,0.00911084865868,297,66,63,294,360,17,0.00286823013329,297,0.0501096676227,751,0.126708284124,5176,0.873291715876,4817,0.812721444238,21,Randolph,3715121
Randolph,3970,3463,0.872292191436,230,0.0579345088161,44,0.0110831234257,20,0.00503778337531,120,0.0302267002519,93,0.0234256926952,270,86,84,268,354,40,0.0100755667506,270,0.0680100755668,315,0.0793450881612,3655,0.920654911839,3296,0.830226700252,22,Randolph,3715122
Randolph,4275,3244,0.758830409357,654,0.15298245614,30,0.00701754385965,6,0.00140350877193,208,0.0486549707602,133,0.0311111111111,710,68,64,706,774,56,0.0130994152047,710,0.166081871345,497,0.116257309942,3778,0.883742690058,3034,0.709707602339,23,Randolph,3715123
Randolph,1198,1172,0.978297161937,10,0.00834724540902,0,0.0,1,0.000834724540902,9,0.00751252086811,6,0.00500834724541,12,0,0,12,12,2,0.0016694490818,12,0.0100166944908,27,0.0225375626043,1171,0.977462437396,1155,0.964106844741,24,Randolph,3715124
Randolph,2831,2607,0.920876015542,78,0.0275521017308,19,0.00671140939597,18,0.0063581773225,64,0.0226068527022,45,0.0158954433063,89,37,36,88,125,11,0.00388555280819,89,0.031437654539,132,0.0466266336983,2699,0.953373366302,2547,0.899682091134,25,Randolph,3715125
Randolph,3789,3586,0.946423858538,35,0.00923726576933,42,0.0110847189232,28,0.00738981261547,39,0.0102929532858,59,0.0155713908683,50,72,69,47,119,15,0.00395882818686,50,0.0131960939562,96,0.0253365003959,3693,0.974663499604,3539,0.934019530219,26,Randolph,3715126
Randolph,571,558,0.977232924694,7,0.0122591943958,0,0.0,0,0.0,3,0.00525394045534,3,0.00525394045534,10,1,0,9,10,3,0.00525394045534,10,0.0175131348511,14,0.0245183887916,557,0.975481611208,549,0.961471103327,27,Randolph,3715127
Randolph,3309,2921,0.882744031429,147,0.0444242973708,23,0.00695074040496,45,0.0135992747053,134,0.0404956180115,39,0.011786038078,158,36,34,156,192,11,0.0033242671502,158,0.047748564521,266,0.0803868238138,3043,0.919613176186,2804,0.847385917196,28,Randolph,3715128
Randolph,4562,4308,0.944322665498,66,0.0144673388865,54,0.0118369136344,21,0.00460324419114,43,0.00942569048663,70,0.0153441473038,92,80,77,89,169,26,0.00569925471285,92,0.0201665935993,127,0.0278386672512,4435,0.972161332749,4242,0.929855326611,29,Randolph,3715129
Randolph,3283,3067,0.934206518428,69,0.0210173621687,36,0.010965580262,8,0.00243679561377,63,0.0191897654584,40,0.0121839780688,83,56,54,81,137,14,0.00426439232409,83,0.0252817544928,107,0.0325921413341,3176,0.967407858666,3029,0.922631739263,30,Randolph,3715130
Randolph,4570,3431,0.750765864333,640,0.140043763676,46,0.0100656455142,38,0.00831509846827,312,0.0682713347921,103,0.0225382932166,700,78,72,694,772,60,0.0131291028446,700,0.153172866521,662,0.144857768053,3908,0.855142231947,3131,0.685120350109,31,Randolph,3715131
Randolph,5848,4977,0.851060191518,195,0.0333447332421,28,0.00478796169631,38,0.00649794801642,474,0.0810533515732,136,0.0232558139535,240,57,50,233,290,45,0.00769493844049,240,0.0410396716826,817,0.139705882353,5031,0.860294117647,4711,0.805574555404,32,Randolph,3715132
Randolph,2388,1951,0.817001675042,205,0.0858458961474,19,0.00795644891122,15,0.00628140703518,144,0.0603015075377,54,0.0226130653266,218,28,27,217,245,13,0.00544388609715,218,0.0912897822446,259,0.108458961474,2129,0.891541038526,1876,0.785594639866,33,Randolph,3715133
Randolph,3811,3462,0.908422986093,162,0.0425085279454,7,0.00183678824456,10,0.00262398320651,104,0.0272894253477,66,0.0173182891629,185,40,34,179,219,23,0.00603516137497,185,0.0485436893204,262,0.0687483600105,3549,0.93125163999,3328,0.873261611126,34,Randolph,3715134
Randolph,2904,2524,0.86914600551,229,0.0788567493113,26,0.00895316804408,6,0.00206611570248,59,0.0203168044077,60,0.0206611570248,252,44,41,249,293,23,0.00792011019284,252,0.0867768595041,174,0.0599173553719,2730,0.940082644628,2434,0.838154269972,35,Randolph,3715135
Randolph,4408,4244,0.96279491833,36,0.00816696914701,36,0.00816696914701,2,0.000453720508167,42,0.00952813067151,48,0.010889292196,52,60,58,50,110,16,0.00362976406534,52,0.0117967332123,101,0.0229128856624,4307,0.977087114338,4199,0.952586206897,36,Randolph,3715136
Randolph,3110,2830,0.909967845659,186,0.059807073955,12,0.00385852090032,23,0.00739549839228,23,0.00739549839228,36,0.011575562701,197,21,18,194,215,11,0.00353697749196,197,0.0633440514469,49,0.0157556270096,3061,0.98424437299,2808,0.902893890675,37,Randolph,3715137
Randolph,5757,5548,0.963696369637,86,0.0149383359389,31,0.00538474900122,31,0.00538474900122,26,0.00451624109779,35,0.00607955532395,93,53,52,92,145,7,0.00121591106479,93,0.0161542470036,90,0.0156331422616,5667,0.984366857738,5504,0.956053500087,38,Randolph,3715138
Randolph,4822,4591,0.95209456657,83,0.0172127747822,14,0.00290335960182,35,0.00725839900456,58,0.0120282040647,41,0.00850269597677,99,28,28,99,127,16,0.00331812525923,99,0.0205309000415,125,0.0259228535877,4697,0.974077146412,4531,0.939651596848,39,Randolph,3715139
Randolph,2940,2718,0.924489795918,32,0.0108843537415,31,0.0105442176871,20,0.00680272108844,107,0.0363945578231,32,0.0108843537415,48,44,44,48,92,16,0.00544217687075,48,0.0163265306122,211,0.071768707483,2729,0.928231292517,2630,0.894557823129,40,Randolph,3715140
Richmond,8063,3690,0.457646037455,3487,0.432469304229,191,0.0236884534292,125,0.0155029145479,449,0.0556864690562,121,0.0150068212824,3546,243,227,3530,3773,59,0.00731737566663,3546,0.439786679896,657,0.0814833188639,7406,0.918516681136,3552,0.440530819794,01,Richmond,3715301
Richmond,7174,5279,0.735851686646,1340,0.18678561472,114,0.0158907164762,101,0.0140786172289,207,0.0288541957067,133,0.0185391692222,1397,172,161,1386,1558,57,0.00794535823808,1397,0.194730972958,323,0.0450236966825,6851,0.954976303318,5192,0.723724560914,02,Richmond,3715302
Richmond,1262,951,0.753565768621,239,0.189381933439,31,0.0245641838352,18,0.0142630744849,11,0.00871632329635,12,0.0095087163233,241,39,39,241,280,2,0.00158478605388,241,0.190966719493,27,0.0213946117274,1235,0.978605388273,940,0.744849445325,03,Richmond,3715303
Richmond,3097,1892,0.610913787536,819,0.264449467226,99,0.0319664191153,11,0.00355182434614,204,0.0658701969648,72,0.0232483048111,844,128,125,841,969,25,0.00807232805941,844,0.272521795286,328,0.105908944139,2769,0.894091055861,1811,0.584759444624,04,Richmond,3715304
Richmond,1147,783,0.682650392328,236,0.205754141238,32,0.0278988666085,13,0.0113339145597,54,0.0470793374019,29,0.025283347864,245,50,45,240,290,9,0.00784655623365,245,0.213600697472,91,0.079337401918,1056,0.920662598082,760,0.662598081953,05,Richmond,3715305
Richmond,2059,1690,0.820786789704,251,0.121903836814,45,0.0218552695483,28,0.0135988343856,14,0.00679941719281,31,0.0150558523555,260,64,63,259,323,9,0.00437105390966,260,0.126274890724,18,0.00874210781933,2041,0.991257892181,1684,0.817872753764,06,Richmond,3715306
Richmond,1437,832,0.578983994433,478,0.332637439109,47,0.0327070285317,2,0.00139178844816,30,0.0208768267223,48,0.0334029227557,503,75,66,494,569,25,0.0173973556019,503,0.350034794711,38,0.026443980515,1399,0.973556019485,832,0.578983994433,07,Richmond,3715307
Richmond,5979,2868,0.479678876066,2705,0.452416792106,141,0.0235825388861,43,0.00719183810002,49,0.00819535039304,173,0.0289346044489,2791,244,210,2757,3001,86,0.0143836762,2791,0.466800468306,147,0.0245860511791,5832,0.975413948821,2802,0.468640240843,08,Richmond,3715308
Richmond,7866,5248,0.667175184338,1918,0.243834223239,341,0.0433511314518,60,0.00762776506484,126,0.0160183066362,173,0.0219933892703,1991,445,425,1971,2416,73,0.00928044749555,1991,0.253114670735,248,0.0315280956013,7618,0.968471904399,5172,0.657513348589,09,Richmond,3715309
Richmond,2308,964,0.417677642981,1106,0.479202772964,46,0.0199306759099,19,0.00823223570191,117,0.0506932409012,56,0.0242634315425,1123,73,70,1120,1193,17,0.00736568457539,1123,0.486568457539,242,0.104852686308,2066,0.895147313692,870,0.376949740035,10,Richmond,3715310
Richmond,1368,930,0.679824561404,394,0.288011695906,15,0.0109649122807,7,0.00511695906433,3,0.00219298245614,19,0.0138888888889,400,22,22,400,422,6,0.00438596491228,400,0.292397660819,18,0.0131578947368,1350,0.986842105263,922,0.673976608187,11,Richmond,3715311
Richmond,2686,1470,0.547282204021,828,0.308265078183,29,0.0107967237528,19,0.00707371556217,271,0.100893521966,69,0.0256887565153,862,53,41,850,903,34,0.0126582278481,862,0.320923306031,360,0.134028294862,2326,0.865971705138,1413,0.526061057334,12,Richmond,3715312
Richmond,1214,701,0.577429983526,315,0.259472817133,29,0.0238879736409,10,0.00823723228995,137,0.112850082372,22,0.0181219110379,326,37,34,323,360,11,0.00906095551895,326,0.268533772652,208,0.171334431631,1006,0.828665568369,653,0.537891268534,13,Richmond,3715313
Richmond,191,77,0.403141361257,107,0.560209424084,0,0.0,1,0.00523560209424,5,0.0261780104712,1,0.00523560209424,107,0,0,107,107,0,0.0,107,0.560209424084,7,0.0366492146597,184,0.96335078534,75,0.392670157068,14,Richmond,3715314
Richmond,276,224,0.811594202899,41,0.148550724638,4,0.0144927536232,0,0.0,2,0.00724637681159,5,0.018115942029,42,8,7,41,49,1,0.0036231884058,42,0.152173913043,6,0.0217391304348,270,0.978260869565,220,0.797101449275,15,Richmond,3715315
Richmond,512,473,0.923828125,5,0.009765625,9,0.017578125,0,0.0,21,0.041015625,4,0.0078125,5,13,13,5,18,0,0.0,5,0.009765625,23,0.044921875,489,0.955078125,471,0.919921875,16,Richmond,3715316
Robeson,2169,244,0.112494236976,234,0.107883817427,1635,0.753803596127,0,0.0,20,0.00922083909636,36,0.0165975103734,240,1668,1664,236,1904,6,0.00276625172891,240,0.110650069156,45,0.0207468879668,2124,0.979253112033,241,0.111111111111,01,Robeson,3715501
Robeson,5424,703,0.129609144543,1697,0.312868731563,2764,0.509587020649,7,0.00129056047198,114,0.021017699115,139,0.0256268436578,1774,2884,2823,1713,4597,77,0.0141961651917,1774,0.327064896755,220,0.0405604719764,5204,0.959439528024,637,0.11744100295,02,Robeson,3715502
Robeson,3495,2037,0.582832618026,762,0.218025751073,579,0.165665236052,12,0.00343347639485,25,0.0071530758226,80,0.0228898426323,798,638,616,776,1414,36,0.0103004291845,798,0.228326180258,81,0.0231759656652,3414,0.976824034335,2008,0.574535050072,03,Robeson,3715503
Robeson,3843,316,0.0822274264897,160,0.0416341399948,3206,0.834244080146,14,0.00364298724954,83,0.0215977101223,64,0.0166536559979,176,3258,3248,166,3424,16,0.00416341399948,176,0.0457975539943,192,0.0499609679938,3651,0.950039032006,222,0.0577673692428,04,Robeson,3715504
Robeson,4233,1238,0.292463973541,1811,0.42782896291,992,0.234349161351,4,0.000944956295771,79,0.0186628868415,109,0.0257500590598,1879,1069,1030,1840,2909,68,0.0160642570281,1879,0.443893219939,117,0.0276399716513,4116,0.972360028349,1207,0.285140562249,05,Robeson,3715505
Robeson,1335,258,0.193258426966,658,0.492883895131,346,0.259176029963,1,0.000749063670412,30,0.0224719101124,42,0.0314606741573,680,379,364,665,1044,22,0.0164794007491,680,0.50936329588,34,0.025468164794,1301,0.974531835206,258,0.193258426966,06,Robeson,3715506
Robeson,1511,284,0.187954996691,455,0.301125082727,642,0.42488418266,3,0.00198544010589,96,0.0635340833885,31,0.0205162144275,469,671,659,457,1128,14,0.00926538716082,469,0.310390469887,144,0.0953011250827,1367,0.904698874917,258,0.170747849107,07,Robeson,3715507
Robeson,2460,1650,0.670731707317,340,0.138211382114,348,0.141463414634,5,0.0020325203252,71,0.0288617886179,46,0.0186991869919,354,385,376,345,730,14,0.00569105691057,354,0.143902439024,81,0.0329268292683,2379,0.967073170732,1637,0.665447154472,08,Robeson,3715508
Robeson,2404,1000,0.415973377704,704,0.292845257903,394,0.163893510815,17,0.00707154742097,226,0.0940099833611,63,0.0262063227953,743,417,405,731,1148,39,0.0162229617304,743,0.309068219634,352,0.146422628952,2052,0.853577371048,910,0.37853577371,09,Robeson,3715509
Robeson,2486,840,0.337892196299,561,0.225663716814,678,0.272727272727,8,0.00321802091714,314,0.126307320998,85,0.0341914722446,589,726,711,574,1300,28,0.01126307321,589,0.236926790024,464,0.186645213194,2022,0.813354786806,735,0.295655671762,10,Robeson,3715510
Robeson,7504,4050,0.539712153518,796,0.106076759062,1981,0.263992537313,232,0.0309168443497,228,0.0303837953092,217,0.0289179104478,874,2122,2078,830,2952,78,0.01039445629,874,0.116471215352,396,0.0527718550107,7108,0.947228144989,3961,0.527851812367,11,Robeson,3715511
Robeson,3962,1278,0.322564361434,1423,0.359162039374,522,0.131751640586,89,0.0224634023221,505,0.127460878344,145,0.0365976779404,1499,598,559,1460,2058,76,0.0191822311964,1499,0.37834427057,725,0.182988389702,3237,0.817011610298,1163,0.29353861686,12,Robeson,3715512
Robeson,2736,1421,0.519371345029,815,0.297880116959,332,0.12134502924,33,0.0120614035088,67,0.0244883040936,68,0.0248538011696,841,378,365,828,1206,26,0.00950292397661,841,0.307383040936,153,0.0559210526316,2583,0.944078947368,1372,0.501461988304,13,Robeson,3715513
Robeson,2783,1221,0.438735177866,890,0.319798778297,400,0.143729787999,21,0.00754581386992,154,0.0553359683794,97,0.0348544735897,940,461,435,914,1375,50,0.0179662234998,940,0.337765001797,306,0.109953287819,2477,0.890046712181,1116,0.401006108516,14,Robeson,3715514
Robeson,2175,384,0.176551724138,1425,0.655172413793,255,0.11724137931,28,0.0128735632184,40,0.0183908045977,43,0.0197701149425,1443,290,277,1430,1720,18,0.00827586206897,1443,0.663448275862,67,0.0308045977011,2108,0.969195402299,381,0.175172413793,15,Robeson,3715515
Robeson,2219,57,0.0256872465074,1912,0.861649391618,187,0.0842721946823,7,0.00315457413249,5,0.00225326723749,51,0.0229833258224,1954,227,195,1922,2149,42,0.018927444795,1954,0.880576836413,19,0.00856241550248,2200,0.991437584498,57,0.0256872465074,16,Robeson,3715516
Robeson,1100,176,0.16,413,0.375454545455,473,0.43,3,0.00272727272727,3,0.00272727272727,32,0.0290909090909,435,493,483,425,918,22,0.02,435,0.395454545455,24,0.0218181818182,1076,0.978181818182,171,0.155454545455,17,Robeson,3715517
Robeson,2554,1602,0.627251370399,395,0.15465935787,195,0.0763508222396,195,0.0763508222396,112,0.043852779953,55,0.0215348472984,429,219,205,415,634,34,0.0133124510572,429,0.167971808927,188,0.0736100234926,2366,0.926389976507,1549,0.606499608457,18A,Robeson,3715518A
Robeson,5558,658,0.11838790932,2324,0.418136020151,2428,0.436847786974,18,0.00323857502699,32,0.00575746671465,98,0.0176322418136,2362,2516,2485,2331,4847,38,0.00683699172364,2362,0.424973011875,84,0.0151133501259,5474,0.984886649874,628,0.112990284275,19,Robeson,3715519
Robeson,1757,947,0.538986909505,587,0.334092202618,171,0.0973249857712,1,0.000569151963574,15,0.00853727945361,36,0.0204894706887,606,202,187,591,793,19,0.0108138873079,606,0.344906089926,33,0.018782014798,1724,0.981217985202,936,0.532726237906,20,Robeson,3715520
Robeson,4144,2167,0.522924710425,1366,0.329633204633,350,0.0844594594595,18,0.00434362934363,112,0.027027027027,131,0.031611969112,1420,418,397,1399,1817,54,0.0130308880309,1420,0.342664092664,240,0.0579150579151,3904,0.942084942085,2080,0.501930501931,21,Robeson,3715521
Robeson,6447,1128,0.174965100047,1363,0.211416162556,3571,0.553901039243,158,0.0245075228789,67,0.0103924305879,160,0.0248177446875,1452,3662,3617,1407,5069,89,0.0138048704824,1452,0.225221033039,154,0.0238870792617,6293,0.976112920738,1096,0.170001551109,22,Robeson,3715522
Robeson,6760,586,0.0866863905325,360,0.0532544378698,5576,0.824852071006,27,0.00399408284024,45,0.00665680473373,166,0.0245562130178,415,5712,5678,381,6093,55,0.00813609467456,415,0.0613905325444,147,0.0217455621302,6613,0.97825443787,542,0.0801775147929,23,Robeson,3715523
Robeson,2313,277,0.119757890186,274,0.118460873325,1442,0.623432771293,7,0.00302637267618,267,0.115434500649,46,0.019887591872,279,1480,1477,276,1756,5,0.0021616947687,279,0.120622568093,356,0.153912667531,1957,0.846087332469,199,0.0860354517942,24,Robeson,3715524
Robeson,3860,649,0.168134715026,531,0.137564766839,2335,0.604922279793,13,0.00336787564767,240,0.0621761658031,92,0.0238341968912,556,2410,2393,539,2949,25,0.00647668393782,556,0.144041450777,334,0.0865284974093,3526,0.913471502591,586,0.151813471503,25,Robeson,3715525
Robeson,4645,888,0.191173304629,1831,0.39418729817,1094,0.235522066738,15,0.0032292787944,625,0.1345532831,192,0.0413347685684,1890,1160,1136,1866,3026,59,0.0127018299247,1890,0.406889128095,961,0.206889128095,3684,0.793110871905,687,0.147900968784,26,Robeson,3715526
Robeson,1526,629,0.412188728702,541,0.354521625164,245,0.160550458716,10,0.00655307994758,68,0.0445609436435,33,0.021625163827,556,264,255,547,811,15,0.00982961992136,556,0.364351245085,102,0.0668414154653,1424,0.933158584535,613,0.401703800786,27,Robeson,3715527
Robeson,2947,479,0.162538174415,305,0.103495079742,1579,0.535799117747,2,0.000678656260604,516,0.175093315236,66,0.0223956565999,314,1617,1611,308,1925,9,0.00305395317272,314,0.106549032915,890,0.302002035969,2057,0.697997964031,209,0.0709195792331,28,Robeson,3715528
Robeson,2429,445,0.183202964183,1170,0.481679703582,757,0.311650885138,1,0.000411692054343,21,0.00864553314121,35,0.014409221902,1192,790,769,1171,1961,22,0.00905722519555,1192,0.490736928777,40,0.0164676821737,2389,0.983532317826,442,0.18196788802,29,Robeson,3715529
Robeson,5341,1143,0.214004868002,386,0.072271110279,3055,0.571990263996,24,0.00449354053548,580,0.108593896274,153,0.0286463209137,422,3142,3118,398,3540,36,0.00674031080322,422,0.0790114210822,1052,0.196966860139,4289,0.803033139861,775,0.145103913125,30,Robeson,3715530
Robeson,5233,2616,0.499904452513,1526,0.291610930633,315,0.0601949168737,32,0.00611503917447,619,0.118287789031,125,0.0238868717753,1577,377,366,1566,1943,51,0.00974584368431,1577,0.301356774317,915,0.174851901395,4318,0.825148098605,2370,0.452895088859,31,Robeson,3715531
Robeson,3762,1523,0.404837852206,836,0.222222222222,604,0.160552897395,14,0.00372142477406,664,0.176501860712,121,0.0321637426901,870,677,660,853,1530,34,0.00903774587985,870,0.231259968102,849,0.225677830941,2913,0.774322169059,1434,0.381180223285,32,Robeson,3715532
Robeson,1477,262,0.177386594448,176,0.119160460393,773,0.523358158429,1,0.000677048070413,207,0.140148950575,58,0.039268788084,185,791,784,178,969,9,0.00609343263372,185,0.125253893026,423,0.286391333785,1054,0.713608666215,104,0.070412999323,33,Robeson,3715533
Robeson,3227,222,0.068794546018,296,0.0917260613573,2620,0.811899597149,3,0.00092965602727,18,0.00557793616362,68,0.0210722032848,324,2679,2656,301,2980,28,0.00867678958785,324,0.100402850945,81,0.0251007127363,3146,0.974899287264,197,0.0610474124574,34,Robeson,3715534
Robeson,3925,138,0.0351592356688,39,0.00993630573248,3656,0.931464968153,3,0.000764331210191,13,0.00331210191083,76,0.0193630573248,56,3721,3711,46,3767,17,0.00433121019108,56,0.0142675159236,47,0.011974522293,3878,0.988025477707,129,0.0328662420382,35,Robeson,3715535
Robeson,2147,642,0.299021891011,867,0.40381928272,577,0.268747088961,2,0.00093153237075,33,0.0153702841174,26,0.0121099208197,877,599,593,871,1470,10,0.00465766185375,877,0.408476944574,68,0.0316721006055,2079,0.968327899395,613,0.285514671635,36,Robeson,3715536
Robeson,978,735,0.751533742331,118,0.120654396728,89,0.0910020449898,0,0.0,18,0.0184049079755,18,0.0184049079755,122,103,102,121,224,4,0.0040899795501,122,0.124744376278,51,0.0521472392638,927,0.947852760736,704,0.719836400818,37,Robeson,3715537
Robeson,858,162,0.188811188811,130,0.151515151515,513,0.597902097902,0,0.0,24,0.027972027972,29,0.0337995337995,140,540,530,130,670,10,0.011655011655,140,0.16317016317,35,0.0407925407925,823,0.959207459207,160,0.18648018648,38,Robeson,3715538
Robeson,3041,261,0.085827030582,544,0.178888523512,2146,0.705688918119,11,0.00361723117396,20,0.00657678395265,59,0.0194015126603,577,2192,2171,556,2748,33,0.0108516935219,577,0.189740217034,45,0.0147977638935,2996,0.985202236107,255,0.0838539953963,39,Robeson,3715539
Robeson,1053,476,0.452041785375,454,0.431149097816,67,0.0636277302944,4,0.00379867046534,38,0.0360873694207,14,0.0132953466287,458,77,76,457,534,4,0.00379867046534,458,0.434947768281,53,0.0503323836657,1000,0.949667616334,471,0.447293447293,40,Robeson,3715540
Robeson,6347,3085,0.486056404601,1162,0.18307861982,1610,0.253663147944,36,0.00567197100993,258,0.0406491255711,196,0.030880731054,1245,1744,1704,1205,2949,83,0.0130770442729,1245,0.196155664093,364,0.0573499291004,5983,0.9426500709,3047,0.48006932409,41,Robeson,3715541
Rockingham,6378,5557,0.871276262151,520,0.0815302602697,17,0.00266541235497,27,0.00423330197554,144,0.0225776105362,113,0.0177171527124,574,61,45,558,619,54,0.00846660395108,574,0.0899968642208,274,0.0429601756036,6104,0.957039824396,5445,0.853715898401,AV,Rockingham,37157AV
Rockingham,7238,3641,0.503039513678,3108,0.429400386847,36,0.0049737496546,20,0.00276319425256,273,0.0377176015474,160,0.0221055540204,3222,86,61,3197,3283,114,0.0157502072396,3222,0.445150594087,490,0.0676982591876,6748,0.932301740812,3463,0.47844708483,CO,Rockingham,37157CO
Rockingham,3949,2810,0.711572550013,893,0.226133198278,22,0.00557103064067,12,0.00303874398582,110,0.0278551532033,102,0.0258293238795,954,45,41,950,995,61,0.0154469485946,954,0.241580146873,304,0.0769815143074,3645,0.923018485693,2659,0.673335021524,DR,Rockingham,37157DR
Rockingham,6497,5047,0.776820070802,1243,0.19131907034,16,0.00246267508081,49,0.00754194243497,47,0.00723410804987,95,0.0146221332923,1298,39,30,1289,1328,55,0.00846544559027,1298,0.19978451593,242,0.0372479605972,6255,0.962752039403,4860,0.748037555795,EC,Rockingham,37157EC
Rockingham,7034,5321,0.756468581177,1284,0.182541939153,40,0.00568666477111,68,0.00966733011089,193,0.0274381575206,128,0.0181973272676,1360,64,60,1356,1420,76,0.0108046630651,1360,0.193346602218,388,0.0551606482798,6646,0.94483935172,5169,0.734859255047,ED-1,Rockingham,37157ED-1
Rockingham,2724,2314,0.849486049927,313,0.114904552129,7,0.00256975036711,25,0.00917767988253,36,0.0132158590308,29,0.0106461086637,325,22,21,324,346,12,0.00440528634361,325,0.119309838473,82,0.0301027900147,2642,0.969897209985,2264,0.831130690162,HO,Rockingham,37157HO
Rockingham,6052,5422,0.895902181097,257,0.042465300727,25,0.00413086582948,40,0.00660938532716,183,0.0302379378718,125,0.0206543291474,296,63,62,295,358,39,0.00644415069399,296,0.048909451421,435,0.0718770654329,5617,0.928122934567,5221,0.862690019828,HU,Rockingham,37157HU
Rockingham,3435,3054,0.889082969432,250,0.0727802037846,16,0.00465793304221,10,0.00291120815138,61,0.0177583697234,44,0.0128093158661,269,31,27,265,296,19,0.00553129548763,269,0.0783114992722,111,0.0323144104803,3324,0.96768558952,3007,0.875400291121,IR,Rockingham,37157IR
Rockingham,5726,4643,0.810862731401,855,0.149318896263,24,0.00419140761439,27,0.00471533356619,89,0.01554313657,88,0.0153684945861,905,62,46,889,951,50,0.00873209919665,905,0.158050995459,160,0.0279427174293,5566,0.972057282571,4591,0.801781348236,LI,Rockingham,37157LI
Rockingham,4923,3627,0.736745886654,1067,0.216737761528,15,0.00304692260817,15,0.00304692260817,111,0.0225472273004,88,0.0178752793012,1118,44,38,1112,1156,51,0.0103595368678,1118,0.227097298395,220,0.0446881982531,4703,0.955311801747,3538,0.718667479179,LK-2,Rockingham,37157LK-2
Rockingham,6293,5002,0.794851422215,739,0.117432067376,13,0.00206578738281,15,0.00238360082631,416,0.0661051962498,108,0.0171619259495,787,49,40,778,827,48,0.00762752264421,787,0.125059590021,637,0.101223581758,5656,0.898776418242,4819,0.765771492134,MA,Rockingham,37157MA
Rockingham,6241,4206,0.673930459862,1702,0.272712706297,14,0.00224323025156,80,0.0128184585804,135,0.0216311488544,104,0.0166639961545,1777,36,28,1769,1805,75,0.0120173049191,1777,0.284730011216,225,0.0360519147573,6016,0.963948085243,4142,0.663675692998,MC,Rockingham,37157MC
Rockingham,3598,2616,0.727070594775,811,0.225403001668,23,0.00639244024458,10,0.00277932184547,68,0.0188993885492,70,0.0194552529183,863,40,37,860,900,52,0.0144524735964,863,0.239855475264,148,0.041133963313,3450,0.958866036687,2543,0.706781545303,MD,Rockingham,37157MD
Rockingham,4735,4388,0.92671594509,133,0.0280887011616,23,0.00485744456177,31,0.0065469904963,82,0.0173178458289,78,0.0164730728617,162,52,50,160,212,29,0.00612460401267,162,0.0342133051742,164,0.0346356916579,4571,0.965364308342,4324,0.913199577614,NB,Rockingham,37157NB
Rockingham,6781,5613,0.827754018581,966,0.142456864769,11,0.00162217961953,20,0.00294941749005,77,0.0113552573367,94,0.0138622622032,1007,53,41,995,1048,41,0.00604630585459,1007,0.148503170624,206,0.0303790001475,6575,0.969620999853,5498,0.810794868014,RC,Rockingham,37157RC
Rockingham,1980,1383,0.698484848485,480,0.242424242424,14,0.00707070707071,6,0.0030303030303,56,0.0282828282828,41,0.0207070707071,506,36,22,492,528,26,0.0131313131313,506,0.255555555556,104,0.0525252525253,1876,0.947474747475,1338,0.675757575758,RD-1,Rockingham,37157RD-1
Rockingham,5595,3392,0.606255585344,1929,0.344772117962,11,0.00196604110813,29,0.00518319928508,132,0.0235924932976,102,0.0182305630027,2004,28,20,1996,2024,75,0.0134048257373,2004,0.3581769437,237,0.0423592493298,5358,0.95764075067,3309,0.591420911528,VA,Rockingham,37157VA
Rockingham,4464,2839,0.635976702509,1105,0.247535842294,18,0.00403225806452,6,0.00134408602151,395,0.0884856630824,101,0.0226254480287,1150,63,51,1138,1201,45,0.0100806451613,1150,0.257616487455,732,0.163978494624,3732,0.836021505376,2554,0.572132616487,WM,Rockingham,37157WM
Rowan,2751,2589,0.941112322792,37,0.013449654671,15,0.00545256270447,26,0.00945110868775,38,0.0138131588513,46,0.0167211922937,55,32,32,55,87,18,0.00654307524537,55,0.0199927299164,61,0.0221737549982,2690,0.977826245002,2572,0.934932751727,01,Rowan,3715901
Rowan,2275,1375,0.604395604396,690,0.303296703297,5,0.0021978021978,15,0.00659340659341,147,0.0646153846154,43,0.0189010989011,715,21,14,708,729,25,0.010989010989,715,0.314285714286,281,0.123516483516,1994,0.876483516484,1269,0.557802197802,02,Rowan,3715902
Rowan,3416,3159,0.924765807963,83,0.0242974238876,13,0.0038056206089,30,0.00878220140515,86,0.0251756440281,45,0.0131733021077,98,32,31,97,129,15,0.00439110070258,98,0.0286885245902,155,0.04537470726,3261,0.95462529274,3102,0.908079625293,03,Rowan,3715903
Rowan,5309,5004,0.942550386137,124,0.0233565643247,16,0.00301375023545,26,0.00489734413261,81,0.015257110567,58,0.0109248446035,143,33,33,143,176,19,0.0035788284046,143,0.0269353927293,243,0.0457713317009,5066,0.954228668299,4858,0.915049915238,04,Rowan,3715904
Rowan,3659,3216,0.878928669035,142,0.0388084176004,17,0.00464607816343,56,0.0153047280678,177,0.0483738726428,51,0.0139382344903,166,32,25,159,191,24,0.0065591691719,166,0.0453675867723,322,0.0880021863897,3337,0.91199781361,3081,0.842033342443,05,Rowan,3715905
Rowan,2566,2015,0.785268901013,278,0.108339828527,14,0.00545596258769,44,0.0171473109899,186,0.0724863600935,29,0.0113016367888,300,22,16,294,316,22,0.00857365549493,300,0.116913484022,251,0.0978176149649,2315,0.902182385035,1954,0.761496492595,06,Rowan,3715906
Rowan,2817,2038,0.723464678736,575,0.204117855875,6,0.00212992545261,26,0.00922967696131,92,0.03265885694,80,0.0283990060348,617,32,26,611,643,42,0.0149094781683,617,0.219027334043,178,0.0631877884274,2639,0.936812211573,1976,0.701455449059,07,Rowan,3715907
Rowan,5102,4125,0.808506468052,436,0.0854566836535,7,0.00137201097609,62,0.0121520972168,381,0.0746765974128,91,0.0178361426891,485,29,25,481,510,49,0.00960407683261,485,0.0950607604861,626,0.122696981576,4476,0.877303018424,3896,0.763622108977,08,Rowan,3715908
Rowan,3064,2835,0.925261096606,59,0.0192558746736,2,0.00065274151436,18,0.00587467362924,126,0.0411227154047,24,0.00783289817232,68,11,11,68,79,9,0.00293733681462,68,0.0221932114883,198,0.0646214099217,2866,0.935378590078,2770,0.904046997389,09,Rowan,3715909
Rowan,3365,3189,0.947696879643,83,0.0246656760773,0,0.0,32,0.00950965824666,31,0.00921248142645,30,0.00891530460624,100,5,3,98,103,17,0.00505200594354,100,0.0297176820208,77,0.022882615156,3288,0.977117384844,3152,0.936701337296,10,Rowan,3715910
Rowan,3300,2681,0.812424242424,388,0.117575757576,15,0.00454545454545,44,0.0133333333333,111,0.0336363636364,61,0.0184848484848,405,28,27,404,432,17,0.00515151515152,405,0.122727272727,188,0.0569696969697,3112,0.94303030303,2624,0.795151515152,11,Rowan,3715911
Rowan,2310,1448,0.62683982684,678,0.293506493506,7,0.0030303030303,28,0.0121212121212,105,0.0454545454545,44,0.0190476190476,700,23,19,696,719,22,0.00952380952381,700,0.30303030303,187,0.0809523809524,2123,0.919047619048,1390,0.601731601732,12,Rowan,3715912
Rowan,3142,2894,0.921069382559,84,0.026734563972,10,0.00318268618714,14,0.004455760662,88,0.0280076384468,52,0.0165499681731,98,37,35,96,133,14,0.004455760662,98,0.031190324634,157,0.0499681731381,2985,0.950031826862,2829,0.900381922342,13,Rowan,3715913
Rowan,2481,2117,0.85328496574,259,0.104393389762,1,0.000403063280935,26,0.0104796453043,43,0.0173317210802,35,0.0141072148327,275,19,13,269,288,16,0.00644901249496,275,0.110842402257,81,0.0326481257557,2400,0.967351874244,2081,0.838774687626,14,Rowan,3715914
Rowan,4371,3841,0.878746282315,333,0.0761839396019,13,0.00297414779227,31,0.00709219858156,94,0.0215053763441,59,0.0134980553649,366,41,29,354,395,33,0.00754975978037,366,0.0837336993823,169,0.0386639212995,4202,0.961336078701,3764,0.861130176161,15,Rowan,3715915
Rowan,3788,2477,0.653907074974,554,0.146251319958,9,0.00237592397043,49,0.0129355860612,609,0.160770855333,90,0.0237592397043,606,27,19,598,625,52,0.0137275607181,606,0.159978880676,860,0.227032734952,2928,0.772967265048,2294,0.605596620908,16,Rowan,3715916
Rowan,4179,3250,0.777698013879,434,0.103852596315,20,0.00478583393156,49,0.0117252931323,323,0.0772912179947,103,0.0246470447475,477,47,44,474,521,43,0.0102895429529,477,0.114142139268,576,0.137832017229,3603,0.862167982771,3049,0.729600382867,17,Rowan,3715917
Rowan,1663,226,0.135898977751,1354,0.814191220686,10,0.00601322910403,2,0.00120264582081,23,0.0138304269393,48,0.0288634996993,1397,20,12,1389,1409,43,0.0258568851473,1397,0.840048105833,44,0.0264582080577,1619,0.973541791942,214,0.128683102826,18,Rowan,3715918
Rowan,3596,3216,0.894327030033,267,0.0742491657397,12,0.00333704115684,15,0.00417130144605,45,0.0125139043382,41,0.0114015572859,283,34,30,279,313,16,0.00444938820912,283,0.0786985539488,122,0.0339265850945,3474,0.966073414905,3150,0.875973303671,19,Rowan,3715919
Rowan,2144,1888,0.880597014925,120,0.0559701492537,13,0.00606343283582,13,0.00606343283582,90,0.0419776119403,20,0.00932835820896,129,14,14,129,143,9,0.00419776119403,129,0.0601679104478,219,0.102145522388,1925,0.897854477612,1770,0.825559701493,20,Rowan,3715920
Rowan,3712,2894,0.77963362069,411,0.110721982759,16,0.00431034482759,33,0.0088900862069,287,0.0773168103448,71,0.0191271551724,446,48,47,445,493,35,0.00942887931034,446,0.120150862069,594,0.160021551724,3118,0.839978448276,2610,0.703125,21,Rowan,3715921
Rowan,1153,1111,0.963573287077,16,0.0138768430182,5,0.00433651344319,4,0.00346921075455,6,0.00520381613183,11,0.00954032957502,18,15,14,17,32,2,0.00173460537728,18,0.0156114483955,9,0.00780572419775,1144,0.992194275802,1108,0.960971379011,22,Rowan,3715922
Rowan,2292,2227,0.971640488656,14,0.00610820244328,6,0.00261780104712,2,0.00087260034904,19,0.00828970331588,24,0.0104712041885,26,16,13,23,39,12,0.00523560209424,26,0.0113438045375,38,0.0165794066318,2254,0.983420593368,2212,0.965095986038,23,Rowan,3715923
Rowan,1692,1551,0.916666666667,100,0.0591016548463,0,0.0,2,0.00118203309693,18,0.0106382978723,21,0.0124113475177,109,8,6,107,115,9,0.00531914893617,109,0.0644208037825,31,0.0183215130024,1661,0.981678486998,1539,0.909574468085,24,Rowan,3715924
Rowan,5215,4976,0.954170661553,70,0.0134228187919,9,0.00172579098754,21,0.00402684563758,83,0.0159156279962,56,0.0107382550336,84,42,40,82,124,14,0.00268456375839,84,0.0161073825503,158,0.030297219559,5057,0.969702780441,4907,0.940939597315,25,Rowan,3715925
Rowan,2477,2418,0.976180863948,25,0.0100928542592,9,0.00363342753331,6,0.0024222850222,7,0.00282599919257,12,0.00484457004441,26,17,17,26,43,1,0.000403714170367,26,0.0104965684296,36,0.0145337101332,2441,0.985466289867,2389,0.964473153008,26,Rowan,3715926
Rowan,1820,1516,0.832967032967,222,0.121978021978,3,0.00164835164835,6,0.0032967032967,57,0.0313186813187,16,0.00879120879121,234,6,6,234,240,12,0.00659340659341,234,0.128571428571,76,0.0417582417582,1744,0.958241758242,1501,0.824725274725,27,Rowan,3715927
Rowan,3439,1994,0.579819715033,1145,0.332945623728,13,0.00378016865368,36,0.0104681593486,172,0.0500145391102,79,0.0229717941262,1198,29,18,1187,1216,53,0.0154114568188,1198,0.348357080547,304,0.0883977900552,3135,0.911602209945,1897,0.551613841233,28,Rowan,3715928
Rowan,1725,1518,0.88,115,0.0666666666667,8,0.00463768115942,2,0.00115942028986,75,0.0434782608696,7,0.00405797101449,118,11,10,117,128,3,0.00173913043478,118,0.0684057971014,200,0.115942028986,1525,0.884057971014,1389,0.805217391304,29,Rowan,3715929
Rowan,5707,3824,0.670054319257,879,0.154021377256,25,0.00438058524619,103,0.0180480112143,781,0.136849483091,95,0.0166462239355,909,51,49,907,958,30,0.00525670229543,909,0.159278079551,1329,0.232871911687,4378,0.767128088313,3329,0.583318731383,30,Rowan,3715930
Rowan,2149,1893,0.8808748255,146,0.0679385760819,13,0.00604932526757,31,0.0144253140996,39,0.0181479758027,27,0.012563983248,157,22,18,153,175,11,0.00511865984179,157,0.0730572359237,86,0.0400186133085,2063,0.959981386691,1859,0.865053513262,31,Rowan,3715931
Rowan,2215,1694,0.764785553047,318,0.143566591422,10,0.00451467268623,18,0.00812641083521,145,0.0654627539503,30,0.0135440180587,339,18,14,335,353,21,0.00948081264108,339,0.153047404063,190,0.0857787810384,2025,0.914221218962,1653,0.746275395034,32,Rowan,3715932
Rowan,2294,2212,0.964254577158,22,0.00959023539669,0,0.0,6,0.00261551874455,30,0.0130775937228,24,0.0104620749782,27,9,9,27,36,5,0.00217959895379,27,0.0117698343505,50,0.0217959895379,2244,0.978204010462,2195,0.956843940715,33,Rowan,3715933
Rowan,4415,2821,0.638958097395,1159,0.262514156285,14,0.00317100792752,151,0.034201585504,183,0.041449603624,87,0.0197055492639,1191,34,29,1186,1220,32,0.00724801812005,1191,0.269762174405,411,0.0930917327293,4004,0.906908267271,2626,0.594790486976,34,Rowan,3715934
Rowan,1881,896,0.476342371079,757,0.402445507709,8,0.00425305688464,14,0.00744284954811,155,0.0824029771398,51,0.0271132376396,770,29,25,766,795,13,0.00691121743753,770,0.409356725146,261,0.138755980861,1620,0.861244019139,819,0.435406698565,35,Rowan,3715935
Rowan,4192,2027,0.483540076336,1736,0.414122137405,22,0.00524809160305,54,0.0128816793893,254,0.0605916030534,99,0.0236164122137,1809,47,32,1794,1841,73,0.0174141221374,1809,0.431536259542,400,0.0954198473282,3792,0.904580152672,1905,0.454437022901,36,Rowan,3715936
Rowan,4217,1959,0.464548257055,2007,0.475930756462,16,0.00379416646905,35,0.00829973915106,125,0.0296419255395,75,0.0177851553237,2038,47,38,2029,2076,31,0.00735119753379,2038,0.483281953996,281,0.0666350486128,3936,0.933364951387,1830,0.433957789898,38,Rowan,3715938
Rowan,3063,2243,0.732288605942,624,0.203721841332,11,0.0035912504081,97,0.0316682990532,36,0.0117531831538,52,0.016976820111,646,31,20,635,666,22,0.00718250081619,646,0.210904342148,102,0.0333006856024,2961,0.966699314398,2200,0.718250081619,39,Rowan,3715939
Rowan,3546,2170,0.6119571348,1130,0.31866892273,15,0.00423011844332,39,0.0109983079526,104,0.029328821207,88,0.0248166948675,1181,43,34,1172,1215,51,0.0143824027073,1181,0.333051325437,183,0.0516074450085,3363,0.948392554992,2102,0.592780597857,40,Rowan,3715940
Rowan,3963,2150,0.542518294222,1423,0.359071410548,11,0.00277567499369,93,0.0234670704012,202,0.0509714862478,84,0.0211960635882,1479,42,25,1462,1504,56,0.0141307090588,1479,0.373202119606,330,0.0832702498107,3633,0.916729750189,2064,0.520817562453,41,Rowan,3715941
Rowan,2661,134,0.0503570086434,2332,0.876362269823,7,0.00263059000376,1,0.000375798571965,141,0.0529875986471,46,0.0172867343104,2371,13,7,2365,2378,39,0.0146561443067,2371,0.89101841413,212,0.0796692972567,2449,0.920330702743,86,0.032318677189,42,Rowan,3715942
Rowan,4055,3806,0.93859432799,91,0.0224414303329,18,0.00443896424168,18,0.00443896424168,77,0.0189889025894,45,0.0110974106042,111,34,32,109,143,20,0.00493218249075,111,0.0273736128237,153,0.0377311960543,3902,0.962268803946,3753,0.92552404439,44,Rowan,3715944
Rowan,1622,949,0.585080147965,538,0.331689272503,10,0.00616522811344,24,0.0147965474723,56,0.0345252774353,45,0.0277435265105,570,24,22,568,592,32,0.019728729963,570,0.351418002466,67,0.04130702836,1555,0.95869297164,937,0.577681874229,45,Rowan,3715945
Rowan,3625,3357,0.926068965517,134,0.0369655172414,14,0.00386206896552,33,0.00910344827586,65,0.0179310344828,22,0.00606896551724,145,24,22,143,167,11,0.00303448275862,145,0.04,148,0.0408275862069,3477,0.959172413793,3281,0.905103448276,46,Rowan,3715946
Rutherford,2920,2773,0.949657534247,98,0.0335616438356,3,0.00102739726027,8,0.0027397260274,12,0.0041095890411,26,0.00890410958904,105,12,12,105,117,7,0.00239726027397,105,0.0359589041096,46,0.0157534246575,2874,0.984246575342,2742,0.93904109589,03A,Rutherford,3716103A
Rutherford,3398,3037,0.893761035903,256,0.0753384343732,10,0.0029429075927,13,0.00382577987051,33,0.00971159505592,49,0.0144202472042,275,24,23,274,298,19,0.00559152442613,275,0.0809299587993,85,0.025014714538,3313,0.974985285462,2995,0.881400824014,04A,Rutherford,3716104A
Rutherford,5175,4581,0.885217391304,348,0.0672463768116,21,0.00405797101449,4,0.000772946859903,119,0.0229951690821,102,0.0197101449275,389,69,65,385,454,41,0.00792270531401,389,0.0751690821256,270,0.0521739130435,4905,0.947826086957,4453,0.860483091787,05A,Rutherford,3716105A
Rutherford,2666,2391,0.896849212303,199,0.0746436609152,7,0.0026256564141,10,0.00375093773443,24,0.00900225056264,35,0.0131282820705,213,31,26,208,239,14,0.00525131282821,213,0.0798949737434,61,0.02288072018,2605,0.97711927982,2352,0.882220555139,06A,Rutherford,3716106A
Rutherford,5133,4862,0.94720436392,138,0.0268848626534,18,0.00350672121566,2,0.000389635690629,46,0.00896162088447,67,0.0130527956361,170,43,43,170,213,32,0.00623417105007,170,0.0331190337035,127,0.024741866355,5006,0.975258133645,4792,0.933567114748,09A,Rutherford,3716109A
Rutherford,1607,1571,0.977598008712,6,0.00373366521469,4,0.00248911014312,8,0.00497822028625,0,0.0,18,0.0112009956441,14,12,10,12,24,8,0.00497822028625,14,0.00871188550093,23,0.014312383323,1584,0.985687616677,1553,0.966397013068,10A,Rutherford,3716110A
Rutherford,8681,8111,0.934339361825,372,0.0428522059671,13,0.00149752332681,17,0.00195829973505,61,0.00702684022578,107,0.0123257689206,444,39,31,436,475,72,0.00829397534846,444,0.0511461813155,121,0.0139384863495,8560,0.986061513651,8053,0.927658103905,11,Rutherford,3716111
Rutherford,6382,4304,0.674396740834,1611,0.252428705735,16,0.00250705108117,48,0.0075211532435,227,0.035568787214,176,0.0275775618928,1730,68,45,1707,1775,119,0.0186461924162,1730,0.271074898151,441,0.0691005954246,5941,0.930899404575,4141,0.648856157944,13,Rutherford,3716113
Rutherford,4099,3085,0.752622590876,688,0.167845816053,11,0.00268358136131,32,0.00780678214199,164,0.0400097584777,119,0.0290314710905,768,39,31,760,799,80,0.019516955355,768,0.187362771408,315,0.0768480117102,3784,0.92315198829,2950,0.719687728714,14,Rutherford,3716114
Rutherford,3570,3418,0.957422969188,85,0.0238095238095,7,0.00196078431373,4,0.00112044817927,12,0.00336134453782,44,0.012324929972,110,23,17,104,127,25,0.00700280112045,110,0.03081232493,42,0.0117647058824,3528,0.988235294118,3392,0.950140056022,16A,Rutherford,3716116A
Rutherford,2852,2591,0.908485273492,213,0.0746844319776,3,0.00105189340813,15,0.00525946704067,9,0.0031556802244,21,0.00736325385694,230,4,4,230,234,17,0.00596072931276,230,0.0806451612903,50,0.0175315568022,2802,0.982468443198,2552,0.894810659187,18,Rutherford,3716118
Rutherford,3188,2772,0.869510664994,252,0.0790464240903,6,0.00188205771644,12,0.00376411543287,88,0.0276035131744,58,0.0181932245922,291,17,14,288,305,39,0.0122333751568,291,0.0912797992472,173,0.0542659974906,3015,0.945734002509,2694,0.84504391468,19,Rutherford,3716119
Rutherford,5007,4332,0.86518873577,484,0.0966646694628,18,0.00359496704614,50,0.0099860195726,33,0.00659077291791,90,0.0179748352307,541,46,38,533,579,57,0.0113840623128,541,0.108048731776,138,0.0275614140204,4869,0.97243858598,4237,0.846215298582,27,Rutherford,3716127
Rutherford,2673,2165,0.809951365507,332,0.124205013094,6,0.00224466891134,21,0.00785634118967,74,0.0276842499065,75,0.0280583613917,371,33,25,363,396,39,0.0145903479237,371,0.138795361018,139,0.0520014964459,2534,0.947998503554,2112,0.79012345679,28,Rutherford,3716128
Rutherford,3184,2612,0.820351758794,366,0.114949748744,6,0.00188442211055,16,0.00502512562814,86,0.0270100502513,98,0.0307788944724,419,29,28,418,447,53,0.0166457286432,419,0.131595477387,187,0.0587311557789,2997,0.941268844221,2530,0.79459798995,29,Rutherford,3716129
Rutherford,5451,3848,0.705925518254,1384,0.253898367272,14,0.00256833608512,35,0.0064208402128,43,0.00788846083287,127,0.0232984773436,1462,44,43,1461,1505,78,0.0143093010457,1462,0.268207668318,166,0.0304531278664,5285,0.969546872134,3748,0.687580260503,30,Rutherford,3716130
Rutherford,1824,1768,0.969298245614,22,0.0120614035088,8,0.00438596491228,6,0.00328947368421,3,0.00164473684211,17,0.0093201754386,29,14,14,29,43,7,0.00383771929825,29,0.015899122807,13,0.00712719298246,1811,0.992872807018,1758,0.963815789474,34,Rutherford,3716134
Sampson,2614,2070,0.791889824024,241,0.0921958684009,38,0.0145371078806,2,0.000765110941086,213,0.0814843152257,50,0.0191277735272,269,59,48,258,317,28,0.0107115531752,269,0.102907421576,298,0.114001530222,2316,0.885998469778,2005,0.767023718439,AUTR,Sampson,37163AUTR
Sampson,1764,223,0.12641723356,1286,0.729024943311,27,0.015306122449,17,0.00963718820862,131,0.0742630385488,80,0.0453514739229,1333,66,36,1303,1369,47,0.0266439909297,1333,0.75566893424,194,0.109977324263,1570,0.890022675737,191,0.108276643991,CLCE,Sampson,37163CLCE
Sampson,4165,1500,0.360144057623,2174,0.521968787515,28,0.00672268907563,16,0.00384153661465,382,0.0917166866747,65,0.015606242497,2214,45,35,2204,2249,40,0.00960384153661,2214,0.531572629052,579,0.139015606242,3586,0.860984393758,1362,0.327010804322,CLEA,Sampson,37163CLEA
Sampson,2493,1541,0.618130766145,345,0.138387484958,97,0.0389089450461,17,0.00681909346169,420,0.168471720818,73,0.0292819895708,376,119,111,368,487,31,0.012434817489,376,0.150822302447,558,0.223826714801,1935,0.776173285199,1463,0.58684316085,CLEM,Sampson,37163CLEM
Sampson,3031,2172,0.716595183108,504,0.166281755196,35,0.0115473441109,42,0.013856812933,212,0.0699439129,66,0.0217749917519,529,54,46,521,575,25,0.00824810293632,529,0.174529858133,316,0.104256021115,2715,0.895743978885,2096,0.691520950181,CLNE,Sampson,37163CLNE
Sampson,2899,1599,0.551569506726,697,0.240427733701,243,0.0838220075888,27,0.00931355639876,275,0.094860296654,58,0.0200068989307,716,287,274,703,990,19,0.00655398413246,716,0.246981717834,391,0.134874094515,2508,0.865125905485,1507,0.519834425664,CLSW,Sampson,37163CLSW
Sampson,3430,2026,0.590670553936,1017,0.296501457726,51,0.0148688046647,24,0.0069970845481,278,0.0810495626822,34,0.00991253644315,1040,61,53,1032,1093,23,0.0067055393586,1040,0.303206997085,379,0.110495626822,3051,0.889504373178,1920,0.559766763848,CLWE,Sampson,37163CLWE
Sampson,2023,953,0.471082550667,824,0.407315867523,11,0.00543746910529,4,0.00197726149283,189,0.0934256055363,42,0.0207612456747,849,40,22,831,871,25,0.0123578843302,849,0.419673751854,256,0.126544735541,1767,0.873455264459,896,0.442906574394,GARL,Sampson,37163GARL
Sampson,2601,1054,0.40522875817,737,0.283352556709,38,0.0146097654748,2,0.00076893502499,707,0.271818531334,63,0.0242214532872,756,62,52,746,808,19,0.00730488273741,756,0.290657439446,971,0.373317954633,1630,0.626682045367,870,0.334486735871,GIDD,Sampson,37163GIDD
Sampson,2631,852,0.323831242873,1480,0.562523755226,23,0.00874192322311,8,0.00304066894717,227,0.0862789813759,41,0.0155834283542,1513,40,24,1497,1537,33,0.0125427594071,1513,0.575066514633,301,0.114405169137,2330,0.885594830863,799,0.303686811098,HARR,Sampson,37163HARR
Sampson,1076,942,0.875464684015,59,0.0548327137546,20,0.0185873605948,1,0.00092936802974,44,0.0408921933086,10,0.0092936802974,63,25,25,63,88,4,0.00371747211896,63,0.0585501858736,68,0.0631970260223,1008,0.936802973978,920,0.855018587361,HERR,Sampson,37163HERR
Sampson,2483,1000,0.402738622634,708,0.285138944825,9,0.00362464760371,22,0.00886024969795,690,0.277889649617,54,0.0217478856222,734,31,24,727,758,26,0.0104712041885,734,0.295610149013,934,0.37615787354,1549,0.62384212646,811,0.326621022956,INGO,Sampson,37163INGO
Sampson,2180,1522,0.698165137615,326,0.149541284404,38,0.0174311926606,17,0.00779816513761,240,0.110091743119,37,0.0169724770642,339,53,50,336,389,13,0.00596330275229,339,0.155504587156,369,0.169266055046,1811,0.830733944954,1429,0.655504587156,KEEN,Sampson,37163KEEN
Sampson,2831,1603,0.566231013776,690,0.243730130696,250,0.0883080183681,18,0.0063581773225,187,0.0660543977393,83,0.0293182620982,729,291,281,719,1010,39,0.0137760508654,729,0.257506181561,334,0.11797951254,2497,0.88202048746,1505,0.531614270576,KFRK,Sampson,37163KFRK
Sampson,4352,1875,0.430836397059,2036,0.467830882353,48,0.0110294117647,7,0.00160845588235,318,0.0730698529412,68,0.015625,2076,70,57,2063,2133,40,0.00919117647059,2076,0.477022058824,463,0.106387867647,3889,0.893612132353,1778,0.408547794118,LAKE,Sampson,37163LAKE
Sampson,3936,2613,0.66387195122,663,0.168445121951,90,0.0228658536585,5,0.00127032520325,494,0.125508130081,71,0.0180386178862,688,114,108,682,796,25,0.00635162601626,688,0.174796747967,725,0.184197154472,3211,0.815802845528,2451,0.622713414634,MING,Sampson,37163MING
Sampson,2596,1661,0.639830508475,422,0.162557781202,27,0.0104006163328,10,0.00385208012327,441,0.169876733436,35,0.0134822804314,433,31,29,431,462,11,0.00423728813559,433,0.166795069337,633,0.243836671803,1963,0.756163328197,1500,0.57781201849,NGRV,Sampson,37163NGRV
Sampson,4211,3246,0.770838280693,521,0.123723581097,62,0.0147233436238,30,0.00712419852767,274,0.065067679886,78,0.0185229161719,557,88,86,555,643,36,0.0085490382332,557,0.13227261933,398,0.0945143671337,3813,0.905485632866,3148,0.747565898836,PLVW,Sampson,37163PLVW
Sampson,2651,1966,0.741606940777,386,0.145605431912,30,0.0113164843455,15,0.00565824217276,174,0.0656356092041,80,0.0301772915881,427,64,60,423,487,41,0.0154658619389,427,0.161071293851,255,0.096190116937,2396,0.903809883063,1905,0.718596755941,ROSE,Sampson,37163ROSE
Sampson,3210,1588,0.494704049844,759,0.236448598131,50,0.0155763239875,4,0.001246105919,732,0.228037383178,77,0.0239875389408,792,63,56,785,848,33,0.0102803738318,792,0.246728971963,941,0.293146417445,2269,0.706853582555,1432,0.446105919003,ROWA,Sampson,37163ROWA
Sampson,1474,1020,0.691994572592,209,0.141791044776,34,0.0230664857531,2,0.00135685210312,171,0.116010854817,38,0.0257801899593,228,52,46,222,274,19,0.0128900949796,228,0.154681139756,234,0.158751696065,1240,0.841248303935,967,0.656037991859,SBRG,Sampson,37163SBRG
Sampson,2181,1034,0.474094452086,784,0.359468133884,5,0.00229252636405,11,0.00504355800092,318,0.145804676754,29,0.0132966529115,792,14,12,790,804,8,0.00366804218249,792,0.363136176066,404,0.185236130215,1777,0.814763869785,975,0.44704264099,TURK,Sampson,37163TURK
Sampson,2599,1925,0.740669488265,260,0.100038476337,43,0.0165448249327,13,0.00500192381685,313,0.120430934975,45,0.0173143516737,271,65,64,270,335,11,0.0042323970758,271,0.104270873413,439,0.168911119661,2160,0.831088880339,1824,0.701808387841,WBRK,Sampson,37163WBRK
Scotland,4614,906,0.196358907672,3236,0.701343736454,321,0.0695708712614,9,0.00195058517555,53,0.0114867793671,89,0.0192891200694,3287,383,353,3257,3640,51,0.0110533159948,3287,0.712397052449,83,0.0179887299523,4531,0.982011270048,887,0.192241005635,1,Scotland,371651
Scotland,3672,1871,0.509531590414,1125,0.30637254902,481,0.130991285403,44,0.0119825708061,51,0.0138888888889,100,0.0272331154684,1162,551,540,1151,1702,37,0.0100762527233,1162,0.316448801743,70,0.0190631808279,3602,0.980936819172,1860,0.506535947712,10,Scotland,3716510
Scotland,3056,766,0.250654450262,1930,0.631544502618,237,0.0775523560209,12,0.00392670157068,49,0.0160340314136,62,0.0202879581152,1963,280,262,1945,2225,33,0.0107984293194,1963,0.642342931937,71,0.0232329842932,2985,0.976767015707,762,0.249345549738,2,Scotland,371652
Scotland,4516,2614,0.578830823738,1463,0.323959255979,234,0.0518157661647,71,0.0157218777679,32,0.00708591674048,102,0.0225863596103,1516,296,273,1493,1789,53,0.0117360496014,1516,0.33569530558,71,0.0157218777679,4445,0.984278122232,2586,0.57263064659,3,Scotland,371653
Scotland,5429,3585,0.660342604531,1332,0.245349051391,299,0.0550745993737,91,0.016761834592,42,0.00773623135016,80,0.0147356787622,1348,353,352,1347,1700,16,0.00294713575244,1348,0.248296187143,100,0.0184195984528,5329,0.981580401547,3543,0.652606373181,4,Scotland,371654
Scotland,2320,1213,0.522844827586,343,0.147844827586,690,0.297413793103,12,0.0051724137931,15,0.00646551724138,47,0.0202586206897,356,727,723,352,1079,13,0.00560344827586,356,0.153448275862,37,0.0159482758621,2283,0.984051724138,1206,0.519827586207,5,Scotland,371655
Scotland,2066,785,0.379961277832,960,0.464666021297,259,0.125363020329,3,0.00145208131655,25,0.0121006776379,34,0.0164569215876,982,281,267,968,1249,22,0.0106485963214,982,0.475314617619,90,0.0435624394966,1976,0.956437560503,725,0.3509196515,6,Scotland,371656
Scotland,5037,1771,0.351598173516,2408,0.478062338694,658,0.13063331348,30,0.00595592614652,41,0.00813976573357,129,0.02561048243,2458,749,726,2435,3184,50,0.00992654357753,2458,0.487988882271,101,0.0200516180266,4936,0.979948381973,1745,0.346436370856,7,Scotland,371657
Scotland,2223,1317,0.592442645074,518,0.233018443545,298,0.134053081422,4,0.00179937022042,33,0.0148448043185,53,0.0238416554206,531,341,335,525,866,13,0.00584795321637,531,0.238866396761,56,0.0251911830859,2167,0.974808816914,1314,0.591093117409,8,Scotland,371658
Scotland,3224,1994,0.618486352357,628,0.194789081886,457,0.141749379653,8,0.00248138957816,44,0.0136476426799,93,0.0288461538462,649,531,516,634,1165,21,0.00651364764268,649,0.201302729529,75,0.0232630272953,3149,0.976736972705,1977,0.613213399504,9,Scotland,371659
Stanly,2416,1832,0.758278145695,352,0.145695364238,11,0.00455298013245,106,0.0438741721854,68,0.0281456953642,47,0.0194536423841,384,20,20,384,404,32,0.0132450331126,384,0.158940397351,130,0.0538079470199,2286,0.94619205298,1779,0.736341059603,0002,Stanly,371670002
Stanly,2814,2311,0.821250888415,348,0.123667377399,2,0.000710732054016,33,0.0117270788913,56,0.0199004975124,64,0.0227434257285,394,17,10,387,404,46,0.0163468372424,394,0.140014214641,98,0.0348258706468,2716,0.965174129353,2281,0.810589907605,0003,Stanly,371670003
Stanly,3008,2312,0.768617021277,455,0.151263297872,13,0.00432180851064,124,0.0412234042553,60,0.0199468085106,44,0.0146276595745,482,19,19,482,501,27,0.00897606382979,482,0.160239361702,118,0.0392287234043,2890,0.960771276596,2256,0.75,0007,Stanly,371670007
Stanly,2853,675,0.236593059937,1988,0.696810375044,10,0.00350508236944,20,0.00701016473887,102,0.0357518401682,58,0.0203294777427,2038,21,12,2029,2050,50,0.0175254118472,2038,0.714335786891,187,0.0655450403084,2666,0.934454959692,605,0.212057483351,0008,Stanly,371670008
Stanly,2314,1866,0.80639585134,216,0.0933448573898,8,0.00345721694036,96,0.0414866032844,88,0.038029386344,40,0.0172860847018,236,16,16,236,252,20,0.00864304235091,236,0.101987899741,141,0.0609334485739,2173,0.939066551426,1817,0.78522039758,0010,Stanly,371670010
Stanly,1972,1712,0.868154158215,131,0.066430020284,5,0.0025354969574,81,0.0410750507099,12,0.00608519269777,31,0.0157200811359,155,9,9,155,164,24,0.0121703853955,155,0.0786004056795,40,0.0202839756592,1932,0.979716024341,1687,0.855476673428,0011,Stanly,371670011
Stanly,1575,1437,0.912380952381,42,0.0266666666667,7,0.00444444444444,52,0.0330158730159,11,0.00698412698413,26,0.0165079365079,55,13,13,55,68,13,0.00825396825397,55,0.0349206349206,17,0.0107936507937,1558,0.989206349206,1430,0.907936507937,0012,Stanly,371670012
Stanly,2603,2394,0.919708029197,74,0.0284287360738,5,0.00192086054552,56,0.0215136381099,42,0.0161352285824,32,0.0122935074914,87,12,12,87,99,13,0.00499423741836,87,0.0334229734921,74,0.0284287360738,2529,0.971571263926,2369,0.910103726469,0013,Stanly,371670013
Stanly,1436,1344,0.935933147632,33,0.0229805013928,3,0.00208913649025,38,0.0264623955432,5,0.00348189415042,13,0.00905292479109,40,7,7,40,47,7,0.00487465181058,40,0.0278551532033,10,0.00696378830084,1426,0.993036211699,1336,0.930362116992,0014,Stanly,371670014
Stanly,2614,1638,0.62662586075,822,0.314460596787,18,0.00688599846978,39,0.0149196633512,78,0.0298393267024,19,0.00726855394032,835,23,22,834,857,13,0.00497322111706,835,0.319433817904,128,0.0489671002295,2486,0.95103289977,1583,0.60558530987,0015,Stanly,371670015
Stanly,1731,1274,0.735990756788,385,0.222414789139,10,0.00577700751011,41,0.0236857307915,7,0.00404390525708,14,0.00808781051415,392,20,17,389,409,7,0.00404390525708,392,0.226458694396,18,0.0103986135182,1713,0.989601386482,1268,0.732524552282,0016,Stanly,371670016
Stanly,2636,2349,0.891122913505,200,0.0758725341426,5,0.00189681335357,50,0.0189681335357,19,0.00720789074355,13,0.00493171471927,209,6,6,209,215,9,0.00341426403642,209,0.0792867981791,44,0.0166919575114,2592,0.983308042489,2332,0.884673748103,0017,Stanly,371670017
Stanly,2162,1900,0.878815911193,152,0.0703052728955,10,0.00462534690102,53,0.0245143385754,15,0.00693802035153,32,0.0148011100833,174,13,13,174,187,22,0.0101757631822,174,0.0804810360777,37,0.0171137835338,2125,0.982886216466,1881,0.870027752081,0018,Stanly,371670018
Stanly,2238,2142,0.957104557641,13,0.00580875781948,5,0.00223413762288,48,0.0214477211796,13,0.00580875781948,17,0.00759606791778,16,15,15,16,31,3,0.00134048257373,16,0.00714924039321,27,0.0120643431635,2211,0.987935656836,2131,0.95218945487,0019,Stanly,371670019
Stanly,3221,3087,0.958398013039,12,0.0037255510711,4,0.00124185035703,84,0.0260788574977,15,0.00465693883887,19,0.0058987891959,14,17,16,13,30,2,0.000620925178516,14,0.00434647624961,31,0.009624340267,3190,0.990375659733,3072,0.953741074201,0020,Stanly,371670020
Stanly,1751,1704,0.973158195317,8,0.00456881781839,1,0.000571102227299,14,0.00799543118218,7,0.00399771559109,17,0.00970873786408,16,10,10,16,26,8,0.00456881781839,16,0.00913763563678,20,0.011422044546,1731,0.988577955454,1688,0.96402055968,0021,Stanly,371670021
Stanly,2599,2191,0.843016544825,217,0.0834936514044,14,0.00538668718738,22,0.0084647941516,123,0.0473258945748,32,0.0123124278569,228,25,25,228,253,11,0.0042323970758,228,0.0877260484802,167,0.064255482878,2432,0.935744517122,2155,0.829165063486,0022,Stanly,371670022
Stanly,4065,3810,0.937269372694,64,0.0157441574416,16,0.00393603936039,16,0.00393603936039,117,0.0287822878229,42,0.010332103321,75,27,27,75,102,11,0.00270602706027,75,0.0184501845018,189,0.0464944649446,3876,0.953505535055,3759,0.924723247232,0023,Stanly,371670023
Stanly,3755,3581,0.953661784288,40,0.0106524633822,7,0.00186418109188,24,0.00639147802929,79,0.0210386151798,24,0.00639147802929,52,16,16,52,68,12,0.00319573901465,52,0.0138482023968,176,0.0468708388815,3579,0.953129161119,3485,0.92809587217,0024,Stanly,371670024
Stanly,4525,4226,0.933922651934,38,0.00839779005525,15,0.00331491712707,41,0.00906077348066,163,0.0360220994475,42,0.0092817679558,50,26,24,48,74,12,0.00265193370166,50,0.0110497237569,260,0.0574585635359,4265,0.942541436464,4176,0.922872928177,0025,Stanly,371670025
Stanly,2461,2216,0.900446972775,119,0.0483543275091,5,0.00203169443316,90,0.0365704997968,9,0.00365704997968,22,0.00893945550589,130,9,9,130,139,11,0.00446972775295,130,0.0528240552621,26,0.0105648110524,2435,0.989435188948,2201,0.894351889476,0026,Stanly,371670026
Stanly,3267,2814,0.861340679522,337,0.103152739516,14,0.00428527701255,7,0.00214263850627,77,0.023569023569,18,0.00550964187328,344,19,19,344,363,7,0.00214263850627,344,0.105295378023,99,0.030303030303,3168,0.969696969697,2790,0.853994490358,0027,Stanly,371670027
Stanly,2569,1808,0.703775788244,584,0.227325807707,9,0.00350330868042,25,0.00973141300117,105,0.0408719346049,38,0.0147917477618,607,20,19,606,626,23,0.00895289996107,607,0.236278707668,129,0.050214091086,2440,0.949785908914,1796,0.699104710004,0028,Stanly,371670028
Stokes,1238,1186,0.957996768982,17,0.013731825525,6,0.0048465266559,1,0.000807754442649,11,0.00888529886914,17,0.013731825525,21,12,12,21,33,4,0.0032310177706,21,0.0169628432956,24,0.0193861066236,1214,0.980613893376,1180,0.953150242326,01,Stokes,3716901
Stokes,2738,2601,0.949963476991,37,0.0135135135135,5,0.0018261504748,1,0.00036523009496,73,0.0266617969321,21,0.00766983199416,51,8,8,51,59,14,0.00511322132944,51,0.018626734843,118,0.0430971512053,2620,0.956902848795,2560,0.934989043097,02,Stokes,3716902
Stokes,2026,1968,0.971372161895,9,0.00444225074038,5,0.00246791707799,0,0.0,27,0.0133267522211,17,0.00839091806515,18,12,12,18,30,9,0.00444225074038,18,0.00888450148075,64,0.0315893385982,1962,0.968410661402,1930,0.952615992103,03,Stokes,3716903
Stokes,3046,2933,0.962902166776,24,0.00787918581747,9,0.00295469468155,5,0.00164149704531,32,0.01050558109,43,0.0141168745896,43,29,25,39,68,19,0.00623768877216,43,0.0141168745896,68,0.0223243598162,2978,0.977675640184,2903,0.953053184504,04,Stokes,3716904
Stokes,1067,997,0.934395501406,47,0.0440487347704,9,0.00843486410497,0,0.0,5,0.00468603561387,9,0.00843486410497,48,16,15,47,63,1,0.000937207122774,48,0.0449859418932,20,0.0187441424555,1047,0.981255857545,989,0.926897844424,05,Stokes,3716905
Stokes,956,906,0.94769874477,33,0.0345188284519,0,0.0,2,0.00209205020921,10,0.010460251046,5,0.00523012552301,35,3,3,35,38,2,0.00209205020921,35,0.0366108786611,24,0.0251046025105,932,0.97489539749,892,0.933054393305,06,Stokes,3716906
Stokes,948,843,0.889240506329,87,0.0917721518987,3,0.00316455696203,0,0.0,8,0.0084388185654,7,0.00738396624473,92,7,5,90,97,5,0.00527426160338,92,0.0970464135021,12,0.0126582278481,936,0.987341772152,839,0.885021097046,07,Stokes,3716907
Stokes,1870,1772,0.947593582888,34,0.0181818181818,3,0.00160427807487,6,0.00320855614973,20,0.0106951871658,35,0.0187165775401,40,22,22,40,62,6,0.00320855614973,40,0.0213903743316,33,0.0176470588235,1837,0.982352941176,1764,0.943315508021,08,Stokes,3716908
Stokes,3136,2953,0.941645408163,108,0.0344387755102,12,0.00382653061224,8,0.00255102040816,25,0.00797193877551,30,0.00956632653061,118,28,27,117,145,10,0.0031887755102,118,0.0376275510204,55,0.0175382653061,3081,0.982461734694,2922,0.931760204082,09,Stokes,3716909
Stokes,4429,4242,0.957778279521,53,0.011966583879,12,0.00270941521788,34,0.00767667645067,36,0.00812824565365,52,0.0117407992775,71,37,34,68,105,18,0.00406412282682,71,0.0160307067058,119,0.0268683675773,4310,0.973131632423,4158,0.938812372996,10,Stokes,3716910
Stokes,5759,5408,0.939051918736,102,0.0177114082306,20,0.00347282514325,14,0.00243097760028,133,0.0230942872026,82,0.0142385830873,134,44,44,134,178,32,0.00555652022921,134,0.0232679284598,241,0.0418475429762,5518,0.958152457024,5329,0.92533425942,11,Stokes,3716911
Stokes,2834,2730,0.963302752294,23,0.00811573747354,15,0.00529287226535,8,0.00282286520819,18,0.00635144671842,40,0.0141143260409,41,37,35,39,76,18,0.00635144671842,41,0.014467184192,54,0.0190543401553,2780,0.980945659845,2697,0.95165843331,12,Stokes,3716912
Stokes,2630,2524,0.95969581749,32,0.0121673003802,8,0.00304182509506,15,0.00570342205323,18,0.00684410646388,33,0.0125475285171,52,16,13,49,65,20,0.00760456273764,52,0.0197718631179,70,0.0266159695817,2560,0.973384030418,2477,0.941825095057,13,Stokes,3716913
Stokes,3444,3331,0.96718931475,28,0.00813008130081,18,0.00522648083624,8,0.00232288037166,38,0.0110336817654,21,0.00609756097561,35,28,28,35,63,7,0.0020325203252,35,0.010162601626,99,0.0287456445993,3345,0.971254355401,3282,0.952961672474,14,Stokes,3716914
Stokes,1892,1849,0.977272727273,15,0.00792811839323,3,0.00158562367865,0,0.0,17,0.00898520084567,8,0.00422832980973,17,5,5,17,22,2,0.00105708245243,17,0.00898520084567,39,0.0206131078224,1853,0.979386892178,1825,0.964587737844,15,Stokes,3716915
Stokes,2452,1900,0.774877650897,479,0.195350734095,2,0.000815660685155,5,0.00203915171289,18,0.00734094616639,48,0.0195758564437,519,11,6,514,525,40,0.0163132137031,519,0.211663947798,28,0.0114192495922,2424,0.988580750408,1893,0.772022838499,16,Stokes,3716916
Stokes,2544,2215,0.870676100629,237,0.0931603773585,6,0.00235849056604,10,0.00393081761006,36,0.0141509433962,40,0.0157232704403,250,30,27,247,277,13,0.00511006289308,250,0.0982704402516,68,0.0267295597484,2476,0.973270440252,2184,0.858490566038,17,Stokes,3716917
Stokes,685,310,0.452554744526,331,0.483211678832,5,0.00729927007299,1,0.0014598540146,4,0.00583941605839,34,0.0496350364964,341,21,19,339,360,10,0.014598540146,341,0.497810218978,17,0.0248175182482,668,0.975182481752,308,0.449635036496,18,Stokes,3716918
Stokes,1516,1318,0.869393139842,143,0.094327176781,7,0.00461741424802,4,0.00263852242744,24,0.0158311345646,20,0.0131926121372,152,21,18,149,170,9,0.00593667546174,152,0.100263852243,32,0.0211081794195,1484,0.97889182058,1312,0.865435356201,19,Stokes,3716919
Stokes,2191,2035,0.92879963487,77,0.0351437699681,8,0.0036513007759,10,0.00456412596988,36,0.0164308534916,25,0.0114103149247,81,21,21,81,102,4,0.00182565038795,81,0.036969420356,69,0.0314924691921,2122,0.968507530808,2003,0.914194431766,20,Stokes,3716920
Surry,2747,2578,0.938478340007,18,0.00655260283946,10,0.00364033491081,7,0.00254823443757,110,0.0400436840189,24,0.00873680378595,31,21,17,27,48,13,0.00473243538406,31,0.0112850382235,201,0.0731707317073,2546,0.926829268293,2491,0.906807426283,01,Surry,3717101
Surry,1436,1099,0.765320334262,66,0.0459610027855,15,0.0104456824513,2,0.00139275766017,234,0.16295264624,20,0.0139275766017,74,17,17,74,91,8,0.00557103064067,74,0.0515320334262,384,0.267409470752,1052,0.732590529248,971,0.676183844011,02,Surry,3717102
Surry,4070,3561,0.874938574939,49,0.0120393120393,15,0.0036855036855,1,0.0002457002457,411,0.100982800983,33,0.00810810810811,57,22,22,57,79,8,0.0019656019656,57,0.0140049140049,686,0.16855036855,3384,0.83144963145,3310,0.813267813268,03,Surry,3717103
Surry,3354,2833,0.844663088849,51,0.0152057245081,19,0.0056648777579,13,0.00387596899225,384,0.114490161002,54,0.0161001788909,65,27,22,60,87,14,0.00417412045319,65,0.0193798449612,684,0.203935599284,2670,0.796064400716,2602,0.775790101371,04,Surry,3717104
Surry,3715,3435,0.924629878869,31,0.00834454912517,8,0.0021534320323,3,0.000807537012113,191,0.0514131897712,47,0.0126514131898,40,24,24,40,64,9,0.00242261103634,40,0.0107671601615,325,0.0874831763122,3390,0.912516823688,3315,0.892328398385,05,Surry,3717105
Surry,2088,1660,0.795019157088,99,0.0474137931034,9,0.00431034482759,22,0.0105363984674,268,0.128352490421,30,0.014367816092,115,22,20,113,135,16,0.00766283524904,115,0.0550766283525,372,0.17816091954,1716,0.82183908046,1605,0.76867816092,06,Surry,3717106
Surry,1925,1477,0.767272727273,155,0.0805194805195,0,0.0,9,0.00467532467532,253,0.131428571429,31,0.0161038961039,166,7,7,166,173,11,0.00571428571429,166,0.0862337662338,339,0.176103896104,1586,0.823896103896,1403,0.728831168831,07,Surry,3717107
Surry,2275,2138,0.93978021978,52,0.0228571428571,1,0.00043956043956,10,0.0043956043956,46,0.0202197802198,28,0.0123076923077,62,7,6,61,68,10,0.0043956043956,62,0.0272527472527,76,0.0334065934066,2199,0.966593406593,2113,0.928791208791,08,Surry,3717108
Surry,2400,2246,0.935833333333,40,0.0166666666667,5,0.00208333333333,6,0.0025,73,0.0304166666667,30,0.0125,50,21,17,46,67,10,0.00416666666667,50,0.0208333333333,132,0.055,2268,0.945,2186,0.910833333333,09,Surry,3717109
Surry,1602,1515,0.945692883895,19,0.0118601747815,0,0.0,5,0.00312109862672,45,0.0280898876404,18,0.0112359550562,25,2,2,25,27,6,0.00374531835206,25,0.0156054931336,89,0.0555555555556,1513,0.944444444444,1481,0.924469413233,10,Surry,3717110
Surry,2631,1933,0.73470163436,88,0.0334473584189,13,0.00494108703915,2,0.000760167236792,551,0.209426073736,44,0.0167236792094,102,25,24,101,126,14,0.00532117065754,102,0.0387685290764,855,0.324971493729,1776,0.675028506271,1650,0.627137970353,11,Surry,3717111
Surry,4234,3483,0.822626358054,346,0.0817194142655,24,0.00566839867737,47,0.0111006140765,208,0.0491261218706,126,0.0297590930562,404,67,59,396,463,58,0.013698630137,404,0.0954180444025,422,0.0996693434105,3812,0.90033065659,3310,0.781766650921,12,Surry,3717112
Surry,1782,1519,0.85241301908,152,0.0852974186308,1,0.000561167227834,31,0.0173961840629,48,0.026936026936,31,0.0173961840629,176,5,2,173,178,24,0.013468013468,176,0.0987654320988,86,0.0482603815937,1696,0.951739618406,1486,0.833894500561,13,Surry,3717113
Surry,2203,1792,0.813436223332,224,0.101679527916,4,0.00181570585565,45,0.0204266908761,85,0.0385837494326,53,0.0240581025874,247,17,14,244,261,23,0.01044030867,247,0.112119836586,123,0.0558329550613,2080,0.944167044939,1764,0.800726282342,14,Surry,3717114
Surry,3316,2771,0.83564535585,265,0.0799155609168,7,0.00211097708082,15,0.00452352231604,198,0.0597104945718,60,0.0180940892642,298,19,19,298,317,33,0.0099517490953,298,0.0898673100121,293,0.08835946924,3023,0.91164053076,2687,0.810313630881,15,Surry,3717115
Surry,2250,2019,0.897333333333,48,0.0213333333333,11,0.00488888888889,2,0.000888888888889,145,0.0644444444444,25,0.0111111111111,58,21,17,54,75,10,0.00444444444444,58,0.0257777777778,218,0.0968888888889,2032,0.903111111111,1956,0.869333333333,16,Surry,3717116
Surry,1755,1628,0.927635327635,18,0.0102564102564,8,0.0045584045584,28,0.0159544159544,63,0.0358974358974,10,0.00569800569801,24,12,11,23,35,6,0.0034188034188,24,0.0136752136752,103,0.0586894586895,1652,0.941310541311,1589,0.905413105413,17,Surry,3717117
Surry,3174,2885,0.908947700063,85,0.0267800882168,2,0.000630119722747,15,0.0047258979206,144,0.0453686200378,43,0.0135475740391,94,12,11,93,105,9,0.00283553875236,94,0.0296156269691,267,0.0841209829868,2907,0.915879017013,2780,0.875866414619,18,Surry,3717118
Surry,3598,3043,0.845747637576,267,0.074207893274,2,0.000555864369094,13,0.00361311839911,211,0.0586436909394,62,0.0172317954419,301,25,18,294,319,34,0.0094496942746,301,0.0836575875486,307,0.0853251806559,3291,0.914674819344,2955,0.821289605336,19,Surry,3717119
Surry,1470,1309,0.890476190476,96,0.065306122449,6,0.00408163265306,14,0.00952380952381,21,0.0142857142857,24,0.0163265306122,102,15,14,101,116,6,0.00408163265306,102,0.069387755102,49,0.0333333333333,1421,0.966666666667,1288,0.87619047619,20,Surry,3717120
Surry,2550,2406,0.943529411765,53,0.0207843137255,3,0.00117647058824,9,0.00352941176471,58,0.0227450980392,21,0.00823529411765,60,6,6,60,66,7,0.00274509803922,60,0.0235294117647,97,0.0380392156863,2453,0.961960784314,2372,0.930196078431,21,Surry,3717121
Surry,1846,1665,0.901950162514,41,0.022210184182,5,0.00270855904659,2,0.00108342361863,125,0.0677139761647,8,0.00433369447454,44,6,6,44,50,3,0.00162513542795,44,0.02383531961,183,0.0991332611051,1663,0.900866738895,1615,0.874864572048,22,Surry,3717122
Surry,2032,1935,0.952263779528,42,0.0206692913386,20,0.00984251968504,2,0.000984251968504,17,0.00836614173228,16,0.00787401574803,53,27,24,50,77,11,0.00541338582677,53,0.0260826771654,44,0.0216535433071,1988,0.978346456693,1909,0.939468503937,23,Surry,3717123
Surry,1148,1114,0.970383275261,0,0.0,5,0.00435540069686,2,0.00174216027875,13,0.0113240418118,14,0.0121951219512,5,6,6,5,11,5,0.00435540069686,5,0.00435540069686,31,0.0270034843206,1117,0.972996515679,1103,0.960801393728,24,Surry,3717124
Surry,3026,2806,0.927296761401,49,0.0161929940516,6,0.00198281559815,5,0.00165234633179,109,0.036021150033,51,0.0168539325843,57,25,25,57,82,8,0.00264375413087,57,0.0188367481824,220,0.0727032385988,2806,0.927296761401,2720,0.898876404494,25,Surry,3717125
Surry,4143,3905,0.942553705045,52,0.0125512913348,2,0.000482741974415,13,0.0031378228337,131,0.0316195993242,40,0.00965483948829,60,21,21,60,81,8,0.00193096789766,60,0.0144822592324,179,0.0432054067101,3964,0.95679459329,3873,0.934829833454,26,Surry,3717126
Surry,2648,2412,0.910876132931,129,0.0487160120846,5,0.00188821752266,3,0.0011329305136,70,0.0264350453172,29,0.0109516616314,147,16,8,139,155,18,0.00679758308157,147,0.0555135951662,105,0.0396525679758,2543,0.960347432024,2386,0.901057401813,27,Surry,3717127
Surry,2233,1989,0.890729959695,58,0.025974025974,12,0.00537393640842,10,0.00447828034035,153,0.0685176892073,11,0.00492610837438,60,14,14,60,74,2,0.00089565606807,60,0.0268696820421,205,0.0918047469772,2028,0.908195253023,1945,0.871025526198,28,Surry,3717128
Surry,2022,1770,0.875370919881,156,0.0771513353116,1,0.000494559841741,29,0.0143422354105,45,0.0222551928783,21,0.0103857566766,168,7,6,167,174,12,0.00593471810089,168,0.0830860534125,80,0.0395647873393,1942,0.960435212661,1746,0.86350148368,33,Surry,3717133
Swain,962,910,0.945945945946,0,0.0,25,0.0259875259875,2,0.002079002079,1,0.0010395010395,24,0.024948024948,0,46,46,0,46,0,0.0,0,0.0,8,0.00831600831601,954,0.991683991684,904,0.939708939709,ALARKA,Swain,37173ALARKA
Swain,1524,1456,0.955380577428,2,0.00131233595801,30,0.0196850393701,4,0.00262467191601,4,0.00262467191601,28,0.0183727034121,6,53,52,5,58,4,0.00262467191601,6,0.00393700787402,27,0.0177165354331,1497,0.982283464567,1437,0.942913385827,ALMOND,Swain,37173ALMOND
Swain,2918,2633,0.902330363263,6,0.00205620287868,168,0.0575736806032,14,0.00479780671693,22,0.00753941055517,75,0.0257025359836,13,230,229,12,242,7,0.00239890335846,13,0.00445510623715,73,0.025017135024,2845,0.974982864976,2599,0.89067854695,BC1,Swain,37173BC1
Swain,3109,2757,0.886780315214,20,0.00643293663557,198,0.0636860726922,34,0.0109359922805,40,0.0128658732711,60,0.0192988099067,28,247,242,23,270,8,0.00257317465423,28,0.0090061112898,95,0.030556449019,3014,0.969443550981,2721,0.87520102927,BC2,Swain,37173BC2
Swain,5468,1559,0.285113386979,48,0.0087783467447,3354,0.613386978786,17,0.00310899780541,83,0.0151792245794,407,0.0744330651061,90,3738,3710,62,3800,42,0.00768105340161,90,0.0164594001463,337,0.0616313094367,5131,0.938368690563,1507,0.275603511339,WHCH,Swain,37173WHCH
Transylvania,2503,2332,0.931681981622,96,0.0383539752297,6,0.00239712345186,23,0.00918897323212,24,0.00958849380743,22,0.00878945265681,105,13,13,105,118,9,0.00359568517779,105,0.0419496604075,49,0.0195765081902,2454,0.98042349181,2305,0.920894926089,B1,Transylvania,37175B1
Transylvania,2480,1724,0.695161290323,552,0.222580645161,8,0.00322580645161,10,0.00403225806452,68,0.0274193548387,118,0.0475806451613,634,43,29,620,663,82,0.033064516129,634,0.25564516129,125,0.0504032258065,2355,0.949596774194,1668,0.672580645161,B2,Transylvania,37175B2
Transylvania,2270,2002,0.881938325991,146,0.0643171806167,6,0.00264317180617,12,0.00528634361233,36,0.015859030837,68,0.0299559471366,180,35,26,171,206,34,0.0149779735683,180,0.079295154185,100,0.0440528634361,2170,0.955947136564,1943,0.855947136564,B3,Transylvania,37175B3
Transylvania,2246,2039,0.907836153161,89,0.0396260017809,5,0.00222617987533,37,0.0164737310775,54,0.0240427426536,22,0.00979519145147,98,12,11,97,109,9,0.0040071237756,98,0.0436331255565,120,0.053428317008,2126,0.946571682992,1975,0.879341050757,B4,Transylvania,37175B4
Transylvania,3694,3384,0.91608012994,172,0.0465619924201,9,0.00243638332431,8,0.00216567406605,48,0.0129940443963,73,0.0197617758527,208,35,33,206,241,36,0.00974553329724,208,0.0563075257174,103,0.0278830536004,3591,0.9721169464,3322,0.899296155929,BD,Transylvania,37175BD
Transylvania,754,738,0.978779840849,2,0.0026525198939,1,0.00132625994695,0,0.0,0,0.0,13,0.0172413793103,4,10,10,4,14,2,0.0026525198939,4,0.0053050397878,4,0.0053050397878,750,0.994694960212,734,0.973474801061,BG,Transylvania,37175BG
Transylvania,3174,3060,0.964083175803,20,0.00630119722747,16,0.00504095778198,7,0.00220541902962,26,0.00819155639572,45,0.0141776937618,38,26,25,37,63,18,0.00567107750473,38,0.0119722747322,60,0.0189035916824,3114,0.981096408318,3030,0.954631379962,CC,Transylvania,37175CC
Transylvania,886,867,0.97855530474,1,0.00112866817156,4,0.00451467268623,7,0.0079006772009,3,0.00338600451467,4,0.00451467268623,1,6,6,1,7,0,0.0,1,0.00112866817156,20,0.0225733634312,866,0.977426636569,851,0.960496613995,CM,Transylvania,37175CM
Transylvania,2673,2612,0.977179199401,8,0.00299289188178,9,0.003367003367,14,0.00523756079312,4,0.00149644594089,26,0.00972689861579,20,21,21,20,41,12,0.00448933782267,20,0.00748222970445,17,0.00635989524878,2656,0.993640104751,2599,0.972315750094,DR,Transylvania,37175DR
Transylvania,1120,1093,0.975892857143,0,0.0,3,0.00267857142857,3,0.00267857142857,7,0.00625,14,0.0125,5,11,11,5,16,5,0.00446428571429,5,0.00446428571429,13,0.0116071428571,1107,0.988392857143,1085,0.96875,EF,Transylvania,37175EF
Transylvania,572,546,0.954545454545,0,0.0,1,0.00174825174825,2,0.0034965034965,2,0.0034965034965,21,0.0367132867133,0,17,17,0,17,0,0.0,0,0.0,4,0.00699300699301,568,0.993006993007,546,0.954545454545,GL,Transylvania,37175GL
Transylvania,1911,1859,0.972789115646,17,0.00889586603872,1,0.000523286237572,3,0.00156985871272,3,0.00156985871272,28,0.014652014652,29,6,6,29,35,12,0.00627943485086,29,0.0151753008896,21,0.010989010989,1890,0.989010989011,1844,0.964939822083,LR,Transylvania,37175LR
Transylvania,716,689,0.962290502793,1,0.00139664804469,0,0.0,3,0.00418994413408,0,0.0,23,0.0321229050279,2,18,17,1,19,1,0.00139664804469,2,0.00279329608939,4,0.00558659217877,712,0.994413407821,688,0.960893854749,LT,Transylvania,37175LT
Transylvania,2124,1889,0.889359698682,157,0.0739171374765,6,0.00282485875706,11,0.00517890772128,34,0.0160075329567,27,0.0127118644068,175,15,13,173,188,18,0.00847457627119,175,0.0823917137476,128,0.060263653484,1996,0.939736346516,1799,0.846986817326,PF,Transylvania,37175PF
Transylvania,841,771,0.916765755054,0,0.0,2,0.00237812128419,1,0.00118906064209,61,0.0725326991677,6,0.00713436385256,0,6,6,0,6,0,0.0,0,0.0,72,0.0856123662307,769,0.914387633769,762,0.906064209275,QB,Transylvania,37175QB
Transylvania,2614,2518,0.963274674828,12,0.00459066564652,12,0.00459066564652,7,0.0026778882938,28,0.0107115531752,37,0.0141545524101,26,33,33,26,59,14,0.00535577658761,26,0.00994644223412,80,0.0306044376435,2534,0.969395562357,2468,0.944146901301,RE,Transylvania,37175RE
Transylvania,658,632,0.960486322188,9,0.0136778115502,5,0.00759878419453,1,0.00151975683891,10,0.0151975683891,1,0.00151975683891,9,6,6,9,15,0,0.0,9,0.0136778115502,26,0.0395136778116,632,0.960486322188,618,0.939209726444,SW,Transylvania,37175SW
Transylvania,1854,1822,0.982740021575,10,0.00539374325782,1,0.000539374325782,3,0.00161812297735,7,0.00377562028047,11,0.0059331175836,17,4,4,17,21,7,0.00377562028047,17,0.0091693635383,18,0.00970873786408,1836,0.990291262136,1812,0.977346278317,WC,Transylvania,37175WC
Tyrrell,330,65,0.19696969697,254,0.769696969697,0,0.0,6,0.0181818181818,0,0.0,5,0.0151515151515,258,0,0,258,258,4,0.0121212121212,258,0.781818181818,4,0.0121212121212,326,0.987878787879,65,0.19696969697,01,Tyrrell,3717701
Tyrrell,2929,1618,0.552406964834,1036,0.353704335951,15,0.00512120177535,68,0.0232161147149,151,0.0515534312052,41,0.0139979515193,1061,22,20,1059,1081,25,0.00853533629225,1061,0.362239672243,209,0.0713554114032,2720,0.928644588597,1580,0.53943325367,02,Tyrrell,3717702
Tyrrell,334,215,0.64371257485,116,0.347305389222,0,0.0,0,0.0,0,0.0,3,0.00898203592814,118,2,1,117,119,2,0.0059880239521,118,0.353293413174,0,0.0,334,1.0,215,0.64371257485,03,Tyrrell,3717703
Tyrrell,91,79,0.868131868132,10,0.10989010989,0,0.0,0,0.0,0,0.0,2,0.021978021978,12,0,0,12,12,2,0.021978021978,12,0.131868131868,0,0.0,91,1.0,79,0.868131868132,14,Tyrrell,3717714
Tyrrell,673,389,0.578008915305,258,0.383358098068,2,0.00297176820208,7,0.0104011887073,9,0.0133729569094,8,0.0118870728083,258,4,4,258,262,0,0.0,258,0.383358098068,25,0.037147102526,648,0.962852897474,374,0.555720653789,15,Tyrrell,3717715
Tyrrell,50,37,0.74,9,0.18,0,0.0,0,0.0,1,0.02,3,0.06,11,0,0,11,11,2,0.04,11,0.22,2,0.04,48,0.96,37,0.74,16,Tyrrell,3717716
Union,3805,1403,0.368725361367,965,0.253613666229,43,0.0113009198423,50,0.0131406044678,1230,0.323258869908,114,0.0299605781866,1014,62,51,1003,1065,49,0.0128777923784,1014,0.266491458607,1867,0.490670170828,1938,0.509329829172,880,0.231274638633,001,Union,37179001
Union,3179,1360,0.427807486631,1110,0.34916640453,20,0.0062912865681,15,0.00471846492608,603,0.189682290028,71,0.0223340673168,1146,42,35,1139,1181,36,0.0113243158226,1146,0.360490720352,950,0.298836111985,2229,0.701163888015,1057,0.332494495124,002,Union,37179002
Union,2623,1405,0.535646206634,629,0.239801753717,8,0.00304994281357,10,0.00381242851697,529,0.201677468547,42,0.0160121997713,644,16,11,639,655,15,0.00571864277545,644,0.245520396493,918,0.349980937857,1705,0.650019062143,1069,0.407548608464,003,Union,37179003
Union,3995,965,0.241551939925,1417,0.354693366708,20,0.00500625782228,5,0.00125156445557,1423,0.356195244055,165,0.0413016270338,1499,59,38,1478,1537,82,0.0205256570713,1499,0.37521902378,2109,0.527909887359,1886,0.472090112641,406,0.101627033792,004,Union,37179004
Union,4798,3766,0.784910379325,576,0.120050020842,31,0.00646102542726,54,0.0112546894539,253,0.0527303042935,118,0.0245935806586,620,46,42,616,662,44,0.00917048770321,620,0.129220508545,675,0.140683618174,4123,0.859316381826,3423,0.713422259275,005,Union,37179005
Union,2681,2290,0.854158895934,181,0.0675121223424,21,0.00783289817232,44,0.0164117866468,102,0.0380455054084,43,0.0160387914957,198,29,28,197,226,17,0.00634091756807,198,0.0738530399105,261,0.0973517344275,2420,0.902648265573,2154,0.80343155539,006,Union,37179006
Union,4678,3517,0.751817015819,664,0.141941000428,11,0.002351432236,22,0.004702864472,379,0.0810175288585,85,0.0181701581873,708,42,37,703,745,44,0.00940572894399,708,0.151346729372,622,0.132962804617,4056,0.867037195383,3297,0.704788371099,007,Union,37179007
Union,4719,2576,0.54587836406,1508,0.31955922865,23,0.00487391396482,36,0.00762873490146,517,0.109557109557,59,0.0125026488663,1541,28,26,1539,1567,33,0.00699300699301,1541,0.326552235643,787,0.166772621318,3932,0.833227378682,2307,0.488874761602,008,Union,37179008
Union,2415,1154,0.47784679089,1092,0.452173913043,14,0.00579710144928,5,0.00207039337474,105,0.0434782608696,45,0.0186335403727,1121,19,15,1117,1136,29,0.0120082815735,1121,0.464182194617,288,0.119254658385,2127,0.880745341615,1014,0.419875776398,009,Union,37179009
Union,2302,879,0.381841876629,788,0.342311033884,10,0.00434404865334,8,0.00347523892268,548,0.238053866203,69,0.0299739357081,834,17,13,830,847,46,0.0199826238054,834,0.362293657689,740,0.321459600348,1562,0.678540399652,743,0.322762814944,010,Union,37179010
Union,3459,3276,0.947094535993,43,0.0124313385371,11,0.00318010985834,16,0.0046256143394,83,0.0239953743857,30,0.00867302688638,50,24,23,49,73,7,0.00202370627349,50,0.0144550448106,121,0.0349812084417,3338,0.965018791558,3236,0.935530500145,011,Union,37179011
Union,3138,3077,0.980560866794,24,0.00764818355641,4,0.0012746972594,4,0.0012746972594,16,0.0050987890376,13,0.00414276609305,29,9,9,29,38,5,0.00159337157425,29,0.00924155513066,29,0.00924155513066,3109,0.990758444869,3067,0.977374123646,012,Union,37179012
Union,3653,3512,0.961401587736,29,0.00793868053655,7,0.00191623323296,17,0.00465370928004,47,0.0128661374213,41,0.011223651793,43,22,22,43,65,14,0.00383246646592,43,0.0117711470025,86,0.0235422940049,3567,0.976457705995,3486,0.954284150014,013,Union,37179013
Union,2342,1962,0.837745516652,139,0.0593509820666,27,0.0115286080273,12,0.00512382578992,131,0.0559350982067,71,0.030315969257,163,46,46,163,209,24,0.0102476515798,163,0.0695986336465,239,0.102049530316,2103,0.897950469684,1876,0.801024765158,014,Union,37179014
Union,5841,4974,0.851566512583,436,0.0746447526109,44,0.0075329566855,128,0.0219140558124,144,0.0246533127889,115,0.0196884095189,491,80,61,472,552,55,0.00941619585687,491,0.0840609484677,483,0.0826913199795,5358,0.917308680021,4654,0.796781373053,015,Union,37179015
Union,5465,4760,0.870997255261,378,0.0691674290942,32,0.00585544373285,94,0.0172003659652,101,0.0184812442818,100,0.0182982616651,411,61,54,404,465,33,0.0060384263495,411,0.0752058554437,302,0.0552607502287,5163,0.944739249771,4586,0.839158279963,016,Union,37179016
Union,4593,3933,0.856303069889,397,0.086435880688,15,0.00326583932071,70,0.0152405834966,100,0.021772262138,78,0.0169823644677,427,34,32,425,459,30,0.00653167864141,427,0.0929675593294,352,0.0766383627259,4241,0.923361637274,3704,0.806444589593,017A,Union,37179017A
Union,5005,4415,0.882117882118,324,0.0647352647353,5,0.000999000999001,138,0.0275724275724,36,0.00719280719281,87,0.0173826173826,358,23,17,352,375,34,0.00679320679321,358,0.0715284715285,230,0.045954045954,4775,0.954045954046,4242,0.847552447552,017B,Union,37179017B
Union,3067,2807,0.915226605804,116,0.0378219758722,2,0.000652103032279,75,0.0244538637105,24,0.00782523638735,43,0.014020215194,134,10,7,131,141,18,0.00586892729051,134,0.0436909031627,82,0.0267362243234,2985,0.973263775677,2745,0.895011411803,018,Union,37179018
Union,5806,4948,0.852221839476,536,0.0923182914227,15,0.00258353427489,64,0.0110230795729,116,0.0199793317258,127,0.0218739235274,591,50,42,583,633,55,0.00947295900792,591,0.101791250431,340,0.0585601102308,5466,0.941439889769,4751,0.818291422666,019,Union,37179019
Union,4469,3622,0.810472141419,583,0.130454240322,10,0.00223763705527,42,0.00939807563213,97,0.0217050794361,115,0.0257328261356,630,41,33,622,663,47,0.0105168941598,630,0.140971134482,323,0.0722756768852,4146,0.927724323115,3433,0.768180801074,020A,Union,37179020A
Union,3794,3490,0.919873484449,136,0.0358460727464,7,0.00184501845018,50,0.0131787032156,28,0.00738007380074,83,0.0218766473379,168,35,31,164,199,32,0.00843437005799,168,0.0442804428044,153,0.0403268318397,3641,0.95967316816,3389,0.893252503954,020B,Union,37179020B
Union,3328,3031,0.910757211538,147,0.0441706730769,15,0.00450721153846,9,0.00270432692308,63,0.0189302884615,63,0.0189302884615,161,47,44,158,205,14,0.00420673076923,161,0.0483774038462,115,0.0345552884615,3213,0.965444711538,2987,0.897536057692,021,Union,37179021
Union,3165,2959,0.934913112164,87,0.0274881516588,7,0.00221169036335,37,0.0116903633491,34,0.0107424960506,41,0.0129541864139,108,13,12,107,120,21,0.00663507109005,108,0.0341232227488,76,0.0240126382306,3089,0.975987361769,2916,0.921327014218,022,Union,37179022
Union,2917,2394,0.820706205005,285,0.0977031196435,14,0.00479945149126,15,0.00514226945492,134,0.0459376071306,75,0.0257113472746,329,33,22,318,351,44,0.0150839904011,329,0.112787110045,250,0.0857044909153,2667,0.914295509085,2313,0.792937949949,023,Union,37179023
Union,3358,3018,0.898749255509,221,0.065812983919,15,0.00446694460989,8,0.00238237045861,79,0.0235259082787,17,0.00506253722454,227,23,22,226,249,6,0.00178677784395,227,0.067599761763,117,0.0348421679571,3241,0.965157832043,2984,0.88862418106,024,Union,37179024
Union,2915,2435,0.835334476844,277,0.095025728988,17,0.00583190394511,21,0.00720411663808,105,0.0360205831904,60,0.0205831903945,299,37,36,298,335,22,0.00754716981132,299,0.102572898799,216,0.0740994854202,2699,0.92590051458,2337,0.801715265866,025,Union,37179025
Union,2912,2409,0.827266483516,326,0.111950549451,27,0.00927197802198,19,0.00652472527473,70,0.0240384615385,61,0.0209478021978,350,48,42,344,392,24,0.00824175824176,350,0.120192307692,181,0.0621565934066,2731,0.937843406593,2329,0.799793956044,026,Union,37179026
Union,2731,2304,0.843647015745,319,0.116807030392,14,0.00512632735262,4,0.00146466495789,65,0.0238008055657,25,0.00915415598682,333,26,25,332,358,14,0.00512632735262,333,0.121933357744,100,0.0366166239473,2631,0.963383376053,2276,0.83339436104,027,Union,37179027
Union,19738,16815,0.851910021279,1381,0.0699665619617,35,0.00177322930388,968,0.0490424561759,167,0.00846083696423,372,0.0188468943155,1523,104,83,1502,1606,142,0.00719424460432,1523,0.077160806566,840,0.0425575032931,18898,0.957442496707,16191,0.820295875975,028,Union,37179028
Union,5935,4538,0.764616680708,863,0.145408593092,19,0.00320134793597,124,0.0208930075821,228,0.0384161752317,163,0.0274641954507,945,48,37,934,982,82,0.0138163437237,945,0.159224936816,703,0.118449873631,5232,0.881550126369,4116,0.69351305813,029A,Union,37179029A
Union,2393,2083,0.870455495194,192,0.0802340158796,4,0.00167154199749,44,0.0183869619724,36,0.0150438779774,34,0.0142081069787,213,14,8,207,221,21,0.00877559548684,213,0.0890096113665,134,0.055996656916,2259,0.944003343084,1991,0.832010029252,029B,Union,37179029B
Union,2942,2577,0.875934738273,204,0.0693405846363,22,0.00747790618627,35,0.0118966689327,63,0.0214140040789,41,0.0139360978926,224,37,36,223,260,20,0.00679809653297,224,0.0761386811693,169,0.0574439157036,2773,0.942556084296,2475,0.841264445955,029C,Union,37179029C
Union,6508,4784,0.735095267363,998,0.153349723417,28,0.00430239704978,118,0.0181315304241,414,0.0636140135218,166,0.0255070682237,1095,48,39,1086,1134,97,0.0149047326368,1095,0.168254456054,898,0.137984019668,5610,0.862015980332,4382,0.673325138291,030,Union,37179030
Union,5036,3936,0.781572676728,615,0.122120730739,25,0.0049642573471,76,0.0150913423352,255,0.0506354249404,129,0.025615567911,682,42,37,677,719,67,0.0133042096902,682,0.135424940429,609,0.120929308975,4427,0.879070691025,3634,0.721604447975,031,Union,37179031
Union,4095,3618,0.883516483516,253,0.0617826617827,5,0.001221001221,115,0.028083028083,57,0.0139194139194,47,0.0114774114774,273,12,11,272,284,20,0.004884004884,273,0.0666666666667,161,0.0393162393162,3934,0.960683760684,3521,0.859829059829,032,Union,37179032
Union,3276,2766,0.844322344322,366,0.111721611722,4,0.001221001221,20,0.00610500610501,41,0.0125152625153,79,0.0241147741148,396,35,34,395,430,30,0.00915750915751,396,0.120879120879,93,0.0283882783883,3183,0.971611721612,2719,0.829975579976,033,Union,37179033
Union,4433,3487,0.786600496278,624,0.140762463343,6,0.00135348522445,37,0.00834649221746,227,0.0512068576585,52,0.0117302052786,650,22,19,647,669,26,0.0058651026393,650,0.146627565982,369,0.0832393413039,4064,0.916760658696,3370,0.760207534401,034,Union,37179034
Union,2406,2282,0.948462177889,64,0.026600166251,2,0.000831255195345,20,0.00831255195345,14,0.00581878636741,24,0.00997506234414,71,15,15,71,86,7,0.00290939318371,71,0.0295095594347,76,0.0315876974231,2330,0.968412302577,2226,0.925187032419,035,Union,37179035
Union,3194,2411,0.754852849092,581,0.181903569192,6,0.00187852222918,9,0.00281778334377,113,0.0353788353162,74,0.0231684408265,621,33,27,615,648,40,0.0125234815279,621,0.19442705072,210,0.0657482780213,2984,0.934251721979,2323,0.727301189731,036,Union,37179036
Union,5951,4878,0.819694169047,591,0.0993110401613,35,0.00588136447656,172,0.0289027054277,151,0.0253738867417,124,0.0208368341455,636,79,65,622,701,45,0.007561754327,636,0.106872794488,532,0.0893967400437,5419,0.910603259956,4547,0.764073264997,037A,Union,37179037A
Union,1859,1718,0.924152770307,80,0.0430338891877,4,0.00215169445939,29,0.0155997848306,15,0.0080688542227,13,0.00699300699301,85,7,5,83,90,5,0.00268961807423,85,0.045723507262,34,0.0182894029048,1825,0.981710597095,1695,0.911780527165,037B,Union,37179037B
Union,6323,4550,0.719595128895,743,0.117507512257,46,0.00727502767674,114,0.0180294164163,711,0.112446623438,159,0.0251462913174,814,81,73,806,887,71,0.0112288470663,814,0.128736359323,1267,0.200379566661,5056,0.799620433339,4050,0.640518741104,038A,Union,37179038A
Union,3422,2970,0.867913500877,239,0.0698421975453,17,0.00496785505552,65,0.0189947399182,55,0.0160724722385,76,0.0222092343659,264,32,30,262,294,25,0.0073056691993,264,0.0771478667446,177,0.051724137931,3245,0.948275862069,2860,0.8357685564,038B,Union,37179038B
Union,2812,2565,0.912162162162,160,0.0568990042674,13,0.00462304409673,21,0.0074679943101,31,0.0110241820768,22,0.00782361308677,165,23,21,163,186,5,0.00177809388336,165,0.0586770981508,86,0.0305832147937,2726,0.969416785206,2513,0.893669985775,039,Union,37179039
Union,4926,4352,0.88347543646,273,0.0554202192448,12,0.00243605359318,144,0.0292326431181,54,0.0109622411693,91,0.0184734064149,301,39,32,294,333,28,0.00568412505075,301,0.0611043442956,166,0.0336987413723,4760,0.966301258628,4243,0.861347949655,040,Union,37179040
Union,3677,3258,0.886048409029,178,0.0484090290998,7,0.00190372586348,131,0.0356268697308,52,0.0141419635572,51,0.0138700027196,192,10,9,191,201,14,0.00380745172695,192,0.0522164808268,149,0.0405221648083,3528,0.959477835192,3161,0.859668207778,041,Union,37179041
Union,2906,2206,0.759119064006,306,0.105299380592,19,0.00653819683414,19,0.00653819683414,300,0.103234686855,56,0.0192704748796,325,36,33,322,358,19,0.00653819683414,325,0.111837577426,454,0.156228492774,2452,0.843771507226,2069,0.711975223675,042,Union,37179042
Union,2307,519,0.224967490247,1114,0.482878196792,17,0.00736887732987,1,0.000433463372345,614,0.26614651062,42,0.0182054616385,1136,21,18,1133,1154,22,0.00953619419159,1136,0.492414390984,828,0.358907672302,1479,0.641092327698,351,0.152145643693,043,Union,37179043
Vance,2818,1698,0.602555003549,974,0.345635202271,13,0.00461320085167,24,0.00851667849539,84,0.0298083747339,25,0.00887154009936,993,18,14,989,1007,19,0.00674237047551,993,0.352377572747,116,0.041163946061,2702,0.958836053939,1672,0.593328601845,DABN,Vance,37181DABN
Vance,3184,362,0.113693467337,2597,0.815640703518,12,0.00376884422111,2,0.000628140703518,178,0.0559045226131,33,0.010364321608,2620,23,14,2611,2634,23,0.00722361809045,2620,0.822864321608,314,0.0986180904523,2870,0.901381909548,255,0.0800879396985,EH1,Vance,37181EH1
Vance,1517,419,0.276203032301,819,0.539881344759,15,0.00988793671721,5,0.00329597890574,215,0.141727092947,44,0.0290046143705,827,16,16,827,843,8,0.00527356624918,827,0.545154911009,314,0.20698747528,1203,0.79301252472,353,0.232696110745,EH2,Vance,37181EH2
Vance,1217,460,0.37797863599,705,0.579293344289,0,0.0,15,0.012325390304,18,0.0147904683648,19,0.0156121610518,710,3,1,708,711,5,0.00410846343468,710,0.583401807724,53,0.0435497124076,1164,0.956450287592,429,0.352506162695,HTOP,Vance,37181HTOP
Vance,5822,3426,0.588457574717,2070,0.355547921676,33,0.0056681552731,8,0.00137409824802,231,0.0396770869117,54,0.00927516317417,2099,49,43,2093,2142,29,0.00498110614909,2099,0.360529027825,363,0.0623497080041,5459,0.937650291996,3338,0.573342493988,KITT,Vance,37181KITT
Vance,3712,1836,0.494612068966,1781,0.479795258621,2,0.000538793103448,9,0.00242456896552,44,0.0118534482759,40,0.010775862069,1809,25,12,1796,1821,28,0.00754310344828,1809,0.487338362069,71,0.0191271551724,3641,0.980872844828,1816,0.489224137931,MIDD,Vance,37181MIDD
Vance,3561,430,0.120752597585,3016,0.846953103061,5,0.00140409997192,16,0.00449311991014,29,0.00814377983712,65,0.0182532996349,3076,35,7,3048,3083,60,0.016849199663,3076,0.863802302724,99,0.027801179444,3462,0.972198820556,407,0.114293737714,NH1,Vance,37181NH1
Vance,1170,557,0.476068376068,586,0.500854700855,2,0.0017094017094,4,0.0034188034188,12,0.0102564102564,9,0.00769230769231,594,5,3,592,597,8,0.00683760683761,594,0.507692307692,46,0.0393162393162,1124,0.960683760684,533,0.455555555556,NH2,Vance,37181NH2
Vance,6711,3568,0.53166443153,2720,0.405304723588,28,0.00417225450752,7,0.00104306362688,312,0.046490835941,76,0.0113246908061,2764,48,37,2753,2801,44,0.0065563999404,2764,0.411861123529,635,0.0946207718671,6076,0.905379228133,3304,0.492326031888,SCRK,Vance,37181SCRK
Vance,3609,956,0.26489332225,2311,0.640343585481,13,0.00360210584649,7,0.0019395954558,275,0.0761983929066,47,0.0130229980604,2349,35,21,2335,2370,38,0.0105292324744,2349,0.650872817955,491,0.136048766971,3118,0.863951233029,782,0.21668052092,SH1,Vance,37181SH1
Vance,1625,728,0.448,640,0.393846153846,3,0.00184615384615,3,0.00184615384615,217,0.133538461538,34,0.0209230769231,653,14,13,652,666,13,0.008,653,0.401846153846,314,0.193230769231,1311,0.806769230769,647,0.398153846154,SH2,Vance,37181SH2
Vance,1341,622,0.463832960477,676,0.504101416853,0,0.0,2,0.00149142431022,22,0.0164056674124,19,0.0141685309471,692,6,3,689,695,16,0.0119313944817,692,0.516032811335,26,0.0193885160328,1315,0.980611483967,620,0.462341536167,TWNS,Vance,37181TWNS
Vance,640,613,0.9578125,21,0.0328125,0,0.0,4,0.00625,2,0.003125,0,0.0,21,0,0,21,21,0,0.0,21,0.0328125,4,0.00625,636,0.99375,611,0.9546875,WATK,Vance,37181WATK
Vance,3664,2298,0.627183406114,1210,0.330240174672,13,0.0035480349345,65,0.0177401746725,38,0.0103711790393,40,0.0109170305677,1231,29,21,1223,1252,21,0.00573144104803,1231,0.335971615721,64,0.0174672489083,3600,0.982532751092,2282,0.622816593886,WH1,Vance,37181WH1
Vance,1499,644,0.429619746498,783,0.522348232155,6,0.00400266844563,34,0.0226817878586,12,0.00800533689126,20,0.0133422281521,797,11,9,795,806,14,0.00933955970647,797,0.531687791861,20,0.0133422281521,1479,0.986657771848,641,0.427618412275,WH2,Vance,37181WH2
Vance,3332,1441,0.432472989196,1736,0.521008403361,2,0.000600240096038,4,0.00120048019208,65,0.0195078031212,84,0.0252100840336,1802,17,8,1793,1810,66,0.0198079231693,1802,0.540816326531,121,0.0363145258103,3211,0.96368547419,1411,0.423469387755,WMSB,Vance,37181WMSB
Wake,2654,2074,0.781461944235,388,0.146194423512,15,0.00565184626978,69,0.025998492841,49,0.0184626978146,59,0.0222305953278,419,35,23,407,442,31,0.0116804822909,419,0.157874905803,137,0.0516201959307,2517,0.948379804069,2004,0.755086661643,01-01,Wake,3718301-01
Wake,3351,3033,0.905102954342,178,0.0531184720979,6,0.00179051029543,62,0.0185019397195,22,0.00656520441659,50,0.0149209191286,194,17,15,192,209,16,0.00477469412116,194,0.057893166219,102,0.0304386750224,3249,0.969561324978,2962,0.883915249179,01-02,Wake,3718301-02
Wake,2405,2314,0.962162162162,36,0.0149688149688,5,0.002079002079,18,0.00748440748441,7,0.0029106029106,25,0.010395010395,43,16,14,41,57,7,0.0029106029106,43,0.0178794178794,34,0.0141372141372,2371,0.985862785863,2293,0.95343035343,01-03,Wake,3718301-03
Wake,1457,1403,0.962937542896,17,0.0116678105697,1,0.000686341798216,6,0.00411805078929,12,0.00823610157859,18,0.0123541523679,26,7,2,21,28,9,0.00617707618394,26,0.0178448867536,25,0.0171585449554,1432,0.982841455045,1388,0.952642415923,01-04,Wake,3718301-04
Wake,1410,1321,0.936879432624,76,0.0539007092199,1,0.000709219858156,7,0.00496453900709,0,0.0,5,0.00354609929078,79,3,2,78,81,3,0.00212765957447,79,0.0560283687943,9,0.0063829787234,1401,0.993617021277,1312,0.930496453901,01-05,Wake,3718301-05
Wake,2949,2748,0.931841302136,89,0.0301797219396,7,0.00237368599525,51,0.0172939979654,14,0.00474737199051,40,0.0135639199729,104,22,13,95,117,15,0.00508646998983,104,0.0352661919295,67,0.0227195659546,2882,0.977280434045,2702,0.916242794168,01-06,Wake,3718301-06
Wake,2075,1659,0.799518072289,304,0.146506024096,6,0.00289156626506,53,0.0255421686747,19,0.00915662650602,34,0.0163855421687,314,20,15,309,329,10,0.00481927710843,314,0.151325301205,74,0.0356626506024,2001,0.964337349398,1609,0.775421686747,01-07,Wake,3718301-07
Wake,1414,1343,0.949787835926,19,0.0134370579915,4,0.002828854314,17,0.0120226308345,9,0.00636492220651,22,0.015558698727,26,7,7,26,33,7,0.0049504950495,26,0.018387553041,21,0.0148514851485,1393,0.985148514851,1334,0.94342291372,01-09,Wake,3718301-09
Wake,1787,1739,0.973139339675,21,0.011751538892,3,0.00167879127029,9,0.00503637381086,0,0.0,15,0.00839395635143,22,3,3,22,25,1,0.000559597090095,22,0.0123111359821,23,0.0128707330722,1764,0.987129266928,1717,0.960828203693,01-10,Wake,3718301-10
Wake,2535,2479,0.977909270217,15,0.00591715976331,0,0.0,19,0.00749506903353,1,0.000394477317554,21,0.00828402366864,25,6,1,20,26,10,0.00394477317554,25,0.00986193293886,31,0.0122287968442,2504,0.987771203156,2448,0.965680473373,01-11,Wake,3718301-11
Wake,2237,1755,0.784532856504,325,0.145283862316,6,0.00268216361198,17,0.00759946356728,104,0.046490835941,30,0.0134108180599,339,11,7,335,346,14,0.00625838176129,339,0.151542244077,185,0.0827000447027,2052,0.917299955297,1682,0.751899865892,01-12,Wake,3718301-12
Wake,2048,1351,0.65966796875,576,0.28125,9,0.00439453125,21,0.01025390625,58,0.0283203125,33,0.01611328125,598,18,16,596,614,22,0.0107421875,598,0.2919921875,104,0.05078125,1944,0.94921875,1322,0.6455078125,01-13,Wake,3718301-13
Wake,4104,3005,0.732212475634,875,0.21320662768,15,0.00365497076023,53,0.0129142300195,68,0.0165692007797,88,0.0214424951267,918,43,28,903,946,43,0.010477582846,918,0.223684210526,178,0.0433723196881,3926,0.956627680312,2919,0.711257309942,01-14,Wake,3718301-14
Wake,1752,1551,0.885273972603,120,0.0684931506849,2,0.00114155251142,36,0.0205479452055,19,0.0108447488584,24,0.013698630137,136,13,7,130,143,16,0.00913242009132,136,0.0776255707763,47,0.0268264840183,1705,0.973173515982,1520,0.867579908676,01-15,Wake,3718301-15
Wake,4052,2727,0.673000987167,646,0.159427443238,33,0.00814412635735,173,0.0426949654492,359,0.0885982230997,114,0.028134254689,704,61,45,688,749,58,0.0143139190523,704,0.17374136229,631,0.155725567621,3421,0.844274432379,2534,0.625370187562,01-16,Wake,3718301-16
Wake,1380,1317,0.954347826087,20,0.0144927536232,5,0.0036231884058,22,0.0159420289855,2,0.00144927536232,14,0.0101449275362,31,9,5,27,36,11,0.00797101449275,31,0.0224637681159,23,0.0166666666667,1357,0.983333333333,1295,0.938405797101,01-17,Wake,3718301-17
Wake,5360,3143,0.586380597015,1103,0.20578358209,34,0.00634328358209,152,0.0283582089552,765,0.142723880597,163,0.0304104477612,1188,84,61,1165,1249,85,0.0158582089552,1188,0.221641791045,1554,0.289925373134,3806,0.710074626866,2478,0.462313432836,01-18,Wake,3718301-18
Wake,3123,346,0.11079090618,2286,0.731988472622,7,0.00224143451809,17,0.00544348382965,413,0.132244636567,54,0.0172910662824,2321,29,16,2308,2337,35,0.0112071725905,2321,0.743195645213,651,0.208453410183,2472,0.791546589817,152,0.0486711495357,01-19,Wake,3718301-19
Wake,3583,689,0.192296957857,2725,0.760535863801,14,0.00390734021769,17,0.0047446274072,73,0.020373988278,65,0.0181412224393,2775,37,20,2758,2795,50,0.0139547864918,2775,0.774490650293,196,0.0547027630477,3387,0.945297236952,613,0.171085682389,01-20,Wake,3718301-20
Wake,6959,3078,0.442304928869,2357,0.338698088806,66,0.00948412128179,132,0.0189682425636,1124,0.161517459405,202,0.0290271590746,2462,96,76,2442,2538,105,0.0150883747665,2462,0.353786463572,1856,0.266704986349,5103,0.733295013651,2509,0.360540307515,01-21,Wake,3718301-21
Wake,5495,462,0.084076433121,4271,0.777252047316,26,0.00473157415833,50,0.0090991810737,561,0.102092811647,125,0.0227479526843,4361,56,30,4335,4391,90,0.0163785259327,4361,0.793630573248,970,0.17652411283,4525,0.82347588717,201,0.0365787079163,01-22,Wake,3718301-22
Wake,12284,8792,0.715727775969,2025,0.164848583523,28,0.00227938782156,996,0.0810810810811,149,0.012129599479,294,0.0239335721263,2140,104,66,2102,2206,115,0.00936177140996,2140,0.174210354933,431,0.0350862911104,11853,0.96491370889,8569,0.697574080104,01-23,Wake,3718301-23
Wake,1528,134,0.0876963350785,1295,0.847513089005,2,0.00130890052356,1,0.00065445026178,33,0.0215968586387,63,0.0412303664921,1352,18,3,1337,1355,57,0.0373036649215,1352,0.884816753927,101,0.0660994764398,1427,0.93390052356,110,0.0719895287958,01-25,Wake,3718301-25
Wake,5698,1291,0.226570726571,3976,0.697788697789,44,0.00772200772201,17,0.0029835029835,284,0.049842049842,86,0.015093015093,4036,71,49,4014,4085,60,0.01053001053,4036,0.708318708319,508,0.0891540891541,5190,0.910845910846,1160,0.20358020358,01-26,Wake,3718301-26
Wake,2948,1659,0.562754409769,837,0.283921302578,38,0.0128900949796,27,0.00915875169607,319,0.108208955224,68,0.0230664857531,861,55,52,858,913,24,0.00814111261872,861,0.292062415197,571,0.19369063772,2377,0.80630936228,1472,0.499321573948,01-27,Wake,3718301-27
Wake,5550,1573,0.283423423423,3524,0.634954954955,18,0.00324324324324,39,0.00702702702703,246,0.0443243243243,150,0.027027027027,3632,81,34,3585,3666,108,0.0194594594595,3632,0.654414414414,472,0.085045045045,5078,0.914954954955,1415,0.254954954955,01-28,Wake,3718301-28
Wake,2813,2713,0.964450764309,48,0.0170636331319,2,0.000710984713829,20,0.00710984713829,14,0.0049768929968,16,0.00568787771063,53,5,3,51,56,5,0.00177746178457,53,0.0188410949165,53,0.0188410949165,2760,0.981158905084,2677,0.95165303946,01-29,Wake,3718301-29
Wake,1563,1467,0.938579654511,63,0.0403071017274,0,0.0,17,0.0108765195138,2,0.00127959053103,14,0.00895713371721,67,1,1,67,68,4,0.00255918106206,67,0.0428662827895,15,0.00959692898273,1548,0.990403071017,1460,0.934101087652,01-30,Wake,3718301-30
Wake,7924,3715,0.468828874306,2045,0.258076728925,47,0.00593134780414,1203,0.151817264008,629,0.0793791014639,285,0.0359666834932,2161,119,84,2126,2245,116,0.0146390711762,2161,0.272715800101,1087,0.137178192832,6837,0.862821807168,3423,0.431978798587,01-31,Wake,3718301-31
Wake,4462,2770,0.620797848498,946,0.212012550426,35,0.00784401613626,166,0.0372030479606,385,0.0862841774989,160,0.0358583594801,1020,78,68,1010,1088,74,0.0165844912595,1020,0.228597041685,653,0.146346929628,3809,0.853653070372,2587,0.579784849843,01-32,Wake,3718301-32
Wake,2177,1647,0.756545705099,142,0.0652273771245,3,0.00137804317869,349,0.160312356454,8,0.00367478180983,28,0.0128617363344,151,7,5,149,156,9,0.00413412953606,151,0.0693615066605,42,0.0192926045016,2135,0.980707395498,1614,0.741387230133,01-33,Wake,3718301-33
Wake,3092,249,0.0805304010349,2712,0.877102199224,12,0.00388098318241,5,0.001617076326,38,0.0122897800776,76,0.0245795601552,2784,40,14,2758,2798,72,0.0232858990944,2784,0.900388098318,115,0.0371927554981,2977,0.962807244502,209,0.0675937904269,01-34,Wake,3718301-34
Wake,4820,488,0.101244813278,3214,0.666804979253,45,0.00933609958506,4,0.000829875518672,933,0.19356846473,136,0.0282157676349,3296,77,52,3271,3348,82,0.0170124481328,3296,0.683817427386,1469,0.304771784232,3351,0.695228215768,89,0.0184647302905,01-35,Wake,3718301-35
Wake,2452,2084,0.849918433931,240,0.0978792822186,1,0.000407830342577,37,0.0150897226754,47,0.0191680261011,43,0.0175367047308,259,11,8,256,267,19,0.00774877650897,259,0.105628058728,86,0.0350734094617,2366,0.964926590538,2059,0.839722675367,01-36,Wake,3718301-36
Wake,2389,2098,0.878191712013,189,0.079112599414,5,0.00209292591042,63,0.0263708664713,17,0.00711594809544,17,0.00711594809544,199,7,7,199,206,10,0.00418585182085,199,0.0832984512348,88,0.0368354960234,2301,0.963164503977,2034,0.85140226036,01-37,Wake,3718301-37
Wake,3552,1879,0.528997747748,980,0.275900900901,22,0.00619369369369,176,0.0495495495495,405,0.11402027027,90,0.0253378378378,1021,51,38,1008,1059,41,0.0115427927928,1021,0.287443693694,654,0.184121621622,2898,0.815878378378,1686,0.474662162162,01-38,Wake,3718301-38
Wake,3830,2382,0.621932114883,1111,0.290078328982,12,0.00313315926893,46,0.0120104438642,129,0.033681462141,150,0.0391644908616,1214,44,21,1191,1235,103,0.0268929503916,1214,0.316971279373,265,0.0691906005222,3565,0.930809399478,2287,0.597127937337,01-39,Wake,3718301-39
Wake,8495,1152,0.135609181872,5961,0.701706886404,84,0.00988816951148,119,0.0140082401413,973,0.114537963508,206,0.0242495585639,6113,136,97,6074,6210,152,0.0178928781636,6113,0.719599764567,1778,0.209299587993,6717,0.790700412007,576,0.0678045909358,01-40,Wake,3718301-40
Wake,4225,2801,0.662958579882,434,0.102721893491,28,0.00662721893491,697,0.164970414201,170,0.0402366863905,95,0.0224852071006,472,60,42,454,514,38,0.00899408284024,472,0.111715976331,345,0.0816568047337,3880,0.918343195266,2666,0.63100591716,01-41,Wake,3718301-41
Wake,3545,3037,0.856699576869,261,0.0736248236953,17,0.00479548660085,137,0.0386459802539,42,0.0118476727786,51,0.0143864598025,282,25,21,278,303,21,0.00592383638928,282,0.0795486600846,130,0.0366713681241,3415,0.963328631876,2957,0.8341325811,01-42,Wake,3718301-42
Wake,4059,2343,0.577235772358,1071,0.263858093126,29,0.00714461690071,70,0.0172456270017,390,0.0960827790096,156,0.0384331116038,1166,56,43,1153,1209,95,0.0234047795023,1166,0.287262872629,761,0.187484602119,3298,0.812515397881,2074,0.510963291451,01-43,Wake,3718301-43
Wake,5822,3111,0.534352456201,1730,0.297148746135,28,0.00480934386809,112,0.0192373754723,677,0.116283064239,164,0.0281690140845,1812,67,49,1794,1861,82,0.0140845070423,1812,0.311233253178,1079,0.185331501202,4743,0.814668498798,2849,0.489350738578,01-44,Wake,3718301-44
Wake,3467,2034,0.586674358235,669,0.192962215172,9,0.00259590423998,285,0.0822036342659,357,0.102970868186,113,0.0325930199019,709,43,34,700,743,40,0.0115373521777,709,0.204499567349,627,0.180847995385,2840,0.819152004615,1802,0.519757715604,01-45,Wake,3718301-45
Wake,7408,1776,0.239740820734,3523,0.475566954644,81,0.01093412527,255,0.0344222462203,1469,0.198299136069,304,0.0410367170626,3725,148,108,3685,3833,202,0.0272678185745,3725,0.502834773218,2587,0.349217062635,4821,0.650782937365,1049,0.141603671706,01-46,Wake,3718301-46
Wake,2850,2569,0.901403508772,167,0.0585964912281,6,0.00210526315789,59,0.020701754386,11,0.00385964912281,38,0.0133333333333,177,18,16,175,193,10,0.00350877192982,177,0.0621052631579,63,0.0221052631579,2787,0.977894736842,2528,0.88701754386,01-47,Wake,3718301-47
Wake,3396,2476,0.729093050648,509,0.14988221437,18,0.00530035335689,140,0.0412249705536,145,0.0426972909305,108,0.0318021201413,556,36,29,549,585,47,0.013839811543,556,0.163722025913,337,0.099234393404,3059,0.900765606596,2325,0.684628975265,01-48,Wake,3718301-48
Wake,4671,2405,0.514879040891,1389,0.297366730893,36,0.00770712909441,267,0.0571612074502,413,0.0884178976665,161,0.0344679940056,1472,72,52,1452,1524,83,0.017769214301,1472,0.315135945194,663,0.141939627489,4008,0.858060372511,2220,0.475272960822,01-49,Wake,3718301-49
Wake,3360,265,0.078869047619,2829,0.841964285714,22,0.00654761904762,56,0.0166666666667,140,0.0416666666667,48,0.0142857142857,2864,33,23,2854,2887,35,0.0104166666667,2864,0.852380952381,258,0.0767857142857,3102,0.923214285714,180,0.0535714285714,01-50,Wake,3718301-50
Wake,1459,1190,0.815627141878,187,0.128169979438,0,0.0,21,0.0143934201508,30,0.0205620287868,31,0.0212474297464,195,8,6,193,201,8,0.00548320767649,195,0.133653187114,77,0.0527758738862,1382,0.947224126114,1167,0.799862919808,01-51,Wake,3718301-51
Wake,4037,3547,0.878622739658,246,0.0609363388655,5,0.00123854347288,158,0.0391379737429,15,0.00371563041863,66,0.016348773842,260,16,15,259,275,14,0.00346792172405,260,0.0644042605895,105,0.0260094129304,3932,0.97399058707,3465,0.858310626703,02-01,Wake,3718302-01
Wake,6866,6138,0.893970288378,387,0.0563646956015,12,0.00174774249927,150,0.0218467812409,54,0.00786484124672,125,0.0182056510341,406,43,36,399,442,19,0.00276725895718,406,0.0591319545587,238,0.0346635595689,6628,0.965336440431,5968,0.869210602971,02-02,Wake,3718302-02
Wake,3614,3350,0.926950747095,100,0.0276701715551,3,0.000830105146652,79,0.0218594355285,26,0.00719424460432,56,0.0154952960708,120,22,9,107,129,20,0.00553403431101,120,0.0332042058661,82,0.0226895406752,3532,0.977310459325,3290,0.910348644162,02-03,Wake,3718302-03
Wake,2980,2704,0.907382550336,95,0.0318791946309,5,0.00167785234899,104,0.0348993288591,21,0.00704697986577,51,0.0171140939597,105,19,16,102,121,10,0.00335570469799,105,0.0352348993289,85,0.0285234899329,2895,0.971476510067,2647,0.888255033557,02-04,Wake,3718302-04
Wake,1300,1176,0.904615384615,42,0.0323076923077,9,0.00692307692308,53,0.0407692307692,5,0.00384615384615,15,0.0115384615385,47,12,12,47,59,5,0.00384615384615,47,0.0361538461538,21,0.0161538461538,1279,0.983846153846,1162,0.893846153846,02-05,Wake,3718302-05
Wake,3258,2962,0.909146715777,130,0.0399017802333,6,0.00184162062615,107,0.0328422344997,14,0.00429711479435,39,0.01197053407,139,12,8,135,147,9,0.00276243093923,139,0.0426642111725,73,0.0224063842848,3185,0.977593615715,2911,0.893492940454,02-06,Wake,3718302-06
Wake,3251,2541,0.781605659797,340,0.104583205168,31,0.00953552752999,172,0.0529067979083,66,0.020301445709,101,0.031067363888,386,68,42,360,428,46,0.0141494924639,386,0.118732697631,166,0.0510612119348,3085,0.948938788065,2466,0.758535835128,03-00,Wake,3718303-00
Wake,3013,2225,0.73846664454,417,0.138400265516,26,0.00862927314968,72,0.0238964487222,191,0.0633919681381,82,0.0272153999336,464,54,43,453,507,47,0.0155990706937,464,0.15399933621,415,0.137736475274,2598,0.862263524726,2036,0.675738466645,04-01,Wake,3718304-01
Wake,5103,3331,0.652753282383,402,0.0787771898883,89,0.0174407211444,224,0.0438957475995,928,0.181853811483,129,0.0252792475015,459,116,106,449,565,57,0.0111699000588,459,0.0899470899471,1863,0.365079365079,3240,0.634920634921,2536,0.496962571037,04-02,Wake,3718304-02
Wake,3490,2240,0.641833810888,650,0.186246418338,33,0.00945558739255,176,0.0504297994269,240,0.0687679083095,151,0.0432664756447,722,82,66,706,788,72,0.0206303724928,722,0.206876790831,633,0.181375358166,2857,0.818624641834,1940,0.555873925501,04-03,Wake,3718304-03
Wake,3397,1857,0.546658816603,680,0.200176626435,19,0.00559317044451,117,0.0344421548425,570,0.167795113335,154,0.0453341183397,741,76,50,715,791,61,0.0179570209008,741,0.218133647336,943,0.277597880483,2454,0.722402119517,1561,0.459523108625,04-04,Wake,3718304-04
Wake,3842,2867,0.746225923998,254,0.0661114003123,21,0.00546590317543,561,0.146017699115,38,0.00989068193649,101,0.0262883914628,273,37,35,271,308,19,0.00494534096825,273,0.0710567412806,192,0.0499739718896,3650,0.95002602811,2743,0.713951067153,04-05,Wake,3718304-05
Wake,3681,3169,0.86090736213,240,0.0651996740016,7,0.00190165715838,138,0.0374898125509,59,0.0160282531921,68,0.0184732409671,273,34,15,254,288,33,0.00896495517522,273,0.0741646291769,159,0.0431947840261,3522,0.956805215974,3078,0.836185819071,04-06,Wake,3718304-06
Wake,3264,3020,0.925245098039,47,0.0143995098039,8,0.00245098039216,129,0.0395220588235,22,0.00674019607843,38,0.0116421568627,50,14,14,50,64,3,0.000919117647059,50,0.015318627451,106,0.0324754901961,3158,0.967524509804,2938,0.90012254902,04-07,Wake,3718304-07
Wake,3361,2278,0.677774471883,475,0.141326986016,8,0.00238024397501,382,0.113656649807,93,0.0276703362095,125,0.0371913121095,538,35,22,525,560,63,0.0187444213032,538,0.160071407319,289,0.0859863135971,3072,0.914013686403,2105,0.626301695924,04-08,Wake,3718304-08
Wake,3821,2941,0.769693797435,230,0.0601936665794,12,0.00314053912588,522,0.136613451976,37,0.00968332897147,79,0.0206752159121,261,28,16,249,277,31,0.00811305940853,261,0.068306725988,166,0.0434441245747,3655,0.956555875425,2810,0.735409578644,04-09,Wake,3718304-09
Wake,3851,3152,0.818488704233,199,0.0516748896391,10,0.00259672812257,362,0.0940015580369,42,0.0109062581148,86,0.0223318618541,223,33,28,218,251,24,0.00623214749416,223,0.0579070371332,212,0.0550506361984,3639,0.944949363802,3010,0.781615164892,04-10,Wake,3718304-10
Wake,2661,1691,0.635475385194,393,0.147688838782,54,0.0202931228861,217,0.0815482901165,208,0.0781661029688,98,0.0368282600526,435,77,70,428,505,42,0.0157835400225,435,0.163472378805,537,0.201803833145,2124,0.798196166855,1439,0.540774145058,04-11,Wake,3718304-11
Wake,3610,3162,0.875900277008,183,0.0506925207756,3,0.000831024930748,158,0.0437673130194,29,0.00803324099723,75,0.0207756232687,211,23,15,203,226,28,0.00775623268698,211,0.0584487534626,146,0.0404432132964,3464,0.959556786704,3067,0.849584487535,04-12,Wake,3718304-12
Wake,6112,4366,0.714332460733,321,0.0525196335079,4,0.00065445026178,1229,0.201079842932,49,0.00801701570681,143,0.0233965968586,359,24,15,350,374,38,0.00621727748691,359,0.0587369109948,213,0.0348494764398,5899,0.96515052356,4212,0.689136125654,04-13,Wake,3718304-13
Wake,2263,1999,0.883340698188,118,0.0521431727795,3,0.00132567388422,43,0.0190013256739,35,0.015466195316,65,0.0287229341582,142,28,21,135,163,24,0.0106053910738,142,0.0627485638533,144,0.0636323464428,2119,0.936367653557,1910,0.844012372956,04-14,Wake,3718304-14
Wake,3019,2497,0.827095064591,255,0.0844650546539,6,0.00198741305068,198,0.0655846306724,17,0.00563100364359,46,0.0152368333885,264,21,21,264,285,9,0.00298111957602,264,0.0874461742299,138,0.0457105001656,2881,0.954289499834,2387,0.790659158662,04-15,Wake,3718304-15
Wake,2779,2411,0.867578265563,161,0.0579345088161,17,0.00611730838431,93,0.0334652752789,29,0.0104354084203,68,0.0244692335372,184,27,22,179,206,23,0.0082763584023,184,0.0662108672184,109,0.0392227419935,2670,0.960777258006,2339,0.841669665347,04-16,Wake,3718304-16
Wake,2672,2084,0.77994011976,278,0.104041916168,14,0.00523952095808,195,0.0729790419162,33,0.0123502994012,68,0.0254491017964,304,24,20,300,324,26,0.00973053892216,304,0.11377245509,187,0.0699850299401,2485,0.93001497006,1970,0.737275449102,04-17,Wake,3718304-17
Wake,3720,2661,0.715322580645,342,0.091935483871,10,0.00268817204301,537,0.14435483871,62,0.0166666666667,108,0.0290322580645,370,35,25,360,395,28,0.00752688172043,370,0.0994623655914,155,0.0416666666667,3565,0.958333333333,2571,0.691129032258,04-18,Wake,3718304-18
Wake,2456,2116,0.861563517915,74,0.0301302931596,3,0.00122149837134,183,0.0745114006515,20,0.00814332247557,60,0.0244299674267,85,16,14,83,99,11,0.00447882736156,85,0.0346091205212,94,0.0382736156352,2362,0.961726384365,2048,0.833876221498,04-19,Wake,3718304-19
Wake,4728,3295,0.696912013536,539,0.114001692047,37,0.00782571912014,377,0.0797377326565,348,0.0736040609137,132,0.0279187817259,594,66,47,575,641,55,0.0116328257191,594,0.125634517766,699,0.147842639594,4029,0.852157360406,3002,0.634940778342,04-20,Wake,3718304-20
Wake,3252,1842,0.566420664207,781,0.240159901599,33,0.010147601476,297,0.0913284132841,168,0.0516605166052,131,0.040282902829,837,74,59,822,896,56,0.0172201722017,837,0.257380073801,464,0.142681426814,2788,0.857318573186,1608,0.494464944649,04-21,Wake,3718304-21
Wake,5977,3991,0.667726284089,782,0.13083486699,30,0.00501924042162,871,0.145725280241,105,0.0175673414757,198,0.0331269867827,880,73,53,860,933,98,0.0163961853773,880,0.147231052367,360,0.0602308850594,5617,0.939769114941,3783,0.632926217166,05-01,Wake,3718305-01
Wake,4522,3002,0.663865546218,350,0.077399380805,19,0.00420168067227,1003,0.221804511278,66,0.0145953118089,82,0.0181335692172,381,38,29,372,410,31,0.00685537372844,381,0.0842547545334,192,0.0424590888987,4330,0.957540911101,2883,0.637549756745,05-03,Wake,3718305-03
Wake,14643,6987,0.477156320426,1671,0.114115959844,49,0.0033463088165,5173,0.353274602199,252,0.0172095881991,511,0.0348972205149,1862,147,106,1821,1968,191,0.0130437751827,1862,0.127159735027,816,0.0557262855972,13827,0.944273714403,6515,0.444922488561,05-04,Wake,3718305-04
Wake,8663,5514,0.636500057717,1821,0.210204317211,23,0.00265496941014,904,0.104351841164,140,0.016160683366,261,0.0301281311324,1948,79,49,1918,1997,127,0.0146600484821,1948,0.224864365693,479,0.0552926238024,8184,0.944707376198,5240,0.6048712917,05-05,Wake,3718305-05
Wake,7036,4994,0.709778283115,262,0.0372370665151,9,0.00127913587265,1585,0.225270039795,32,0.00454803865833,154,0.0218874360432,292,18,18,292,310,30,0.00426378624218,292,0.0415008527572,209,0.0297043774872,6827,0.970295622513,4835,0.687180216032,05-06,Wake,3718305-06
Wake,11080,8625,0.778429602888,1653,0.149187725632,78,0.00703971119134,235,0.0212093862816,232,0.0209386281588,257,0.0231949458484,1770,113,105,1762,1875,117,0.010559566787,1770,0.159747292419,778,0.0702166064982,10302,0.929783393502,8144,0.735018050542,06-01,Wake,3718306-01
Wake,3601,2534,0.703693418495,746,0.207164676479,8,0.00222160510969,56,0.0155512357678,142,0.039433490697,115,0.0319355734518,805,43,28,790,833,59,0.016384337684,805,0.223549014163,318,0.0883088031102,3283,0.91169119689,2396,0.665370730353,06-04,Wake,3718306-04
Wake,4234,3894,0.919697685404,215,0.0507794048181,4,0.000944733112896,43,0.0101558809636,29,0.00684931506849,49,0.011572980633,242,27,9,224,251,27,0.00637694851205,242,0.0571563533302,162,0.0382616910723,4072,0.961738308928,3770,0.890410958904,06-05,Wake,3718306-05
Wake,6736,5222,0.775237529691,833,0.123663895487,49,0.00727434679335,337,0.0500296912114,93,0.0138064133017,202,0.0299881235154,930,101,73,902,1003,97,0.0144002375297,930,0.138064133017,380,0.0564133016627,6356,0.943586698337,4986,0.740201900238,06-06,Wake,3718306-06
Wake,5164,3931,0.761231603408,654,0.126646010844,16,0.00309837335399,337,0.0652594887684,142,0.0274980635167,84,0.0162664601084,681,38,34,677,715,27,0.00522850503486,681,0.131874515879,395,0.0764910921766,4769,0.923508907823,3698,0.716111541441,06-07,Wake,3718306-07
Wake,2801,1875,0.669403784363,572,0.20421278115,24,0.00856836843984,45,0.0160656908247,217,0.0774723313102,68,0.0242770439129,610,50,36,596,646,38,0.0135665833631,610,0.217779364513,455,0.162441985005,2346,0.837558014995,1687,0.602284898251,07-01,Wake,3718307-01
Wake,2037,1399,0.686794305351,398,0.195385370643,21,0.0103092783505,56,0.0274914089347,108,0.0530191458027,55,0.027000490918,417,31,25,411,442,19,0.00932744231713,417,0.20471281296,201,0.0986745213549,1836,0.901325478645,1334,0.654884634266,07-02,Wake,3718307-02
Wake,2041,1808,0.885840274375,116,0.0568348848604,2,0.000979911807937,40,0.0195982361587,45,0.0220480156786,30,0.0146986771191,126,5,4,125,130,10,0.00489955903969,126,0.0617344439,85,0.0416462518373,1956,0.958353748163,1778,0.871141597256,07-03,Wake,3718307-03
Wake,5964,4032,0.676056338028,1375,0.230549966465,27,0.00452716297787,134,0.0224681421865,223,0.0373910127431,173,0.0290073775989,1447,61,47,1433,1494,72,0.0120724346076,1447,0.242622401073,511,0.0856807511737,5453,0.914319248826,3848,0.645204560698,07-04,Wake,3718307-04
Wake,2564,1895,0.739079563183,443,0.172776911076,14,0.00546021840874,38,0.0148205928237,127,0.0495319812793,47,0.0183307332293,473,17,17,473,490,30,0.0117004680187,473,0.184477379095,246,0.0959438377535,2318,0.904056162246,1803,0.703198127925,07-05,Wake,3718307-05
Wake,4247,3697,0.870496821286,247,0.058158700259,11,0.00259006357429,128,0.0301389215917,72,0.0169531433953,92,0.021662349894,295,27,21,289,316,48,0.0113020955969,295,0.0694607958559,206,0.0485048269367,4041,0.951495173063,3570,0.840593360019,07-06,Wake,3718307-06
Wake,5430,4558,0.8394106814,511,0.0941068139963,6,0.00110497237569,166,0.0305709023941,76,0.0139963167587,113,0.0208103130755,571,29,17,559,588,60,0.0110497237569,571,0.105156537753,236,0.0434622467772,5194,0.956537753223,4424,0.814732965009,07-07,Wake,3718307-07
Wake,4638,3271,0.705260888314,538,0.115998275119,30,0.00646830530401,213,0.0459249676585,468,0.100905562743,118,0.0254420008624,584,55,45,574,629,46,0.00991806813282,584,0.125916343251,771,0.166235446313,3867,0.833764553687,3007,0.648339801639,07-09,Wake,3718307-09
Wake,6941,4813,0.693415934303,1271,0.183114824953,33,0.00475435816165,400,0.0576285837776,268,0.038611151131,156,0.0224751476732,1338,76,51,1313,1389,67,0.00965278778274,1338,0.192767612736,627,0.0903328050713,6314,0.909667194929,4505,0.649041924795,07-10,Wake,3718307-10
Wake,1277,1187,0.929522317933,42,0.0328895849648,0,0.0,32,0.0250587314017,1,0.000783085356304,15,0.0117462803446,48,7,1,42,49,6,0.00469851213782,48,0.0375880971026,32,0.0250587314017,1245,0.974941268598,1163,0.910728269381,07-11,Wake,3718307-11
Wake,3669,2581,0.703461433633,662,0.18043063505,5,0.00136276914691,73,0.0198964295448,257,0.070046334151,91,0.0248023984737,711,28,21,704,732,49,0.0133551376397,711,0.19378577269,490,0.133551376397,3179,0.866448623603,2390,0.651403652221,07-12,Wake,3718307-12
Wake,2466,1774,0.719383617194,489,0.198296836983,12,0.00486618004866,77,0.0312246553122,73,0.029602595296,41,0.0166261151663,517,18,16,515,533,28,0.0113544201135,517,0.209651257097,163,0.066098945661,2303,0.933901054339,1716,0.695863746959,07-13,Wake,3718307-13
Wake,5481,4342,0.792191205984,692,0.126254333151,20,0.00364896916621,213,0.0388615216201,98,0.0178799489144,116,0.021164021164,738,39,32,731,770,46,0.00839262908228,738,0.134646962233,269,0.0490786352855,5212,0.950921364714,4212,0.768472906404,08-02,Wake,3718308-02
Wake,6335,4801,0.757853196527,814,0.128492501973,14,0.00220994475138,447,0.0705603788477,96,0.0151539068666,163,0.0257300710339,887,54,35,868,922,73,0.0115232833465,887,0.14001578532,336,0.0530386740331,5999,0.946961325967,4595,0.725335438043,08-03,Wake,3718308-03
Wake,2196,2056,0.936247723133,60,0.0273224043716,2,0.000910746812386,43,0.0195810564663,5,0.00227686703097,30,0.0136612021858,74,10,6,70,80,14,0.0063752276867,74,0.0336976320583,67,0.0305100182149,2129,0.969489981785,1999,0.91029143898,08-04,Wake,3718308-04
Wake,2661,2343,0.880496054115,169,0.0635099586622,5,0.00187899285983,79,0.0296880871853,23,0.0086433671552,42,0.0157835400225,183,27,20,176,203,14,0.00526118000752,183,0.0687711386697,78,0.0293122886133,2583,0.970687711387,2293,0.861706125517,08-05,Wake,3718308-05
Wake,3588,2231,0.621794871795,1005,0.280100334448,25,0.00696767001115,77,0.0214604236343,140,0.0390189520624,110,0.0306577480491,1064,66,49,1047,1113,59,0.0164437012263,1064,0.296544035674,314,0.08751393534,3274,0.91248606466,2125,0.592251950948,08-06,Wake,3718308-06
Wake,3134,2773,0.884811742183,127,0.0405232929164,3,0.000957243139757,144,0.0459476707084,17,0.00542437779196,70,0.022335673261,145,11,10,144,155,18,0.00574345883854,145,0.0462667517549,77,0.0245692405871,3057,0.975430759413,2727,0.87013401404,08-07,Wake,3718308-07
Wake,5970,5238,0.877386934673,348,0.0582914572864,15,0.00251256281407,209,0.0350083752094,33,0.00552763819095,127,0.0212730318258,389,37,32,384,421,41,0.00686767169179,389,0.0651591289782,251,0.0420435510888,5719,0.957956448911,5036,0.843551088777,08-08,Wake,3718308-08
Wake,2868,2107,0.734658298466,500,0.174337517434,5,0.00174337517434,76,0.0264993026499,124,0.0432357043236,56,0.0195258019526,517,16,10,511,527,17,0.00592747559275,517,0.180264993026,266,0.0927475592748,2602,0.907252440725,2004,0.698744769874,08-09,Wake,3718308-09
Wake,3746,2739,0.731179925254,603,0.16097170315,15,0.00400427122264,242,0.0646022423919,63,0.0168179391351,84,0.0224239188468,636,35,28,629,664,33,0.0088093966898,636,0.16978109984,189,0.0504538174052,3557,0.949546182595,2643,0.705552589429,08-10,Wake,3718308-10
Wake,5875,4044,0.688340425532,699,0.118978723404,20,0.00340425531915,881,0.149957446809,102,0.0173617021277,129,0.0219574468085,752,43,29,738,781,53,0.00902127659574,752,0.128,327,0.0556595744681,5548,0.944340425532,3836,0.652936170213,08-11,Wake,3718308-11
Wake,3417,2099,0.614281533509,967,0.282996780802,14,0.00409716125256,16,0.00468247000293,253,0.0740415569213,68,0.0199004975124,992,30,21,983,1013,25,0.00731635937957,992,0.290313140181,401,0.117354404448,3016,0.882645595552,1981,0.579748317237,09-01,Wake,3718309-01
Wake,5881,2829,0.481040639347,2186,0.371705492263,30,0.00510117326985,49,0.00833191634076,590,0.100323074307,197,0.033497704472,2293,81,64,2276,2357,107,0.0181941846625,2293,0.389899676926,990,0.168338717905,4891,0.831661282095,2567,0.43649039279,09-02,Wake,3718309-02
Wake,3230,2353,0.728482972136,662,0.204953560372,18,0.00557275541796,38,0.0117647058824,92,0.0284829721362,67,0.0207430340557,702,36,23,689,725,40,0.0123839009288,702,0.2173374613,182,0.056346749226,3048,0.943653250774,2292,0.70959752322,09-03,Wake,3718309-03
Wake,2071,1500,0.724287783679,297,0.143408981169,11,0.00531144374698,36,0.0173829068083,168,0.0811202317721,59,0.0284886528247,327,27,18,318,345,30,0.0144857556736,327,0.157894736842,248,0.119748913568,1823,0.880251086432,1444,0.697247706422,10-01,Wake,3718310-01
Wake,6441,3585,0.556590591523,1803,0.27992547741,49,0.00760751436112,50,0.00776276975625,749,0.116286290949,205,0.0318273560006,1883,118,100,1865,1983,80,0.01242043161,1883,0.29234590902,1322,0.205247632355,5119,0.794752367645,3173,0.492625368732,10-02,Wake,3718310-02
Wake,4270,2414,0.565339578454,1320,0.309133489461,31,0.00725995316159,30,0.00702576112412,340,0.07962529274,135,0.0316159250585,1397,72,49,1374,1446,77,0.0180327868852,1397,0.327166276347,560,0.131147540984,3710,0.868852459016,2260,0.529274004684,10-03,Wake,3718310-03
Wake,9150,4673,0.510710382514,3240,0.354098360656,89,0.00972677595628,131,0.0143169398907,729,0.0796721311475,288,0.0314754098361,3420,190,146,3376,3566,180,0.0196721311475,3420,0.373770491803,1347,0.147213114754,7803,0.852786885246,4269,0.466557377049,10-04,Wake,3718310-04
Wake,5312,3906,0.73531626506,916,0.172439759036,15,0.00282379518072,245,0.0461219879518,92,0.0173192771084,138,0.0259789156627,989,62,32,959,1021,73,0.0137424698795,989,0.186182228916,258,0.0485692771084,5054,0.951430722892,3784,0.71234939759,11-01,Wake,3718311-01
Wake,4788,4006,0.836675020886,446,0.093149540518,14,0.00292397660819,165,0.0344611528822,82,0.0171261487051,75,0.015664160401,477,27,22,472,499,31,0.00647451963241,477,0.0996240601504,209,0.0436507936508,4579,0.956349206349,3902,0.814954051796,11-02,Wake,3718311-02
Wake,7123,5925,0.831812438579,694,0.0974308577846,23,0.00322897655482,107,0.0150217604942,230,0.0322897655482,144,0.0202162010389,748,49,38,737,786,54,0.00758107538958,748,0.105011933174,566,0.0794609013056,6557,0.920539098694,5646,0.792643549066,12-01,Wake,3718312-01
Wake,5510,3867,0.701814882033,1143,0.207441016334,48,0.00871143375681,91,0.0165154264973,197,0.0357531760436,164,0.0297640653358,1234,93,67,1208,1301,91,0.0165154264973,1234,0.223956442831,596,0.108166969147,4914,0.891833030853,3552,0.644646098004,12-02,Wake,3718312-02
Wake,5714,4775,0.835666783339,441,0.0771788589429,32,0.005600280014,37,0.00647532376619,269,0.0470773538677,160,0.02800140007,500,87,73,486,573,59,0.0103255162758,500,0.0875043752188,639,0.11183059153,5075,0.88816940847,4478,0.783689184459,12-04,Wake,3718312-04
Wake,9236,7628,0.825898657427,870,0.0941966219142,51,0.0055218709398,173,0.0187310524036,339,0.0367042009528,175,0.0189475963621,942,88,73,927,1015,72,0.00779558250325,942,0.101992204417,861,0.0932221741013,8375,0.906777825899,7167,0.775985275011,12-05,Wake,3718312-05
Wake,4280,3303,0.771728971963,626,0.146261682243,39,0.00911214953271,66,0.0154205607477,146,0.0341121495327,100,0.0233644859813,675,80,68,663,743,49,0.0114485981308,675,0.157710280374,423,0.0988317757009,3857,0.901168224299,3089,0.721728971963,12-06,Wake,3718312-06
Wake,3904,3090,0.791495901639,481,0.123206967213,15,0.00384221311475,19,0.00486680327869,223,0.0571209016393,76,0.0194672131148,520,37,32,515,552,39,0.00998975409836,520,0.133196721311,413,0.105788934426,3491,0.894211065574,2896,0.741803278689,12-07,Wake,3718312-07
Wake,6176,4246,0.6875,1502,0.243199481865,26,0.00420984455959,119,0.019268134715,126,0.0204015544041,157,0.025420984456,1570,61,51,1560,1621,68,0.0110103626943,1570,0.25420984456,506,0.0819300518135,5670,0.918069948187,3927,0.635848445596,12-08,Wake,3718312-08
Wake,4449,3504,0.787592717465,608,0.136659923578,46,0.0103394021128,78,0.0175320296696,110,0.0247246572263,103,0.0231512699483,652,86,65,631,717,44,0.00988986289054,652,0.146549786469,394,0.0885592267925,4055,0.911440773207,3260,0.732748932344,12-09,Wake,3718312-09
Wake,9027,2911,0.322477013404,4039,0.447435471364,88,0.00974853218123,365,0.0404342527972,1266,0.14024592888,358,0.0396588013737,4245,185,132,4192,4377,206,0.0228204276061,4245,0.47025589897,2369,0.26243491747,6658,0.73756508253,2059,0.228093497286,13-01,Wake,3718313-01
Wake,2859,2400,0.839454354669,263,0.0919902063659,10,0.00349772647779,97,0.0339279468346,29,0.0101434067856,60,0.0209863588667,284,19,17,282,301,21,0.00734522560336,284,0.0993354319692,132,0.0461699895068,2727,0.953830010493,2324,0.812871633438,13-02,Wake,3718313-02
Wake,3232,1481,0.45823019802,1264,0.391089108911,22,0.00680693069307,94,0.0290841584158,260,0.0804455445545,111,0.0343440594059,1329,56,38,1311,1367,65,0.0201113861386,1329,0.41120049505,654,0.202351485149,2578,0.797648514851,1168,0.361386138614,13-05,Wake,3718313-05
Wake,4217,3163,0.750059283851,701,0.166231918425,11,0.00260848944747,189,0.0448185914157,45,0.0106710931942,108,0.0256106236661,748,39,19,728,767,47,0.0111453640028,748,0.177377282428,217,0.0514583827365,4000,0.948541617263,3003,0.712117619161,13-06,Wake,3718313-06
Wake,2928,1455,0.496926229508,954,0.325819672131,16,0.00546448087432,234,0.0799180327869,169,0.057718579235,100,0.0341530054645,1007,32,24,999,1031,53,0.0181010928962,1007,0.343920765027,411,0.140368852459,2517,0.859631147541,1293,0.441598360656,13-07,Wake,3718313-07
Wake,4885,1696,0.347185261003,2237,0.457932446264,41,0.00839303991812,178,0.0364380757421,516,0.105629477994,217,0.0444216990788,2365,98,58,2325,2423,128,0.0262026612078,2365,0.484135107472,1188,0.243193449335,3697,0.756806550665,1190,0.243602865916,13-08,Wake,3718313-08
Wake,6698,2706,0.404001194386,2908,0.434159450582,42,0.00627052851597,618,0.0922663481636,205,0.0306061510899,219,0.0326963272619,3061,107,57,3011,3118,153,0.0228426395939,3061,0.457002090176,631,0.0942072260376,6067,0.905792773962,2404,0.358913108391,13-09,Wake,3718313-09
Wake,7767,6467,0.832625209218,727,0.0936011329986,17,0.00218874726407,282,0.0363074546157,68,0.00875498905626,206,0.0265224668469,815,57,36,794,851,88,0.0113299858375,815,0.104931118836,356,0.0458349427063,7411,0.954165057294,6232,0.802368997039,13-10,Wake,3718313-10
Wake,4263,3650,0.856204550786,354,0.0830401125968,7,0.00164203612479,127,0.0297912268356,34,0.00797560403472,91,0.0213464696223,405,22,17,400,422,51,0.0119634060521,405,0.0950035186488,169,0.0396434435843,4094,0.960356556416,3527,0.827351630307,13-11,Wake,3718313-11
Wake,1010,910,0.90099009901,56,0.0554455445545,2,0.0019801980198,19,0.0188118811881,16,0.0158415841584,7,0.00693069306931,63,2,2,63,65,7,0.00693069306931,63,0.0623762376238,27,0.0267326732673,983,0.973267326733,898,0.889108910891,14-01,Wake,3718314-01
Wake,6595,6008,0.910993176649,267,0.0404852160728,24,0.00363912054587,120,0.0181956027293,107,0.0162244124337,69,0.0104624715694,296,38,34,292,330,29,0.00439727065959,296,0.0448824867324,268,0.0406368460955,6327,0.959363153904,5873,0.890523123578,14-02,Wake,3718314-02
Wake,6241,5164,0.827431501362,670,0.10735459061,23,0.00368530684185,67,0.010735459061,193,0.0309245313251,124,0.0198686107996,715,63,52,704,767,45,0.00721038295145,715,0.114564973562,450,0.0721038295145,5791,0.927896170485,4943,0.792020509534,15-01,Wake,3718315-01
Wake,8319,6070,0.729655006611,1022,0.122851304243,216,0.0259646592138,179,0.0215170092559,668,0.0802981127539,164,0.0197139079216,1112,245,233,1100,1345,90,0.0108186080058,1112,0.133669912249,1581,0.190046880635,6738,0.809953119365,5407,0.649957927636,15-02,Wake,3718315-02
Wake,6545,5417,0.827654698243,701,0.107104660046,53,0.00809778456837,28,0.00427807486631,155,0.0236822001528,191,0.0291825821238,791,124,106,773,897,90,0.0137509549274,791,0.120855614973,460,0.070282658518,6085,0.929717341482,5175,0.790679908327,15-03,Wake,3718315-03
Wake,2914,2266,0.777625257378,464,0.159231297186,15,0.00514756348662,27,0.00926561427591,85,0.0291695264242,57,0.0195607412491,483,26,20,477,503,19,0.00652024708305,483,0.165751544269,161,0.0552505147563,2753,0.944749485244,2223,0.762868908717,15-04,Wake,3718315-04
Wake,4055,2904,0.716152897657,737,0.181750924784,27,0.00665844636252,52,0.012823674476,255,0.0628853267571,80,0.019728729963,774,50,44,768,818,37,0.00912453760789,774,0.190875462392,417,0.102836004932,3638,0.897163995068,2768,0.68261405672,16-01,Wake,3718316-01
Wake,8594,2683,0.31219455434,4561,0.530719106353,42,0.0048871305562,98,0.0114033046311,948,0.110309518269,262,0.0304863858506,4742,121,69,4690,4811,181,0.0210612054922,4742,0.551780311845,1699,0.197696067024,6895,0.802303932976,2096,0.243891086805,16-02,Wake,3718316-02
Wake,2672,1486,0.556137724551,833,0.311751497006,14,0.00523952095808,25,0.00935628742515,260,0.0973053892216,54,0.0202095808383,856,25,24,855,880,23,0.00860778443114,856,0.320359281437,540,0.202095808383,2132,0.797904191617,1243,0.465194610778,16-03,Wake,3718316-03
Wake,3400,2240,0.658823529412,1003,0.295,8,0.00235294117647,24,0.00705882352941,76,0.0223529411765,49,0.0144117647059,1031,14,13,1030,1044,28,0.00823529411765,1031,0.303235294118,196,0.0576470588235,3204,0.942352941176,2166,0.637058823529,16-04,Wake,3718316-04
Wake,3985,2810,0.705144291092,769,0.192973651192,39,0.00978670012547,49,0.0122961104141,210,0.0526976160602,108,0.0271016311167,824,90,68,802,892,55,0.0138017565872,824,0.206775407779,462,0.115934755332,3523,0.884065244668,2616,0.656461731493,16-05,Wake,3718316-05
Wake,2467,1227,0.497365220916,1015,0.411430887718,6,0.00243210376976,12,0.00486420753952,128,0.0518848804216,79,0.0320226996352,1062,37,23,1048,1085,47,0.0190514795298,1062,0.430482367248,229,0.0928252938792,2238,0.907174706121,1160,0.47020672882,16-06,Wake,3718316-06
Wake,4530,3236,0.714348785872,1018,0.22472406181,12,0.00264900662252,79,0.0174392935982,92,0.0203090507726,93,0.0205298013245,1070,45,22,1047,1092,52,0.0114790286976,1070,0.236203090508,247,0.0545253863135,4283,0.945474613687,3097,0.683664459161,16-07,Wake,3718316-07
Wake,10877,2623,0.24115105268,6895,0.633906408017,59,0.00542428978579,166,0.0152615610922,824,0.075756182771,310,0.0285005056541,7116,130,78,7064,7194,221,0.0203181024179,7116,0.654224510435,1623,0.149213937667,9254,0.850786062333,2078,0.191045324998,16-08,Wake,3718316-08
Wake,4924,2893,0.587530463038,1514,0.3074735987,62,0.0125913891145,124,0.0251827782291,211,0.0428513403737,120,0.0243704305443,1573,80,72,1565,1645,59,0.0119821283509,1573,0.319455727051,580,0.117790414297,4344,0.882209585703,2609,0.529853777417,16-09,Wake,3718316-09
Wake,5153,2038,0.39549776829,1937,0.375897535416,36,0.00698622161847,264,0.0512322918688,743,0.144187851737,135,0.0261983310693,2017,76,55,1996,2072,80,0.0155249369299,2017,0.391422472346,1067,0.207063846303,4086,0.792936153697,1803,0.349893266059,17-01,Wake,3718317-01
Wake,1787,1070,0.598768886402,329,0.184107442641,12,0.00671516508114,17,0.00951315053162,278,0.155567991046,81,0.0453273642977,371,32,21,360,392,42,0.023503077784,371,0.207610520425,414,0.231673195299,1373,0.768326804701,975,0.545607162843,17-02,Wake,3718317-02
Wake,9072,5007,0.551917989418,3042,0.335317460317,22,0.00242504409171,532,0.0586419753086,194,0.0213844797178,275,0.0303130511464,3205,77,47,3175,3252,163,0.017967372134,3205,0.353284832451,572,0.0630511463845,8500,0.936948853616,4728,0.521164021164,17-03,Wake,3718317-03
Wake,7550,4150,0.549668874172,2309,0.30582781457,57,0.00754966887417,126,0.0166887417219,665,0.0880794701987,243,0.0321854304636,2424,131,87,2380,2511,115,0.0152317880795,2424,0.321059602649,1230,0.162913907285,6320,0.837086092715,3710,0.491390728477,17-04,Wake,3718317-04
Wake,6091,2678,0.439665079626,2518,0.413396814973,36,0.00591035954687,322,0.0528648826137,350,0.0574618289279,187,0.0307010343129,2617,75,49,2591,2666,99,0.0162534887539,2617,0.429650303727,827,0.135774092924,5264,0.864225907076,2380,0.39074043671,17-05,Wake,3718317-05
Wake,3445,2219,0.64412191582,610,0.177068214804,31,0.00899854862119,16,0.00464441219158,437,0.126850507983,132,0.0383164005806,640,62,52,630,692,30,0.00870827285922,640,0.185776487663,849,0.246444121916,2596,0.753555878084,1928,0.559651669086,17-06,Wake,3718317-06
Wake,6166,1650,0.267596496919,3281,0.53211157963,53,0.00859552384042,228,0.0369769704833,744,0.120661693156,210,0.0340577359715,3391,88,68,3371,3459,110,0.0178397664612,3391,0.549951346091,1234,0.200129743756,4932,0.799870256244,1315,0.213266299059,17-07,Wake,3718317-07
Wake,9986,5270,0.527738834368,3500,0.350490686962,63,0.00630883236531,210,0.0210294412177,629,0.0629881834568,314,0.0314440216303,3697,155,104,3646,3801,197,0.0197276186661,3697,0.370218305628,1227,0.122872020829,8759,0.877127979171,4799,0.480572801923,17-08,Wake,3718317-08
Wake,5502,807,0.14667393675,3747,0.681025081788,33,0.00599781897492,133,0.0241730279898,621,0.112868047983,161,0.029262086514,3871,80,38,3829,3909,124,0.0225372591785,3871,0.703562340967,1003,0.182297346419,4499,0.817702653581,544,0.0988731370411,17-09,Wake,3718317-09
Wake,2253,1109,0.492232578784,774,0.343541944075,23,0.0102086107412,113,0.0501553484243,175,0.0776742121616,59,0.0261873058145,812,47,31,796,843,38,0.0168664003551,812,0.36040834443,353,0.156679982246,1900,0.843320017754,970,0.430537061696,17-10,Wake,3718317-10
Wake,7930,2929,0.369356872636,2899,0.365573770492,74,0.0093316519546,591,0.074527112232,1141,0.143883984868,296,0.0373266078184,3044,134,102,3012,3146,145,0.0182849936948,3044,0.383858764187,2116,0.26683480454,5814,0.73316519546,2179,0.274779319042,17-11,Wake,3718317-11
Wake,8800,6317,0.717840909091,1664,0.189090909091,44,0.005,432,0.0490909090909,144,0.0163636363636,199,0.0226136363636,1742,91,79,1730,1821,78,0.00886363636364,1742,0.197954545455,402,0.0456818181818,8398,0.954318181818,6126,0.696136363636,18-01,Wake,3718318-01
Wake,5894,5347,0.907193756362,200,0.0339328130302,15,0.00254496097727,185,0.0313878520529,40,0.00678656260604,107,0.0181540549712,236,49,44,231,280,36,0.00610790634544,236,0.0400407193756,244,0.0413980318968,5650,0.958601968103,5169,0.876993552766,18-02,Wake,3718318-02
Wake,2665,2211,0.829643527205,94,0.0352720450281,0,0.0,256,0.0960600375235,43,0.0161350844278,61,0.0228893058161,104,13,8,99,112,10,0.00375234521576,104,0.0390243902439,76,0.0285178236398,2589,0.97148217636,2164,0.81200750469,18-03,Wake,3718318-03
Wake,5689,4435,0.779574617683,574,0.100896466866,44,0.00773422394094,170,0.0298822288627,353,0.0620495693443,113,0.0198628933029,603,68,62,597,665,29,0.00509755668835,603,0.105994023554,665,0.116892248198,5024,0.883107751802,4180,0.734751274389,18-04,Wake,3718318-04
Wake,5836,5318,0.911240575737,131,0.0224468814256,3,0.000514050719671,279,0.0478067169294,21,0.0035983550377,84,0.0143934201508,146,22,22,146,168,15,0.00257025359836,146,0.025017135024,163,0.0279300891021,5673,0.972069910898,5197,0.89050719671,18-05,Wake,3718318-05
Wake,5672,3930,0.692877291961,906,0.159732016925,29,0.00511283497884,544,0.0959097320169,94,0.0165726375176,169,0.0297954866008,979,63,54,970,1033,73,0.0128702397743,979,0.1726022567,287,0.0505994358251,5385,0.949400564175,3767,0.664139633286,18-06,Wake,3718318-06
Wake,4543,3850,0.847457627119,336,0.0739599383667,32,0.00704380365397,56,0.0123266563945,193,0.042482940788,76,0.0167290336782,370,59,51,362,421,34,0.00748404138235,370,0.0814439797491,347,0.0763812458728,4196,0.923618754127,3721,0.819062293639,18-07,Wake,3718318-07
Wake,5677,4430,0.780341729787,509,0.0896600317069,22,0.00387528624273,497,0.0875462392109,104,0.0183195349657,115,0.020257178087,553,47,41,547,594,44,0.00775057248547,553,0.0974106041924,315,0.055487053021,5362,0.944512946979,4239,0.746697199225,18-08,Wake,3718318-08
Wake,4468,3651,0.817144136079,471,0.105416293644,22,0.00492390331244,88,0.0196956132498,91,0.0203670546106,145,0.0324529991047,544,76,60,528,604,73,0.0163384064458,544,0.12175470009,249,0.0557296329454,4219,0.944270367055,3532,0.790510295434,19-03,Wake,3718319-03
Wake,8137,6096,0.749170455942,1362,0.167383556593,35,0.00430133956003,348,0.0427676047683,108,0.0132727049281,188,0.0231043382082,1462,80,63,1445,1525,100,0.0122895416001,1462,0.179673098193,461,0.0566547867765,7676,0.943345213224,5790,0.711564458646,19-04,Wake,3718319-04
Wake,4177,3723,0.89130955231,219,0.0524299736653,8,0.00191525017955,90,0.02154656452,60,0.0143643763467,77,0.0184342829782,229,27,22,224,251,10,0.00239406272444,229,0.0548240363898,191,0.0457265980369,3986,0.954273401963,3618,0.866171893704,19-05,Wake,3718319-05
Wake,10817,8055,0.744661181474,1533,0.141721364519,30,0.0027734122215,745,0.0688730701673,167,0.0154386613664,287,0.0265323102524,1650,99,70,1621,1720,117,0.0108163076639,1650,0.152537672183,588,0.0543588795415,10229,0.945641120459,7693,0.711195340667,19-06,Wake,3718319-06
Wake,3422,2033,0.594097019287,1203,0.35154880187,14,0.00409117475161,56,0.0163646990064,55,0.0160724722385,61,0.0178258328463,1239,44,31,1226,1270,36,0.010520163647,1239,0.362068965517,182,0.0531852717709,3240,0.946814728229,1926,0.562828755114,19-07,Wake,3718319-07
Wake,5362,4359,0.812942931742,712,0.132786273778,13,0.00242446848191,107,0.0199552405819,101,0.0188362551287,70,0.0130548302872,755,33,26,748,781,43,0.00801939574786,755,0.140805669526,272,0.0507273405446,5090,0.949272659455,4204,0.784035807535,19-09,Wake,3718319-09
Wake,8167,6779,0.830047753153,914,0.111913799437,27,0.00330598751071,157,0.0192237051549,150,0.0183665972817,140,0.017142157463,984,69,53,968,1037,70,0.00857107873148,984,0.120484878168,426,0.0521611362802,7741,0.94783886372,6536,0.800293865557,19-10,Wake,3718319-10
Wake,3782,3099,0.819407720783,424,0.112109994712,12,0.00317292437864,79,0.020888418826,70,0.018508725542,98,0.0259122157589,467,35,27,459,494,43,0.0113696456901,467,0.123479640402,231,0.0610787942887,3551,0.938921205711,2964,0.783712321523,19-11,Wake,3718319-11
Wake,6318,5081,0.804210193099,749,0.118550174106,27,0.0042735042735,159,0.0251661918329,148,0.0234251345362,154,0.0243748021526,815,57,45,803,860,66,0.0104463437797,815,0.128996517885,423,0.0669515669516,5895,0.933048433048,4851,0.767806267806,19-12,Wake,3718319-12
Wake,4286,2764,0.644890340644,1130,0.263649090061,38,0.00886607559496,102,0.0237984134391,157,0.0366308912739,95,0.0221651889874,1183,56,47,1174,1230,53,0.0123658422772,1183,0.276014932338,397,0.0926271581895,3889,0.907372841811,2562,0.597760149323,19-16,Wake,3718319-16
Wake,6541,3742,0.572083779239,2152,0.3290016817,32,0.00489221831524,190,0.0290475462468,221,0.0337868827396,204,0.0311878917597,2265,83,54,2236,2319,113,0.0172756459257,2265,0.346277327626,619,0.0946338480355,5922,0.905366151965,3426,0.523773123376,19-17,Wake,3718319-17
Wake,5451,3382,0.620436617134,1055,0.193542469272,24,0.00440286186021,302,0.0554026784076,565,0.103650706292,123,0.0225646670336,1099,50,44,1093,1143,44,0.00807191341038,1099,0.201614382682,936,0.171711612548,4515,0.828288387452,3091,0.567051917079,20-01,Wake,3718320-01
Wake,18163,11580,0.63755987447,1622,0.089302428013,51,0.0028079061829,4123,0.226999944943,248,0.0136541320266,539,0.0296757143644,1815,161,111,1765,1926,193,0.0106259979078,1815,0.0999284259208,871,0.0479546330452,17292,0.952045366955,11003,0.605791994715,20-02,Wake,3718320-02
Wake,3600,3198,0.888333333333,171,0.0475,8,0.00222222222222,76,0.0211111111111,57,0.0158333333333,90,0.025,201,31,28,198,229,30,0.00833333333333,201,0.0558333333333,162,0.045,3438,0.955,3101,0.861388888889,20-03,Wake,3718320-03
Wake,5650,4013,0.710265486726,194,0.0343362831858,6,0.00106194690265,1241,0.219646017699,39,0.00690265486726,157,0.0277876106195,231,33,29,227,260,37,0.00654867256637,231,0.0408849557522,231,0.0408849557522,5419,0.959115044248,3823,0.676637168142,20-04,Wake,3718320-04
Wake,4603,3937,0.855311753204,216,0.0469259178796,9,0.00195524657832,314,0.0682163806213,35,0.00760373669346,92,0.0199869650228,245,26,20,239,265,29,0.00630023897458,245,0.0532261568542,107,0.02324570932,4496,0.97675429068,3866,0.839887030198,20-05,Wake,3718320-05
Wake,10994,8695,0.790885937784,1051,0.0955975986902,38,0.00345643078043,534,0.0485719483355,429,0.0390212843369,247,0.0224668000728,1152,103,75,1124,1227,101,0.00918682917955,1152,0.10478442787,890,0.0809532472258,10104,0.919046752774,8305,0.755412042933,20-06,Wake,3718320-06
Wake,6757,5169,0.764984460559,466,0.0689655172414,15,0.00221992008288,824,0.121947609886,103,0.0152434512358,180,0.0266390409945,525,47,31,509,556,59,0.00873168565932,525,0.0776972029007,398,0.0589018795323,6359,0.941098120468,4918,0.727837797839,20-08,Wake,3718320-08
Wake,3341,2973,0.889853337324,146,0.0436994911703,8,0.00239449266687,147,0.0439988027537,17,0.00508829691709,50,0.0149655791679,163,20,13,156,176,17,0.00508829691709,163,0.0487877880874,108,0.0323256510027,3233,0.967674348997,2886,0.863813229572,20-09,Wake,3718320-09
Wake,5097,3769,0.739454581126,143,0.0280557190504,13,0.00255051991367,1048,0.20561114381,23,0.00451245830881,101,0.0198155777909,155,45,38,148,193,12,0.00235432607416,155,0.0304100451246,193,0.0378654110261,4904,0.962134588974,3597,0.70570924073,20-10,Wake,3718320-10
Wake,5407,4508,0.833734048456,311,0.0575180321805,13,0.00240429073423,319,0.0589975957093,83,0.0153504716109,173,0.0319955613094,369,49,31,351,400,58,0.0107268355835,369,0.068244867764,268,0.0495653782134,5139,0.950434621787,4347,0.803957832439,20-11,Wake,3718320-11
Wake,3831,3089,0.806316888541,161,0.0420255807883,5,0.00130514226051,442,0.115374575829,55,0.0143565648656,79,0.020621247716,181,29,21,173,202,20,0.00522056904203,181,0.0472461498303,193,0.0503784912555,3638,0.949621508744,2962,0.773166275124,20-12,Wake,3718320-12
Warren,1352,903,0.667899408284,406,0.300295857988,12,0.00887573964497,6,0.00443786982249,7,0.0051775147929,18,0.0133136094675,418,28,18,408,436,12,0.00887573964497,418,0.309171597633,12,0.00887573964497,1340,0.991124260355,899,0.664940828402,1,Warren,371851
Warren,2542,693,0.272619984264,1738,0.68371361133,15,0.00590086546027,8,0.00314712824548,35,0.013768686074,53,0.0208497246263,1781,44,21,1758,1802,43,0.0169158143194,1781,0.700629425649,70,0.0275373721479,2472,0.972462627852,682,0.268292682927,10,Warren,3718510
Warren,517,137,0.26499032882,356,0.688588007737,18,0.0348162475822,2,0.00386847195358,2,0.00386847195358,2,0.00386847195358,358,20,18,356,376,2,0.00386847195358,358,0.692456479691,7,0.0135396518375,510,0.986460348162,131,0.253384912959,11,Warren,3718511
Warren,1214,1061,0.873970345964,122,0.100494233937,9,0.00741350906096,7,0.00576606260297,4,0.00329489291598,11,0.00906095551895,124,17,16,123,140,2,0.00164744645799,124,0.102141680395,8,0.00658978583196,1206,0.993410214168,1059,0.872322899506,12,Warren,3718512
Warren,1118,542,0.484794275492,505,0.451699463327,2,0.00178890876565,4,0.00357781753131,42,0.0375670840787,23,0.020572450805,518,7,6,517,524,13,0.0116279069767,518,0.463327370304,70,0.0626118067979,1048,0.937388193202,515,0.460644007156,13,Warren,3718513
Warren,2234,663,0.296777081468,1406,0.629364368845,34,0.0152193375112,2,0.000895255147717,102,0.0456580125336,27,0.0120859444942,1422,51,40,1411,1462,16,0.00716204118174,1422,0.636526410027,148,0.0662488809311,2086,0.933751119069,632,0.282900626679,14,Warren,3718514
Warren,1061,736,0.693685202639,294,0.277097078228,3,0.00282752120641,3,0.00282752120641,10,0.00942507068803,15,0.014137606032,303,11,8,300,311,9,0.00848256361923,303,0.285579641847,15,0.014137606032,1046,0.985862393968,730,0.688030160226,2,Warren,371852
Warren,1457,698,0.479066575154,703,0.482498284146,11,0.00754975978037,5,0.00343170899108,27,0.0185312285518,13,0.0089224433768,715,20,12,707,727,12,0.00823610157859,715,0.490734385724,43,0.0295126973233,1414,0.970487302677,684,0.469457789979,3,Warren,371853
Warren,1216,493,0.405427631579,673,0.553453947368,8,0.00657894736842,3,0.00246710526316,12,0.00986842105263,27,0.0222039473684,692,23,16,685,708,19,0.015625,692,0.569078947368,23,0.0189144736842,1193,0.981085526316,485,0.398848684211,4,Warren,371854
Warren,2538,689,0.271473601261,1759,0.693065405831,19,0.00748620961387,6,0.00236406619385,43,0.0169424743893,22,0.0086682427108,1769,28,25,1766,1794,10,0.00394011032309,1769,0.697005516154,79,0.0311268715524,2459,0.968873128448,666,0.262411347518,5,Warren,371855
Warren,1866,648,0.347266881029,1132,0.606645230439,14,0.0075026795284,1,0.0005359056806,40,0.021436227224,31,0.0166130760986,1158,34,18,1142,1176,26,0.0139335476956,1158,0.620578778135,60,0.032154340836,1806,0.967845659164,638,0.341907824223,6,Warren,371856
Warren,1358,404,0.297496318115,825,0.607511045655,20,0.0147275405007,3,0.00220913107511,82,0.060382916053,24,0.0176730486009,844,31,23,836,867,19,0.0139911634757,844,0.621502209131,103,0.0758468335788,1255,0.924153166421,395,0.29086892489,7,Warren,371857
Warren,1781,151,0.0847838293094,691,0.387984278495,862,0.483997754071,2,0.00112296462661,18,0.0101066816395,57,0.0320044918585,735,913,875,697,1610,44,0.0247052217855,735,0.412689500281,31,0.0174059517125,1750,0.982594048287,145,0.0814149354295,8,Warren,371858
Warren,718,310,0.431754874652,360,0.50139275766,23,0.0320334261838,2,0.00278551532033,4,0.00557103064067,19,0.0264623955432,377,37,24,364,401,17,0.0236768802228,377,0.525069637883,23,0.0320334261838,695,0.967966573816,310,0.431754874652,9,Warren,371859
Washington,2840,1100,0.387323943662,1631,0.574295774648,4,0.00140845070423,2,0.000704225352113,75,0.0264084507042,28,0.00985915492958,1643,15,15,1643,1658,12,0.00422535211268,1643,0.578521126761,105,0.0369718309859,2735,0.963028169014,1077,0.379225352113,LM,Washington,37187LM
Washington,2080,797,0.383173076923,1232,0.592307692308,1,0.000480769230769,20,0.00961538461538,15,0.00721153846154,15,0.00721153846154,1244,6,2,1240,1246,12,0.00576923076923,1244,0.598076923077,23,0.0110576923077,2057,0.988942307692,791,0.380288461538,P1,Washington,37187P1
Washington,1682,395,0.234839476813,1175,0.698573127229,8,0.00475624256837,3,0.00178359096314,81,0.0481569560048,20,0.0118906064209,1185,18,17,1184,1202,10,0.00594530321046,1185,0.70451843044,93,0.0552913198573,1589,0.944708680143,390,0.231866825208,P2,Washington,37187P2
Washington,3548,1882,0.530439684329,1593,0.448985343856,9,0.00253664036077,8,0.00225479143179,28,0.00789177001127,28,0.00789177001127,1611,25,16,1602,1627,18,0.00507328072153,1611,0.454058624577,55,0.0155016910936,3493,0.984498308906,1858,0.523675310034,P3,Washington,37187P3
Washington,1804,1125,0.623614190687,530,0.293791574279,1,0.000554323725055,6,0.00332594235033,108,0.059866962306,34,0.0188470066519,549,11,6,544,555,19,0.0105321507761,549,0.304323725055,148,0.0820399113082,1656,0.917960088692,1098,0.608647450111,SC,Washington,37187SC
Washington,1274,785,0.616169544741,426,0.334379905808,1,0.000784929356358,0,0.0,33,0.0259026687598,29,0.0227629513344,438,15,14,437,452,12,0.0094191522763,438,0.343799058085,42,0.032967032967,1232,0.967032967033,784,0.615384615385,SK,Washington,37187SK
Watauga,619,589,0.951534733441,5,0.00807754442649,1,0.0016155088853,3,0.0048465266559,6,0.00969305331179,15,0.0242326332795,10,7,4,7,14,5,0.00807754442649,10,0.016155088853,20,0.032310177706,599,0.967689822294,576,0.930533117932,01,Watauga,3718901
Watauga,1351,1325,0.980754996299,4,0.00296076980015,2,0.00148038490007,0,0.0,12,0.00888230940044,8,0.0059215396003,4,9,9,4,13,0,0.0,4,0.00296076980015,18,0.0133234641007,1333,0.986676535899,1320,0.977054034049,02,Watauga,3718902
Watauga,2715,2620,0.965009208103,9,0.00331491712707,6,0.00220994475138,12,0.00441988950276,12,0.00441988950276,56,0.0206261510129,19,40,40,19,59,10,0.0036832412523,19,0.00699815837937,52,0.019152854512,2663,0.980847145488,2590,0.953959484346,03,Watauga,3718903
Watauga,4211,4069,0.966278793636,39,0.00926145808597,14,0.00332462597958,35,0.00831156494894,17,0.00403704583234,37,0.00878651151745,44,28,28,44,72,5,0.00118736642128,44,0.0104488245072,83,0.0197102825932,4128,0.980289717407,4008,0.951792923296,04,Watauga,3718904
Watauga,2069,1866,0.901884968584,100,0.0483325277912,11,0.00531657805703,24,0.0115998066699,14,0.00676655389077,54,0.0260995650072,114,38,36,112,150,14,0.00676655389077,114,0.055099081682,44,0.0212663122281,2025,0.978733687772,1842,0.890285161914,05,Watauga,3718905
Watauga,3398,3165,0.93143025309,112,0.0329605650383,5,0.00147145379635,39,0.0114773396115,27,0.00794585050029,50,0.0147145379635,130,17,12,125,142,18,0.00529723366686,130,0.0382577987051,109,0.0320776927604,3289,0.96792230724,3096,0.9111241907,06,Watauga,3718906
Watauga,4935,4683,0.948936170213,88,0.0178318135765,12,0.00243161094225,34,0.00688956433637,62,0.0125633232016,56,0.0113475177305,106,33,33,106,139,18,0.00364741641337,106,0.0214792299899,152,0.0308004052685,4783,0.969199594732,4601,0.932320162107,07,Watauga,3718907
Watauga,3118,3043,0.975946119307,9,0.00288646568313,4,0.00128287363695,10,0.00320718409237,22,0.00705580500321,30,0.0096215522771,14,18,16,12,30,5,0.00160359204618,14,0.00449005772931,63,0.0202052597819,3055,0.979794740218,3006,0.964079538165,08,Watauga,3718908
Watauga,638,621,0.973354231975,8,0.012539184953,0,0.0,2,0.00313479623824,2,0.00313479623824,5,0.00783699059561,8,3,3,8,11,0,0.0,8,0.012539184953,7,0.0109717868339,631,0.989028213166,616,0.965517241379,09,Watauga,3718909
Watauga,1640,1579,0.962804878049,7,0.00426829268293,2,0.00121951219512,7,0.00426829268293,14,0.00853658536585,31,0.0189024390244,12,23,22,11,34,5,0.0030487804878,12,0.00731707317073,35,0.0213414634146,1605,0.978658536585,1564,0.953658536585,10,Watauga,3718910
Watauga,3191,3087,0.967408335945,28,0.00877467878408,11,0.0034471952366,17,0.00532748354748,19,0.00595424631777,29,0.00908806016923,32,33,32,31,64,4,0.00125352554058,32,0.0100282043247,64,0.0200564086493,3127,0.979943591351,3038,0.952052648073,11,Watauga,3718911
Watauga,3912,3545,0.90618609407,165,0.0421779141104,5,0.00127811860941,80,0.0204498977505,23,0.00587934560327,94,0.0240286298569,202,38,33,197,235,37,0.00945807770961,202,0.05163599182,116,0.0296523517382,3796,0.970347648262,3463,0.885224948875,12,Watauga,3718912
Watauga,3253,3000,0.922225637873,82,0.0252075007685,12,0.00368890255149,55,0.0169074700277,59,0.0181371042115,45,0.0138333845681,95,31,30,94,125,13,0.00399631109745,95,0.029203811866,148,0.0454964648017,3105,0.954503535198,2921,0.897940362742,13,Watauga,3718913
Watauga,3731,3518,0.942910747789,60,0.0160814794961,12,0.00321629589922,58,0.0155454301796,40,0.0107209863307,43,0.0115250603055,72,27,26,71,98,12,0.00321629589922,72,0.0192977753953,127,0.0340391316001,3604,0.9659608684,3438,0.921468775127,14,Watauga,3718914
Watauga,4854,4427,0.91203131438,100,0.020601565719,11,0.00226617222909,89,0.0183353934899,145,0.0298722702925,82,0.0168932838896,129,31,29,127,158,29,0.00597445405851,129,0.0265760197775,391,0.0805521219613,4463,0.919447878039,4205,0.866295838484,15,Watauga,3718915
Watauga,229,223,0.973799126638,2,0.00873362445415,0,0.0,0,0.0,0,0.0,4,0.0174672489083,3,3,3,3,6,1,0.00436681222707,3,0.0131004366812,1,0.00436681222707,228,0.995633187773,222,0.96943231441,16,Watauga,3718916
Watauga,765,749,0.97908496732,6,0.0078431372549,1,0.00130718954248,2,0.00261437908497,1,0.00130718954248,6,0.0078431372549,6,4,4,6,10,0,0.0,6,0.0078431372549,8,0.0104575163399,757,0.98954248366,744,0.972549019608,17,Watauga,3718917
Watauga,2585,2412,0.933075435203,29,0.0112185686654,10,0.00386847195358,10,0.00386847195358,95,0.036750483559,29,0.0112185686654,40,22,22,40,62,11,0.00425531914894,40,0.0154738878143,125,0.0483558994197,2460,0.95164410058,2388,0.923791102515,18,Watauga,3718918
Watauga,3558,3451,0.969926925239,21,0.00590219224283,7,0.00196739741428,11,0.00309162450815,26,0.00730747611017,42,0.0118043844857,29,30,30,29,59,8,0.00224845418775,29,0.00815064643058,140,0.0393479482856,3418,0.960652051714,3339,0.93844856661,19,Watauga,3718919
Watauga,307,300,0.977198697068,3,0.00977198697068,3,0.00977198697068,0,0.0,1,0.00325732899023,0,0.0,3,3,3,3,6,0,0.0,3,0.00977198697068,10,0.0325732899023,297,0.967426710098,291,0.947882736156,20,Watauga,3718920
Wayne,3905,2845,0.728553137004,822,0.210499359795,12,0.00307298335467,9,0.00230473751601,119,0.0304737516005,98,0.0250960307298,873,54,37,856,910,51,0.0130601792574,873,0.223559539052,206,0.0527528809219,3699,0.947247119078,2781,0.712163892446,01,Wayne,3719101
Wayne,5227,4025,0.770040176009,896,0.171417639181,30,0.0057394298833,31,0.00593074421274,144,0.0275492634398,101,0.0193227472738,957,49,38,946,995,61,0.011670174096,957,0.183087813277,353,0.0675339582935,4874,0.932466041707,3844,0.73541228238,02,Wayne,3719102
Wayne,5048,4050,0.802297939778,517,0.102416798732,10,0.00198098256735,32,0.00633914421553,314,0.0622028526149,125,0.0247622820919,572,33,26,565,598,55,0.0108954041204,572,0.113312202853,444,0.0879556259905,4604,0.91204437401,3944,0.781299524564,03,Wayne,3719103
Wayne,6241,5003,0.801634353469,865,0.1385995834,21,0.00336484537734,67,0.010735459061,130,0.0208299951931,155,0.0248357634994,939,50,39,928,978,74,0.0118570741868,939,0.150456657587,262,0.0419804518507,5979,0.958019548149,4905,0.785931741708,04,Wayne,3719104
Wayne,4828,3897,0.807166528583,661,0.136909693455,9,0.00186412593206,105,0.0217481358741,58,0.0120132560066,98,0.0202982601491,699,28,26,697,725,38,0.00787075393538,699,0.14478044739,117,0.0242336371168,4711,0.975766362883,3857,0.798881524441,05,Wayne,3719105
Wayne,3700,2344,0.633513513514,1062,0.287027027027,7,0.00189189189189,75,0.0202702702703,121,0.0327027027027,91,0.0245945945946,1106,22,16,1100,1122,44,0.0118918918919,1106,0.298918918919,191,0.0516216216216,3509,0.948378378378,2294,0.62,06,Wayne,3719106
Wayne,6599,4689,0.710562206395,1425,0.215941809365,30,0.00454614335505,89,0.0134868919533,190,0.0287922412487,176,0.026670707683,1521,83,57,1495,1578,96,0.0145476587362,1521,0.230489468101,348,0.0527352629186,6251,0.947264737081,4556,0.690407637521,07,Wayne,3719107
Wayne,4844,3834,0.791494632535,648,0.13377374071,28,0.00578034682081,38,0.00784475639967,190,0.0392237819983,106,0.0218827415359,697,55,50,692,747,49,0.0101156069364,697,0.143889347647,305,0.0629644921552,4539,0.937035507845,3746,0.773327828241,08,Wayne,3719108
Wayne,5273,3667,0.695429546748,1253,0.237625640053,41,0.00777545989001,80,0.0151716290537,162,0.0307225488337,70,0.013275175422,1285,60,46,1271,1331,32,0.00606865162147,1285,0.243694291675,234,0.044377014982,5039,0.955622985018,3604,0.683481888868,09,Wayne,3719109
Wayne,2823,617,0.218561813673,2099,0.743535246192,11,0.00389656393907,7,0.00247963159759,44,0.0155862557563,45,0.0159404888417,2139,29,14,2124,2153,40,0.0141693234148,2139,0.757704569607,100,0.035423308537,2723,0.964576691463,581,0.2058094226,10,Wayne,3719110
Wayne,3604,1710,0.474472807991,1659,0.460321864595,18,0.00499445061043,86,0.0238623751387,60,0.0166481687014,71,0.0197003329634,1706,44,25,1687,1731,47,0.0130410654828,1706,0.473362930078,152,0.0421753607103,3452,0.95782463929,1652,0.458379578246,11,Wayne,3719111
Wayne,5110,2778,0.543639921722,1857,0.363405088063,7,0.0013698630137,208,0.0407045009785,89,0.0174168297456,171,0.0334637964775,1954,43,22,1933,1976,97,0.0189823874755,1954,0.382387475538,260,0.0508806262231,4850,0.949119373777,2652,0.518982387476,12,Wayne,3719112
Wayne,2947,1327,0.450288428911,1368,0.464200882253,11,0.00373260943332,65,0.0220563284696,107,0.0363081099423,69,0.0234136409908,1407,23,22,1406,1429,39,0.0132337970818,1407,0.477434679335,196,0.0665083135392,2751,0.933491686461,1249,0.423820834747,13,Wayne,3719113
Wayne,3794,2984,0.786505007907,537,0.141539272536,12,0.00316288877174,54,0.0142329994729,155,0.0408539799684,52,0.0137058513442,555,18,16,553,571,18,0.00474433315762,555,0.146283605693,348,0.0917237743806,3446,0.908276225619,2797,0.737216657881,14,Wayne,3719114
Wayne,6457,3925,0.607867430695,1004,0.155490165712,24,0.00371689639151,52,0.00805327551495,1277,0.197769862165,175,0.0271023695214,1063,49,39,1053,1102,59,0.0091373702958,1063,0.164627536007,2005,0.310515719374,4452,0.689484280626,3315,0.513396314078,15,Wayne,3719115
Wayne,4226,2491,0.589446284903,1194,0.282536677709,7,0.00165641268339,53,0.0125414103171,374,0.0884997633696,107,0.0253194510175,1251,28,19,1242,1270,57,0.0134879318504,1251,0.29602460956,524,0.123994320871,3702,0.876005679129,2382,0.563653573119,16,Wayne,3719116
Wayne,3038,604,0.198815009875,2268,0.746543778802,10,0.00329163923634,24,0.00789993416722,63,0.0207373271889,69,0.0227123107307,2316,28,18,2306,2334,48,0.0157998683344,2316,0.762343647136,169,0.0556287030941,2869,0.944371296906,538,0.177090190915,17,Wayne,3719117
Wayne,2428,584,0.240527182867,1725,0.710461285008,13,0.00535420098847,17,0.00700164744646,31,0.0127677100494,58,0.0238879736409,1766,28,18,1756,1784,41,0.0168863261944,1766,0.727347611203,89,0.0366556836903,2339,0.96334431631,548,0.225700164745,18,Wayne,3719118
Wayne,2575,684,0.265631067961,1717,0.666796116505,10,0.00388349514563,24,0.00932038834951,34,0.0132038834951,106,0.0411650485437,1776,27,12,1761,1788,59,0.0229126213592,1776,0.689708737864,132,0.0512621359223,2443,0.948737864078,616,0.239223300971,19,Wayne,3719119
Wayne,2571,269,0.104628549203,2172,0.844807467911,4,0.00155581485803,5,0.00194476857254,42,0.0163360560093,79,0.0307273434461,2232,15,5,2222,2237,60,0.0233372228705,2232,0.868144690782,78,0.0303383897316,2493,0.969661610268,263,0.102294826916,20,Wayne,3719120
Wayne,2480,965,0.389112903226,1381,0.55685483871,8,0.00322580645161,35,0.0141129032258,39,0.0157258064516,52,0.0209677419355,1414,24,14,1404,1428,33,0.0133064516129,1414,0.570161290323,71,0.0286290322581,2409,0.971370967742,945,0.381048387097,21,Wayne,3719121
Wayne,2814,1587,0.563965884861,961,0.341506751955,12,0.00426439232409,116,0.0412224591329,52,0.0184790334044,86,0.0305614783227,1007,34,17,990,1024,46,0.0163468372424,1007,0.357853589197,150,0.0533049040512,2664,0.946695095949,1513,0.537668798863,22,Wayne,3719122
Wayne,3701,2354,0.636044312348,906,0.244798703053,13,0.00351256417185,80,0.021615779519,217,0.0586328019454,131,0.0353958389624,971,34,23,960,994,65,0.0175628208592,971,0.262361523912,421,0.113753039719,3280,0.886246960281,2189,0.59146176709,23,Wayne,3719123
Wayne,4264,3827,0.897514071295,202,0.047373358349,11,0.00257973733583,4,0.00093808630394,172,0.0403377110694,48,0.0112570356473,217,34,31,214,248,15,0.00351782363977,217,0.0508911819887,311,0.0729362101313,3953,0.927063789869,3694,0.866322701689,24,Wayne,3719124
Wayne,3442,2429,0.705694363742,829,0.240848343986,18,0.00522951772225,17,0.00493898895991,103,0.0299244625218,46,0.013364323068,858,27,22,853,880,29,0.00842533410808,858,0.249273678094,228,0.0662405578152,3214,0.933759442185,2328,0.676350958745,25,Wayne,3719125
Wayne,4465,1970,0.441209406495,1685,0.377379619261,16,0.00358342665174,35,0.00783874580067,653,0.146248600224,106,0.0237402015677,1737,49,29,1717,1766,52,0.0116461366181,1737,0.389025755879,983,0.220156774916,3482,0.779843225084,1712,0.383426651736,26,Wayne,3719126
Wayne,3075,947,0.307967479675,1678,0.545691056911,11,0.00357723577236,18,0.00585365853659,374,0.12162601626,47,0.0152845528455,1703,14,13,1702,1716,25,0.00813008130081,1703,0.553821138211,492,0.16,2583,0.84,847,0.275447154472,27,Wayne,3719127
Wayne,7582,3916,0.516486415194,1779,0.234634661039,51,0.0067264573991,37,0.00487997889739,1591,0.209839092588,208,0.0274333948826,1835,90,82,1827,1917,56,0.00738591400686,1835,0.242020575046,2566,0.3384331311,5016,0.6615668689,3138,0.413874967027,28,Wayne,3719128
Wayne,2823,1175,0.41622387531,1547,0.547998583068,2,0.00070846617074,21,0.00743889479277,36,0.0127523910733,42,0.0148777895855,1576,8,3,1571,1579,29,0.0102727594757,1576,0.558271342543,86,0.0304640453418,2737,0.969535954658,1142,0.404534183493,29,Wayne,3719129
Wayne,2739,638,0.232931726908,1782,0.650602409639,24,0.00876232201533,11,0.00401606425703,248,0.0905439941585,36,0.013143483023,1800,38,32,1794,1832,18,0.0065717415115,1800,0.65717415115,341,0.124497991968,2398,0.875502008032,584,0.213216502373,30,Wayne,3719130
Wilkes,1103,1000,0.90661831369,66,0.0598368087035,2,0.00181323662738,4,0.00362647325476,19,0.0172257479601,12,0.0108794197643,75,4,4,75,79,9,0.00815956482321,75,0.0679963735267,30,0.0271985494107,1073,0.972801450589,990,0.897552130553,101,Wilkes,37193101
Wilkes,2286,1971,0.862204724409,242,0.105861767279,2,0.00087489063867,5,0.00218722659668,38,0.0166229221347,28,0.0122484689414,253,19,14,248,267,11,0.00481189851269,253,0.110673665792,56,0.0244969378828,2230,0.975503062117,1956,0.855643044619,102,Wilkes,37193102
Wilkes,551,541,0.981851179673,2,0.00362976406534,0,0.0,0,0.0,1,0.00181488203267,7,0.0127041742287,6,2,2,6,8,4,0.00725952813067,6,0.010889292196,4,0.00725952813067,547,0.992740471869,539,0.978221415608,103,Wilkes,37193103
Wilkes,2697,2417,0.896180941787,61,0.0226177233964,5,0.0018539117538,21,0.00778642936596,154,0.0571004820171,39,0.0144605116796,87,12,9,84,96,26,0.00964034111976,87,0.0322580645161,249,0.0923248053393,2448,0.907675194661,2335,0.865776789025,104,Wilkes,37193104
Wilkes,1808,1683,0.930862831858,52,0.0287610619469,2,0.00110619469027,4,0.00221238938053,34,0.0188053097345,33,0.0182522123894,66,12,6,60,72,14,0.00774336283186,66,0.0365044247788,73,0.0403761061947,1735,0.959623893805,1658,0.91703539823,105,Wilkes,37193105
Wilkes,1511,1378,0.911978821972,90,0.0595632031767,0,0.0,3,0.00198544010589,26,0.0172071475844,14,0.00926538716082,95,7,7,95,102,5,0.00330906684315,95,0.0628722700199,44,0.0291197882197,1467,0.97088021178,1361,0.900727994705,106,Wilkes,37193106
Wilkes,4005,3855,0.962546816479,37,0.00923845193508,8,0.0019975031211,7,0.00174781523096,71,0.0177278401998,27,0.00674157303371,46,14,13,45,59,9,0.00224719101124,46,0.0114856429463,126,0.0314606741573,3879,0.968539325843,3817,0.953058676654,107,Wilkes,37193107
Wilkes,2796,2227,0.796494992847,275,0.0983547925608,8,0.00286123032904,7,0.00250357653791,202,0.0722460658083,77,0.027539341917,309,21,16,304,325,34,0.0121602288984,309,0.110515021459,345,0.12339055794,2451,0.87660944206,2110,0.754649499285,108,Wilkes,37193108
Wilkes,1253,1160,0.925778132482,71,0.0566640063847,3,0.0023942537909,3,0.0023942537909,9,0.00718276137271,7,0.00558659217877,76,6,5,75,81,5,0.00399042298484,76,0.0606544293695,12,0.00957701516361,1241,0.990422984836,1157,0.923383878691,109,Wilkes,37193109
Wilkes,567,549,0.968253968254,8,0.0141093474427,0,0.0,1,0.00176366843034,0,0.0,9,0.015873015873,11,6,6,11,17,3,0.00529100529101,11,0.0194003527337,2,0.00352733686067,565,0.996472663139,547,0.964726631393,110,Wilkes,37193110
Wilkes,2843,2716,0.955328877946,20,0.00703482237074,3,0.00105522335561,11,0.0038691523039,53,0.0186422792824,40,0.0140696447415,36,8,8,36,44,16,0.00562785789659,36,0.0126626802673,113,0.0397467463947,2730,0.960253253605,2668,0.938445304256,111,Wilkes,37193111
Wilkes,3007,2600,0.864649151979,136,0.0452278017958,12,0.00399068839375,22,0.0073162620552,179,0.0595277685401,58,0.0192883272364,164,33,30,161,194,28,0.00931160625208,164,0.0545394080479,304,0.101097439308,2703,0.898902560692,2485,0.826405054872,112,Wilkes,37193112
Wilkes,2475,2417,0.976565656566,15,0.00606060606061,5,0.0020202020202,3,0.00121212121212,9,0.00363636363636,26,0.0105050505051,26,16,16,26,42,11,0.00444444444444,26,0.0105050505051,20,0.00808080808081,2455,0.991919191919,2409,0.973333333333,113,Wilkes,37193113
Wilkes,1023,1009,0.986314760508,2,0.0019550342131,2,0.0019550342131,0,0.0,0,0.0,10,0.00977517106549,8,7,6,7,14,6,0.0058651026393,8,0.00782013685239,12,0.0117302052786,1011,0.988269794721,1000,0.977517106549,114,Wilkes,37193114
Wilkes,5665,5478,0.966990291262,47,0.00829655781112,4,0.000706090026478,9,0.00158870255958,91,0.0160635481024,36,0.00635481023831,66,10,10,66,76,19,0.00335392762577,66,0.0116504854369,170,0.0300088261253,5495,0.969991173875,5400,0.953221535746,115A,Wilkes,37193115A
Wilkes,1740,1590,0.913793103448,79,0.0454022988506,1,0.000574712643678,9,0.0051724137931,39,0.0224137931034,22,0.0126436781609,89,3,3,89,92,10,0.00574712643678,89,0.0511494252874,72,0.0413793103448,1668,0.958620689655,1563,0.898275862069,117,Wilkes,37193117
Wilkes,4070,2936,0.721375921376,574,0.141031941032,17,0.0041769041769,25,0.00614250614251,426,0.104668304668,92,0.0226044226044,631,44,35,622,666,57,0.0140049140049,631,0.155036855037,551,0.135380835381,3519,0.864619164619,2824,0.693857493857,118,Wilkes,37193118
Wilkes,6420,6128,0.954517133956,46,0.00716510903427,10,0.00155763239875,24,0.00373831775701,153,0.0238317757009,59,0.00919003115265,71,31,31,71,102,25,0.00389408099688,71,0.0110591900312,242,0.0376947040498,6178,0.96230529595,6054,0.942990654206,119,Wilkes,37193119
Wilkes,2859,2734,0.956278419028,27,0.00944386149003,0,0.0,7,0.00244840853445,63,0.0220356768101,28,0.00979363413781,35,11,8,32,43,8,0.00279818118223,35,0.0122420426723,85,0.0297306750612,2774,0.970269324939,2719,0.951031829311,120,Wilkes,37193120
Wilkes,3187,2982,0.9356761845,68,0.0213366802636,14,0.00439284593662,4,0.00125509883903,89,0.0279259491685,30,0.00941324129275,85,21,21,85,106,17,0.00533417006589,85,0.0266708503295,145,0.045497332915,3042,0.954502667085,2930,0.919359899592,121,Wilkes,37193121
Wilkes,1077,1050,0.974930362117,8,0.00742804085422,3,0.00278551532033,0,0.0,4,0.00371402042711,12,0.0111420612813,10,6,6,10,16,2,0.00185701021356,10,0.00928505106778,17,0.0157845868152,1060,0.984215413185,1040,0.965645311049,122,Wilkes,37193122
Wilkes,1351,1297,0.960029607698,24,0.0177646188009,2,0.00148038490007,9,0.00666173205033,9,0.00666173205033,10,0.00740192450037,27,7,7,27,34,3,0.00222057735011,27,0.019985196151,36,0.0266469282013,1315,0.973353071799,1275,0.943745373797,123,Wilkes,37193123
Wilkes,2034,1975,0.970993117011,16,0.007866273353,4,0.00196656833825,2,0.000983284169125,15,0.00737463126844,22,0.0108161258604,23,14,13,22,36,7,0.00344149459194,23,0.0113077679449,55,0.0270403146509,1979,0.972959685349,1939,0.953294001967,124,Wilkes,37193124
Wilkes,1259,1240,0.984908657665,2,0.00158856235107,0,0.0,1,0.000794281175536,7,0.00555996822875,9,0.00714853057983,4,1,1,4,5,2,0.00158856235107,4,0.00317712470214,23,0.0182684670373,1236,0.981731532963,1226,0.973788721207,125,Wilkes,37193125
Wilkes,1223,1183,0.967293540474,2,0.00163532297629,9,0.0073589533933,0,0.0,18,0.0147179067866,11,0.00899427636958,4,17,17,4,21,2,0.00163532297629,4,0.00327064595258,25,0.0204415372036,1198,0.979558462796,1180,0.96484055601,126,Wilkes,37193126
Wilkes,3397,2766,0.814247865764,309,0.0909626140712,6,0.0017662643509,102,0.0300264939653,136,0.040035325287,78,0.0229614365617,354,22,18,350,372,45,0.0132469826317,354,0.104209596703,247,0.0727112157786,3150,0.927288784221,2671,0.786282013541,127,Wilkes,37193127
Wilkes,4082,3394,0.831455169035,419,0.102645761881,4,0.000979911807937,21,0.00514453699167,183,0.0448309652131,61,0.014943655071,448,21,17,444,465,29,0.00710436060755,448,0.109750122489,244,0.0597746202842,3838,0.940225379716,3344,0.819206271436,128,Wilkes,37193128
Wilkes,3051,2548,0.835136020977,132,0.0432645034415,7,0.00229432972796,12,0.0039331366765,284,0.0930842346772,68,0.0222877745002,161,18,17,160,178,29,0.00950508030154,161,0.052769583743,470,0.154047853163,2581,0.845952146837,2390,0.783349721403,129,Wilkes,37193129
Wilson,4087,3234,0.791289454368,544,0.133104966968,7,0.00171274773673,14,0.00342549547345,237,0.0579887448006,51,0.0124785906533,573,14,13,572,586,29,0.00709566919501,573,0.140200636163,327,0.0800097871299,3760,0.91999021287,3161,0.773427942256,PRBL,Wilson,37195PRBL
Wilson,3896,2658,0.682238193018,734,0.18839835729,18,0.00462012320329,5,0.00128336755647,396,0.101642710472,85,0.02181724846,757,45,43,755,800,23,0.00590349075975,757,0.194301848049,511,0.131160164271,3385,0.868839835729,2580,0.662217659138,PRCR,Wilson,37195PRCR
Wilson,3870,2041,0.527390180879,1409,0.364082687339,5,0.00129198966408,10,0.00258397932817,336,0.0868217054264,69,0.0178294573643,1443,27,17,1433,1460,34,0.00878552971576,1443,0.372868217054,563,0.145478036176,3307,0.854521963824,1830,0.472868217054,PRGA,Wilson,37195PRGA
Wilson,5379,3941,0.732664063952,786,0.146123814835,3,0.000557724484105,28,0.00520542851831,543,0.100948131623,78,0.0145008365867,814,13,13,814,827,28,0.00520542851831,814,0.151329243354,735,0.136642498606,4644,0.863357501394,3775,0.701803309165,PROL,Wilson,37195PROL
Wilson,1665,834,0.500900900901,712,0.427627627628,11,0.00660660660661,0,0.0,102,0.0612612612613,6,0.0036036036036,713,12,11,712,724,1,0.000600600600601,713,0.428228228228,152,0.0912912912913,1513,0.908708708709,805,0.483483483483,PRSA,Wilson,37195PRSA
Wilson,3131,2156,0.688597892047,663,0.211753433408,15,0.00479080166081,16,0.0051101884382,214,0.0683487703609,67,0.021398914085,698,36,27,689,725,35,0.0111785372086,698,0.222931970616,278,0.0887895241137,2853,0.911210475886,2110,0.673906100287,PRSP,Wilson,37195PRSP
Wilson,1968,1135,0.576727642276,729,0.370426829268,14,0.00711382113821,7,0.00355691056911,67,0.0340447154472,16,0.00813008130081,735,18,18,735,753,6,0.0030487804878,735,0.373475609756,161,0.0818089430894,1807,0.918191056911,1057,0.537093495935,PRST,Wilson,37195PRST
Wilson,9001,5650,0.627708032441,2575,0.286079324519,28,0.0031107654705,211,0.0234418397956,373,0.0414398400178,164,0.0182201977558,2669,34,29,2664,2698,94,0.0104432840795,2669,0.296522608599,590,0.0655482724142,8411,0.934451727586,5469,0.607599155649,PRTA,Wilson,37195PRTA
Wilson,5462,3117,0.570670084218,2144,0.392530208715,18,0.00329549615525,1,0.000183083119736,117,0.0214207250092,65,0.0119004027829,2182,42,30,2170,2212,38,0.00695715854998,2182,0.399487367265,193,0.0353350421091,5269,0.964664957891,3057,0.559685097034,PRTO,Wilson,37195PRTO
Wilson,2264,803,0.354681978799,1179,0.520759717314,9,0.00397526501767,9,0.00397526501767,226,0.0998233215548,38,0.0167844522968,1206,21,12,1197,1218,27,0.011925795053,1206,0.532685512367,359,0.158568904594,1905,0.841431095406,685,0.302561837456,PRWA,Wilson,37195PRWA
Wilson,2399,252,0.105043768237,1772,0.738641100459,11,0.0045852438516,3,0.00125052105044,316,0.131721550646,45,0.0187578157566,1795,25,16,1786,1811,23,0.00958732805336,1795,0.748228428512,469,0.195498124218,1930,0.804501875782,145,0.0604418507712,PRWB,Wilson,37195PRWB
Wilson,2563,422,0.164650799844,1851,0.722200546235,3,0.00117050331643,8,0.00312134217714,207,0.0807647288334,72,0.0280920795942,1903,25,9,1887,1912,52,0.0202887241514,1903,0.742489270386,348,0.135778384705,2215,0.864221615295,316,0.123293015997,PRWC,Wilson,37195PRWC
Wilson,2017,1686,0.835894893406,254,0.125929598413,4,0.0019831432821,10,0.00495785820526,31,0.0153693604363,32,0.0158651462568,270,8,7,269,277,16,0.00793257312841,270,0.133862171542,57,0.02825979177,1960,0.97174020823,1668,0.826970748637,PRWD,Wilson,37195PRWD
Wilson,2426,826,0.340478153339,1410,0.58120362737,8,0.00329760923331,19,0.0078318219291,140,0.0577081615829,23,0.00948062654575,1425,12,11,1424,1436,15,0.00618301731245,1425,0.587386644683,272,0.112118713932,2154,0.887881286068,716,0.295136026381,PRWE,Wilson,37195PRWE
Wilson,1748,110,0.0629290617849,1372,0.784897025172,4,0.00228832951945,7,0.00400457665904,235,0.134439359268,20,0.0114416475973,1381,11,5,1375,1386,9,0.00514874141876,1381,0.79004576659,310,0.177345537757,1438,0.822654462243,53,0.0303203661327,PRWH,Wilson,37195PRWH
Wilson,3094,1129,0.364899806076,1664,0.53781512605,3,0.000969618616677,20,0.00646412411118,230,0.0743374272786,48,0.0155138978668,1698,12,3,1689,1701,34,0.010989010989,1698,0.548804137039,377,0.121848739496,2717,0.878151260504,1012,0.327084680026,PRWI,Wilson,37195PRWI
Wilson,4863,2811,0.578038247995,1748,0.359448899856,14,0.00287888134896,102,0.020974706971,114,0.0234423195558,74,0.0152169442731,1789,31,26,1784,1815,41,0.00843100966482,1789,0.367879909521,197,0.0405099732675,4666,0.959490026732,2753,0.566111453835,PRWJ,Wilson,37195PRWJ
Wilson,1891,1530,0.809095716552,309,0.1634056055,3,0.00158646218932,18,0.00951877313591,19,0.0100475938657,12,0.00634584875727,315,9,5,311,320,6,0.00317292437864,315,0.166578529878,54,0.0285563194077,1837,0.971443680592,1503,0.794817556848,PRWK,Wilson,37195PRWK
Wilson,3372,2103,0.623665480427,1093,0.324139976275,10,0.00296559905101,54,0.0160142348754,55,0.0163107947805,57,0.0169039145907,1126,19,11,1118,1137,33,0.00978647686833,1126,0.333926453144,105,0.0311387900356,3267,0.968861209964,2073,0.614768683274,PRWL,Wilson,37195PRWL
Wilson,5479,3207,0.585325789378,1943,0.354626756707,16,0.00292024091988,115,0.0209892316116,95,0.0173389304618,103,0.0187990509217,2009,49,30,1990,2039,66,0.0120459937945,2009,0.366672750502,185,0.0337652856361,5294,0.966234714364,3133,0.571819675123,PRWM,Wilson,37195PRWM
Wilson,3781,257,0.067971436128,3164,0.836815657234,7,0.00185136207353,2,0.000528960592436,312,0.08251785242,39,0.0103147315525,3187,24,8,3171,3195,23,0.00608304681301,3187,0.842898704047,402,0.10632107908,3379,0.89367892092,191,0.0505157365776,PRWN,Wilson,37195PRWN
Wilson,2116,1637,0.773629489603,388,0.183364839319,8,0.00378071833648,26,0.0122873345936,23,0.0108695652174,34,0.0160680529301,405,13,9,401,414,17,0.00803402646503,405,0.191398865784,50,0.023629489603,2066,0.976370510397,1615,0.763232514178,PRWP,Wilson,37195PRWP
Wilson,999,10,0.01001001001,818,0.818818818819,2,0.002002002002,1,0.001001001001,161,0.161161161161,7,0.00700700700701,823,7,2,818,825,5,0.00500500500501,823,0.823823823824,168,0.168168168168,831,0.831831831832,5,0.00500500500501,PRWQ,Wilson,37195PRWQ
Wilson,3763,673,0.178846664895,2425,0.644432633537,17,0.00451767207016,7,0.00186021791124,573,0.152272123306,68,0.0180706882806,2471,38,26,2459,2497,46,0.012224289131,2471,0.656656922668,861,0.228806803083,2902,0.771193196917,445,0.118256710072,PRWR,Wilson,37195PRWR
Yadkin,4179,3707,0.887054319215,201,0.0480976310122,10,0.00239291696578,4,0.000957166786313,199,0.047619047619,58,0.0138789184015,235,17,16,234,251,34,0.00813591768366,235,0.0562335486959,294,0.070351758794,3885,0.929648241206,3635,0.869825317061,BNVL,Yadkin,37197BNVL
Yadkin,3326,2727,0.819903788334,43,0.0129284425737,8,0.00240529164161,2,0.000601322910403,489,0.147023451594,57,0.0171377029465,65,33,25,57,90,22,0.00661455201443,65,0.0195429945881,642,0.193024654239,2684,0.806975345761,2606,0.783523752255,DCRK,Yadkin,37197DCRK
Yadkin,3489,3207,0.919174548581,47,0.0134709085698,11,0.00315276583548,11,0.00315276583548,169,0.0484379478361,44,0.0126110633419,61,22,22,61,83,14,0.00401261106334,61,0.0174835196331,257,0.0736600745199,3232,0.92633992548,3130,0.897105187733,EBND,Yadkin,37197EBND
Yadkin,4032,3817,0.946676587302,68,0.0168650793651,6,0.0014880952381,11,0.00272817460317,94,0.0233134920635,36,0.00892857142857,76,17,16,75,92,8,0.00198412698413,76,0.0188492063492,172,0.0426587301587,3860,0.957341269841,3758,0.932043650794,FBSH,Yadkin,37197FBSH
Yadkin,2348,2032,0.865417376491,22,0.00936967632027,5,0.00212947189097,6,0.00255536626917,256,0.109028960818,27,0.0114991482112,36,7,7,36,43,14,0.00596252129472,36,0.015332197615,359,0.152896081772,1989,0.847103918228,1945,0.828364565588,NBCK,Yadkin,37197NBCK
Yadkin,1515,1478,0.975577557756,6,0.0039603960396,0,0.0,2,0.0013201320132,20,0.013201320132,9,0.00594059405941,8,5,5,8,13,2,0.0013201320132,8,0.00528052805281,46,0.0303630363036,1469,0.969636963696,1454,0.959735973597,NFAL,Yadkin,37197NFAL
Yadkin,4649,3949,0.849429984943,365,0.0785115078512,6,0.00129060012906,11,0.00236610023661,214,0.0460314046031,104,0.022370402237,432,33,27,426,459,67,0.0144117014412,432,0.0929232092923,372,0.0800172080017,4277,0.919982791998,3823,0.822327382233,NKNB,Yadkin,37197NKNB
Yadkin,6013,4903,0.815399966739,292,0.0485614501913,11,0.00182936969899,18,0.00299351405289,730,0.121403625478,59,0.00981207384001,317,28,22,311,339,25,0.00415765840679,317,0.052719108598,1022,0.169965075669,4991,0.830034924331,4648,0.77299185099,NLIB,Yadkin,37197NLIB
Yadkin,1368,1243,0.908625730994,19,0.0138888888889,3,0.00219298245614,4,0.00292397660819,91,0.0665204678363,8,0.00584795321637,20,6,6,20,26,1,0.000730994152047,20,0.0146198830409,110,0.0804093567251,1258,0.919590643275,1226,0.896198830409,SBCK,Yadkin,37197SBCK
Yadkin,2551,2411,0.945119560956,46,0.0180321442572,4,0.0015680125441,3,0.00117600940808,69,0.0270482163857,18,0.00705605644845,51,7,7,51,58,5,0.00196001568013,51,0.0199921599373,133,0.0521364170913,2418,0.947863582909,2352,0.921991375931,SFAL,Yadkin,37197SFAL
Yadkin,1804,1719,0.95288248337,13,0.00720620842572,0,0.0,1,0.000554323725055,54,0.029933481153,17,0.00942350332594,19,5,5,19,24,6,0.00332594235033,19,0.0105321507761,93,0.0515521064302,1711,0.94844789357,1686,0.934589800443,SKNB,Yadkin,37197SKNB
Yadkin,3132,2814,0.89846743295,70,0.022349936143,15,0.00478927203065,17,0.00542784163474,175,0.0558748403576,41,0.0130906768838,78,36,36,78,114,8,0.00255427841635,78,0.0249042145594,249,0.0795019157088,2883,0.920498084291,2759,0.880906768838,SLIB,Yadkin,37197SLIB
Yancey,4409,3966,0.89952370152,87,0.0197323656158,43,0.0097527784078,9,0.00204127920163,244,0.0553413472443,60,0.0136085280109,112,72,68,108,180,25,0.00567022000454,112,0.0254025856203,431,0.0977545928782,3978,0.902245407122,3830,0.868677704695,01-BUR,Yancey,3719901-BUR
Yancey,1880,1828,0.972340425532,4,0.00212765957447,7,0.00372340425532,4,0.00212765957447,23,0.0122340425532,14,0.00744680851064,7,16,16,7,23,3,0.00159574468085,7,0.00372340425532,43,0.0228723404255,1837,0.977127659574,1811,0.96329787234,02-CAN,Yancey,3719902-CAN
Yancey,585,567,0.969230769231,0,0.0,8,0.0136752136752,1,0.0017094017094,1,0.0017094017094,8,0.0136752136752,0,15,15,0,15,0,0.0,0,0.0,2,0.0034188034188,583,0.996581196581,565,0.965811965812,03-EGY,Yancey,3719903-EGY
Yancey,443,436,0.984198645598,1,0.00225733634312,2,0.00451467268623,0,0.0,0,0.0,4,0.00902934537246,3,6,4,1,7,2,0.00451467268623,3,0.00677200902935,1,0.00225733634312,442,0.997742663657,435,0.981941309255,04-RAM,Yancey,3719904-RAM
Yancey,600,580,0.966666666667,1,0.00166666666667,2,0.00333333333333,2,0.00333333333333,9,0.015,6,0.01,2,7,6,1,8,1,0.00166666666667,2,0.00333333333333,13,0.0216666666667,587,0.978333333333,578,0.963333333333,05-GRE,Yancey,3719905-GRE
Yancey,1686,1629,0.966192170819,12,0.00711743772242,4,0.00237247924081,4,0.00237247924081,29,0.0172004744958,8,0.00474495848161,15,6,6,15,21,3,0.0017793594306,15,0.00889679715302,48,0.0284697508897,1638,0.97153024911,1616,0.958481613286,06-JAC,Yancey,3719906-JAC
Yancey,523,515,0.984703632887,1,0.0019120458891,0,0.0,0,0.0,4,0.00764818355641,3,0.0057361376673,1,1,1,1,2,0,0.0,1,0.0019120458891,12,0.0229445506692,511,0.977055449331,509,0.973231357553,07-BRU,Yancey,3719907-BRU
Yancey,3359,3255,0.969038404287,12,0.00357249181304,6,0.00178624590652,12,0.00357249181304,58,0.017267043763,16,0.00476332241739,14,14,14,14,28,2,0.000595415302173,14,0.00416790711521,118,0.0351295028282,3241,0.964870497172,3197,0.951771360524,08-CRA,Yancey,3719908-CRA
Yancey,2344,2256,0.962457337884,15,0.00639931740614,4,0.00170648464164,4,0.00170648464164,36,0.0153583617747,29,0.0123720136519,22,16,15,21,37,7,0.00298634812287,22,0.00938566552901,74,0.0315699658703,2270,0.96843003413,2219,0.946672354949,09-SOU,Yancey,3719909-SOU
Yancey,625,601,0.9616,5,0.008,0,0.0,0,0.0,6,0.0096,13,0.0208,7,5,5,7,12,2,0.0032,7,0.0112,22,0.0352,603,0.9648,592,0.9472,10-PEN,Yancey,3719910-PEN
Yancey,1364,1334,0.978005865103,7,0.00513196480938,3,0.00219941348974,3,0.00219941348974,10,0.00733137829912,7,0.00513196480938,8,9,8,7,16,1,0.000733137829912,8,0.0058651026393,50,0.0366568914956,1314,0.963343108504,1300,0.953079178886,11-PRI,Yancey,3719911-PRI
