County,Total,White,% White ,Black,% Black,NA,%  NA,A/PI,%  A/PI ,Other,% Other,MR,%  MR,AP Black,AP    NA,AP NA NB,AP B NNA,AP B NA,MR Black,% MR   Black,Total Black,% Total Black,Hisp,%  Hisp ,Non  Hisp,% Non   Hisp,White Non Hisp,% White Non Hisp,excelVTDId,excelCountyName,GEOID10
Alamance,3686,3359,0.911285946826,257,0.0697232772653,8,0.00217037438958,9,0.00244167118828,33,0.00895279435703,20,0.00542593597396,262,19,17,260,279,5,0.00135648399349,262,0.0710797612588,79,0.0214324470971,3607,0.978567552903,3309,0.897721106891,01,Alamance,3700101
Alamance,3483,3343,0.959804766006,82,0.0235429227677,18,0.00516795865633,9,0.00258397932817,14,0.00401952339937,17,0.00488084984209,85,28,28,85,113,3,0.000861326442722,85,0.0244042492105,40,0.0114843525696,3443,0.98851564743,3321,0.953488372093,02,Alamance,3700102
Alamance,5660,5016,0.886219081272,429,0.0757950530035,19,0.00335689045936,63,0.0111307420495,68,0.0120141342756,65,0.0114840989399,450,32,28,446,478,21,0.00371024734982,450,0.0795053003534,166,0.0293286219081,5494,0.970671378092,4927,0.870494699647,035,Alamance,37001035
Alamance,2153,1909,0.886669763121,148,0.0687412912216,1,0.000464468183929,57,0.026474686484,20,0.00928936367859,18,0.00836042731073,158,9,5,154,163,10,0.00464468183929,158,0.0733859730608,44,0.0204366000929,2109,0.979563399907,1884,0.875058058523,03C,Alamance,3700103C
Alamance,4955,4437,0.89545913219,352,0.0710393541877,1,0.000201816347124,81,0.0163471241171,33,0.0066599394551,51,0.0102926337033,369,13,5,361,374,17,0.00343087790111,369,0.0744702320888,96,0.0193743693239,4859,0.980625630676,4378,0.883551967709,03N,Alamance,3700103N
Alamance,5580,4338,0.777419354839,734,0.131541218638,12,0.00215053763441,268,0.0480286738351,153,0.0274193548387,75,0.0134408602151,774,35,21,760,795,40,0.00716845878136,774,0.138709677419,260,0.0465949820789,5320,0.953405017921,4240,0.759856630824,03S,Alamance,3700103S
Alamance,2408,2117,0.87915282392,199,0.0826411960133,8,0.00332225913621,31,0.0128737541528,30,0.0124584717608,23,0.00955149501661,208,16,14,206,222,9,0.00373754152824,208,0.0863787375415,72,0.0299003322259,2336,0.970099667774,2080,0.863787375415,03W,Alamance,3700103W
Alamance,4194,3683,0.878159275155,422,0.100619933238,12,0.00286123032904,12,0.00286123032904,31,0.00739151168336,34,0.00810681926562,429,27,26,428,455,7,0.00166905102527,429,0.102288984263,88,0.0209823557463,4106,0.979017644254,3642,0.868383404864,04,Alamance,3700104
Alamance,2681,2486,0.927265945543,154,0.0574412532637,7,0.00261096605744,6,0.00223797090638,16,0.00596792241701,12,0.00447594181276,158,12,12,158,170,4,0.00149198060425,158,0.058933233868,48,0.017903767251,2633,0.982096232749,2455,0.91570309586,05,Alamance,3700105
Alamance,3498,1719,0.491423670669,1053,0.30102915952,30,0.00857632933105,37,0.0105774728416,594,0.169811320755,65,0.0185820468839,1076,49,41,1068,1117,23,0.00657518582047,1076,0.30760434534,940,0.268724985706,2558,0.731275014294,1449,0.41423670669,063,Alamance,37001063
Alamance,4345,3262,0.750747986191,483,0.111162255466,81,0.0186421173763,81,0.0186421173763,397,0.0913693901036,41,0.00943613348677,498,98,92,492,590,15,0.00345224395857,498,0.114614499425,626,0.144073647871,3719,0.855926352129,3126,0.719447640967,064,Alamance,37001064
Alamance,2371,1629,0.687051876845,580,0.244622522143,20,0.00843525938423,14,0.00590468156896,88,0.0371151412906,40,0.0168705187685,597,39,28,586,625,17,0.00716997047659,597,0.251792492619,196,0.0826655419654,2175,0.917334458035,1542,0.650358498524,06E,Alamance,3700106E
Alamance,3167,1625,0.513103883802,1034,0.326491948216,36,0.0113672245027,30,0.00947268708557,402,0.126934006947,40,0.0126302494474,1048,55,48,1041,1096,14,0.0044205873066,1048,0.330912535523,623,0.196716135144,2544,0.803283864856,1450,0.457846542469,06N,Alamance,3700106N
Alamance,3130,2456,0.784664536741,477,0.152396166134,23,0.0073482428115,67,0.0214057507987,69,0.0220447284345,38,0.0121405750799,492,39,32,485,524,15,0.00479233226837,492,0.157188498403,186,0.0594249201278,2944,0.940575079872,2368,0.756549520767,06S,Alamance,3700106S
Alamance,1505,956,0.635215946844,340,0.225913621262,18,0.0119601328904,32,0.0212624584718,131,0.0870431893688,28,0.0186046511628,352,27,25,350,377,12,0.00797342192691,352,0.233887043189,211,0.140199335548,1294,0.859800664452,899,0.597342192691,06W,Alamance,3700106W
Alamance,3307,3058,0.92470517085,149,0.0450559419413,18,0.00544299969761,15,0.00453583308134,48,0.0145146658603,19,0.0057453885697,157,27,25,155,182,8,0.00241911097672,157,0.0474750529181,104,0.0314484426973,3203,0.968551557303,3011,0.910492893862,07,Alamance,3700107
Alamance,3118,2655,0.851507376523,265,0.0849903784477,19,0.0060936497755,8,0.00256574727389,149,0.0477870429763,22,0.00705580500321,271,32,31,270,302,6,0.00192431045542,271,0.0869146889031,233,0.0747273893521,2885,0.925272610648,2590,0.830660679923,08N,Alamance,3700108N
Alamance,1694,1571,0.927390791027,70,0.0413223140496,10,0.00590318772137,3,0.00177095631641,16,0.00944510035419,24,0.0141676505313,78,27,23,74,101,8,0.0047225501771,78,0.0460448642267,52,0.0306965761511,1642,0.969303423849,1541,0.909681227863,08S,Alamance,3700108S
Alamance,1834,1453,0.79225736096,329,0.179389312977,4,0.00218102508179,8,0.00436205016358,19,0.0103598691385,21,0.0114503816794,340,15,12,337,352,11,0.00599781897492,340,0.185387131952,59,0.0321701199564,1775,0.967829880044,1414,0.770992366412,09N,Alamance,3700109N
Alamance,4661,3838,0.823428448831,533,0.114353143102,37,0.0079382106844,19,0.00407637845956,180,0.0386183222484,54,0.0115854966745,549,59,52,542,601,16,0.00343273975542,549,0.117785882858,386,0.0828148465994,4275,0.917185153401,3664,0.786097403991,09S,Alamance,3700109S
Alamance,3146,2579,0.819771137953,269,0.0855054036872,9,0.00286077558805,26,0.00826446280992,219,0.0696122059758,44,0.013986013986,288,23,16,281,304,19,0.00603941513032,288,0.0915448188175,335,0.106484424666,2811,0.893515575334,2486,0.79020979021,103,Alamance,37001103
Alamance,3292,2638,0.801336573512,509,0.154617253949,21,0.00637910085055,18,0.00546780072904,68,0.0206561360875,38,0.0115431348724,523,42,33,514,556,14,0.00425273390036,523,0.158869987849,137,0.0416160388821,3155,0.958383961118,2586,0.785540704739,10N,Alamance,3700110N
Alamance,5931,4327,0.729556567189,1320,0.222559433485,26,0.00438374641713,75,0.0126454223571,91,0.01534311246,92,0.0155117180914,1364,62,51,1353,1415,44,0.00741864778284,1364,0.229978081268,249,0.0419828022256,5682,0.958017197774,4202,0.708480863261,10S,Alamance,3700110S
Alamance,3476,1917,0.551495972382,1347,0.38751438435,46,0.0132336018412,4,0.00115074798619,117,0.0336593785961,45,0.0129459148446,1373,66,55,1362,1428,26,0.00747986191024,1373,0.39499424626,220,0.0632911392405,3256,0.936708860759,1836,0.528193325662,11,Alamance,3700111
Alamance,2127,1448,0.680771039022,497,0.233662435355,7,0.00329102021627,64,0.0300893276916,85,0.0399623883404,26,0.0122237893747,510,12,9,507,519,13,0.00611189468735,510,0.239774330042,145,0.0681711330512,1982,0.931828866949,1404,0.660084626234,1210,Alamance,370011210
Alamance,1948,1523,0.7818275154,278,0.142710472279,10,0.00513347022587,14,0.00718685831622,97,0.049794661191,26,0.0133470225873,284,24,24,284,308,6,0.00308008213552,284,0.145790554415,145,0.0744353182752,1803,0.925564681725,1481,0.760266940452,124,Alamance,37001124
Alamance,2197,1885,0.85798816568,209,0.0951297223487,6,0.00273099681384,34,0.0154756486117,49,0.0223031406463,14,0.00637232589895,213,15,14,212,227,4,0.00182066454256,213,0.0969503868912,125,0.0568957669549,2072,0.943104233045,1817,0.827036868457,125,Alamance,37001125
Alamance,1713,1622,0.946876824285,53,0.0309398715703,4,0.00233508464682,14,0.00817279626386,15,0.00875656742557,5,0.00291885580852,55,7,5,53,60,2,0.00116754232341,55,0.0321074138938,30,0.0175131348511,1683,0.982486865149,1609,0.939287799183,126,Alamance,37001126
Alamance,4922,2067,0.419951239334,2339,0.475213327915,26,0.00528240552621,52,0.0105648110524,339,0.068874441284,99,0.0201137748883,2386,65,43,2364,2429,47,0.00954896383584,2386,0.484762291751,736,0.14953271028,4186,0.85046728972,1739,0.353311661926,127,Alamance,37001127
Alamance,2757,1346,0.488211824447,958,0.347479143997,21,0.0076169749728,56,0.0203119332608,319,0.115705476968,57,0.0206746463547,986,46,34,974,1020,28,0.0101559666304,986,0.357635110627,480,0.174102285092,2277,0.825897714908,1223,0.443598113892,128,Alamance,37001128
Alamance,1630,1392,0.853987730061,143,0.0877300613497,5,0.00306748466258,50,0.0306748466258,33,0.020245398773,7,0.00429447852761,145,8,6,143,151,2,0.00122699386503,145,0.0889570552147,71,0.0435582822086,1559,0.956441717791,1359,0.833742331288,129,Alamance,37001129
Alamance,2503,1285,0.513383939273,719,0.287255293648,35,0.0139832201358,42,0.016779864163,368,0.147023571714,54,0.0215741110667,736,47,45,734,781,17,0.00679184978026,736,0.294047143428,622,0.248501797843,1881,0.751498202157,1085,0.433479824211,12E,Alamance,3700112E
Alamance,4530,1396,0.308167770419,2479,0.547240618102,27,0.00596026490066,32,0.00706401766004,507,0.111920529801,89,0.019646799117,2515,50,39,2504,2554,36,0.00794701986755,2515,0.555187637969,823,0.181677704194,3707,0.818322295806,1162,0.25651214128,12N,Alamance,3700112N
Alamance,1860,883,0.474731182796,607,0.326344086022,28,0.0150537634409,28,0.0150537634409,273,0.146774193548,41,0.0220430107527,623,52,41,612,664,16,0.00860215053763,623,0.334946236559,423,0.227419354839,1437,0.772580645161,758,0.40752688172,12S,Alamance,3700112S
Alamance,2156,1779,0.825139146568,245,0.113636363636,7,0.00324675324675,21,0.00974025974026,71,0.0329313543599,33,0.015306122449,258,20,13,251,271,13,0.00602968460111,258,0.119666048237,121,0.0561224489796,2035,0.94387755102,1740,0.807050092764,12W,Alamance,3700112W
Alamance,4070,2443,0.600245700246,1187,0.291646191646,33,0.00810810810811,22,0.00540540540541,345,0.0847665847666,40,0.00982800982801,1195,51,50,1194,1245,8,0.0019656019656,1195,0.293611793612,521,0.12800982801,3549,0.87199017199,2311,0.567813267813,13,Alamance,3700113
Alexander,2871,2791,0.972135144549,14,0.00487634970394,11,0.00383141762452,30,0.0104493207941,9,0.00313479623824,16,0.00557297109021,17,20,20,17,37,3,0.00104493207941,17,0.00592128178335,29,0.010101010101,2842,0.989898989899,2771,0.965168930686,B1,Alexander,37003B1
Alexander,3528,3416,0.968253968254,25,0.00708616780045,7,0.00198412698413,52,0.0147392290249,15,0.00425170068027,13,0.00368480725624,27,14,14,27,41,2,0.000566893424036,27,0.00765306122449,54,0.015306122449,3474,0.984693877551,3380,0.958049886621,B2,Alexander,37003B2
Alexander,2567,2413,0.940007791196,121,0.0471367354889,4,0.00155823918972,7,0.002726918582,9,0.00350603817686,13,0.00506427736658,124,12,12,124,136,3,0.00116867939229,124,0.0483054148812,26,0.0101285547332,2541,0.989871445267,2399,0.934553954032,E,Alexander,37003E
Alexander,769,754,0.980494148244,5,0.00650195058518,1,0.00130039011704,0,0.0,3,0.00390117035111,6,0.00780234070221,7,6,5,6,12,2,0.00260078023407,7,0.00910273081925,7,0.00910273081925,762,0.990897269181,751,0.976592977893,G1,Alexander,37003G1
Alexander,940,862,0.917021276596,39,0.0414893617021,4,0.00425531914894,3,0.0031914893617,26,0.0276595744681,6,0.0063829787234,39,9,9,39,48,0,0.0,39,0.0414893617021,35,0.0372340425532,905,0.962765957447,857,0.91170212766,G2,Alexander,37003G2
Alexander,1133,1078,0.95145631068,33,0.0291262135922,4,0.00353045013239,8,0.00706090026478,5,0.00441306266549,5,0.00441306266549,36,6,6,36,42,3,0.00264783759929,36,0.0317740511915,17,0.0150044130627,1116,0.984995586937,1066,0.940864960282,L,Alexander,37003L
Alexander,1973,1718,0.870755195134,138,0.0699442473391,7,0.00354789660416,35,0.0177394830208,55,0.0278763304612,20,0.0101368474404,140,12,11,139,151,2,0.00101368474404,140,0.0709579320831,102,0.0516979219463,1871,0.948302078054,1679,0.850988342625,M,Alexander,37003M
Alexander,2417,2202,0.911046752172,68,0.0281340504758,7,0.00289615225486,4,0.00165494414564,114,0.0471659081506,22,0.00910219280099,72,20,19,71,91,4,0.00165494414564,72,0.0297889946214,172,0.0711625982623,2245,0.928837401738,2153,0.890773686388,S1,Alexander,37003S1
Alexander,1019,913,0.895976447498,63,0.0618253189401,3,0.00294406280667,3,0.00294406280667,31,0.0304219823356,6,0.00588812561335,63,7,7,63,70,0,0.0,63,0.0618253189401,44,0.0431795878312,975,0.956820412169,904,0.887144259078,S2,Alexander,37003S2
Alexander,929,909,0.978471474704,1,0.0010764262648,3,0.0032292787944,2,0.0021528525296,11,0.0118406889128,3,0.0032292787944,1,6,6,1,7,0,0.0,1,0.0010764262648,17,0.0182992465016,912,0.981700753498,905,0.974165769645,SL,Alexander,37003SL
Alexander,2802,2094,0.747323340471,570,0.203426124197,24,0.00856531049251,35,0.0124910778016,64,0.02284082798,15,0.00535331905782,576,30,30,576,606,6,0.00214132762313,576,0.20556745182,108,0.0385438972163,2694,0.961456102784,2053,0.732690935046,T1,Alexander,37003T1
Alexander,1758,1375,0.782138794084,248,0.141069397042,7,0.00398179749716,12,0.00682593856655,80,0.0455062571104,36,0.0204778156997,257,31,28,254,285,9,0.00511945392491,257,0.146188850967,130,0.0739476678043,1628,0.926052332196,1331,0.757110352673,T2,Alexander,37003T2
Alexander,1384,1313,0.948699421965,49,0.0354046242775,1,0.000722543352601,7,0.00505780346821,3,0.0021676300578,11,0.00794797687861,51,10,10,51,61,2,0.0014450867052,51,0.0368497109827,23,0.0166184971098,1361,0.98338150289,1293,0.934248554913,T3,Alexander,37003T3
Alexander,1737,1436,0.826712723086,231,0.13298791019,0,0.0,22,0.0126655152562,33,0.0189982728843,15,0.00863557858377,239,9,5,235,244,8,0.00460564191134,239,0.137593552101,52,0.0299366724237,1685,0.970063327576,1418,0.816350028785,T4,Alexander,37003T4
Alexander,1092,978,0.895604395604,74,0.0677655677656,2,0.0018315018315,12,0.010989010989,23,0.0210622710623,3,0.00274725274725,75,3,3,75,78,1,0.000915750915751,75,0.0686813186813,46,0.0421245421245,1046,0.957875457875,956,0.875457875458,T5,Alexander,37003T5
Alexander,1826,1769,0.96878422782,10,0.00547645125958,5,0.00273822562979,19,0.0104052573932,15,0.00821467688938,8,0.00438116100767,14,7,7,14,21,4,0.00219058050383,14,0.00766703176342,34,0.0186199342826,1792,0.981380065717,1752,0.959474260679,W,Alexander,37003W
Alleghany,1214,1173,0.966227347611,4,0.00329489291598,1,0.000823723228995,6,0.00494233937397,22,0.0181219110379,8,0.00658978583196,4,6,6,4,10,0,0.0,4,0.00329489291598,32,0.0263591433278,1182,0.973640856672,1163,0.957990115321,01,Alleghany,3700501
Alleghany,325,295,0.907692307692,4,0.0123076923077,0,0.0,0,0.0,26,0.08,0,0.0,4,0,0,4,4,0,0.0,4,0.0123076923077,33,0.101538461538,292,0.898461538462,288,0.886153846154,02,Alleghany,3700502
Alleghany,3532,3192,0.903737259343,73,0.0206681766704,16,0.00453001132503,22,0.00622876557191,197,0.0557757644394,32,0.00906002265006,77,29,29,77,106,4,0.00113250283126,77,0.0218006795017,362,0.102491506229,3170,0.897508493771,3055,0.864949037373,03,Alleghany,3700503
Alleghany,1567,1461,0.932354818124,11,0.00701978302489,0,0.0,1,0.000638162093172,81,0.0516911295469,13,0.00829610721123,14,11,9,12,23,3,0.00191448627951,14,0.0089342693044,132,0.0842373962987,1435,0.915762603701,1413,0.901723037652,04,Alleghany,3700504
Alleghany,718,695,0.967966573816,5,0.00696378830084,3,0.0041782729805,6,0.008356545961,7,0.00974930362117,2,0.00278551532033,5,5,5,5,10,0,0.0,5,0.00696378830084,56,0.0779944289694,662,0.922005571031,647,0.901114206128,05,Alleghany,3700505
Alleghany,702,686,0.977207977208,0,0.0,1,0.0014245014245,2,0.002849002849,11,0.0156695156695,2,0.002849002849,0,2,2,0,2,0,0.0,0,0.0,25,0.0356125356125,677,0.964387464387,672,0.957264957265,06,Alleghany,3700506
Alleghany,862,840,0.974477958237,4,0.0046403712297,0,0.0,2,0.00232018561485,8,0.0092807424594,8,0.0092807424594,4,8,8,4,12,0,0.0,4,0.0046403712297,24,0.0278422273782,838,0.972157772622,824,0.955916473318,07,Alleghany,3700507
Anson,1289,739,0.573312645462,507,0.393328161365,4,0.00310318076028,24,0.0186190845617,9,0.00698215671063,6,0.00465477114042,510,6,6,510,516,3,0.00232738557021,510,0.395655546936,18,0.0139643134213,1271,0.986035686579,736,0.570985259891,ANS,Anson,37007ANS
Anson,1513,1233,0.814937210839,238,0.157303370787,7,0.00462656972902,13,0.00859220092531,10,0.00660938532716,12,0.0079312623926,241,17,15,239,256,3,0.00198281559815,241,0.159286186385,18,0.0118968935889,1495,0.988103106411,1226,0.81031064111,BURN,Anson,37007BURN
Anson,1224,520,0.424836601307,681,0.55637254902,3,0.00245098039216,1,0.000816993464052,12,0.00980392156863,7,0.00571895424837,683,8,7,682,690,2,0.0016339869281,683,0.558006535948,23,0.0187908496732,1201,0.981209150327,510,0.416666666667,GULL,Anson,37007GULL
Anson,2672,1239,0.46369760479,1374,0.514221556886,17,0.0063622754491,10,0.00374251497006,11,0.00411676646707,21,0.00785928143713,1381,32,29,1378,1410,7,0.00261976047904,1381,0.516841317365,25,0.00935628742515,2647,0.990643712575,1229,0.45995508982,LILE,Anson,37007LILE
Anson,1431,413,0.288609364081,937,0.654786862334,13,0.00908455625437,7,0.00489168413697,40,0.0279524807827,21,0.0146750524109,952,24,18,946,970,15,0.0104821802935,952,0.665269042628,59,0.0412299091544,1372,0.958770090846,407,0.284416491964,MM,Anson,37007MM
Anson,1595,1315,0.824451410658,217,0.13605015674,3,0.00188087774295,27,0.0169278996865,26,0.0163009404389,7,0.00438871473354,221,6,5,220,226,4,0.0025078369906,221,0.13855799373,41,0.0257053291536,1554,0.974294670846,1297,0.813166144201,PEAC,Anson,37007PEAC
Anson,1286,712,0.55365474339,531,0.412908242613,13,0.0101088646967,15,0.0116640746501,1,0.000777604976672,14,0.0108864696734,535,23,23,535,558,4,0.00311041990669,535,0.416018662519,8,0.00622083981337,1278,0.993779160187,709,0.55132192846,POLK,Anson,37007POLK
Anson,2623,820,0.312619138391,1730,0.659550133435,17,0.00648112847884,21,0.00800609988563,22,0.00838734273732,13,0.00495615707205,1741,23,18,1736,1759,11,0.00419367136866,1741,0.663743804804,30,0.0114372855509,2593,0.988562714449,817,0.311475409836,W1,Anson,37007W1
Anson,4109,1531,0.372596738866,2396,0.583110245802,50,0.0121684108055,38,0.00924799221222,72,0.01752251156,22,0.00535410075444,2412,62,56,2406,2468,16,0.00389389145778,2412,0.58700413726,279,0.067899732295,3830,0.932100267705,1325,0.322462886347,W2,Anson,37007W2
Anson,2887,1648,0.570834776585,1157,0.400762036716,7,0.00242466227918,39,0.0135088326983,11,0.00381018358157,25,0.00865950813994,1172,14,11,1169,1183,15,0.00519570488396,1172,0.4059577416,26,0.00900588846554,2861,0.990994111534,1645,0.569795635608,W3,Anson,37007W3
Anson,353,215,0.609065155807,117,0.331444759207,0,0.0,3,0.00849858356941,14,0.0396600566572,4,0.0113314447592,118,4,3,117,121,1,0.0028328611898,118,0.334277620397,31,0.0878186968839,322,0.912181303116,199,0.563739376771,WS,Anson,37007WS
Ashe,1439,1402,0.974287699792,5,0.00347463516331,4,0.00277970813065,3,0.00208478109798,14,0.00972897845726,11,0.00764419735928,6,13,12,5,18,1,0.000694927032662,6,0.00416956219597,31,0.0215427380125,1408,0.978457261987,1391,0.966643502432,02,Ashe,3700902
Ashe,487,467,0.958932238193,1,0.00205338809035,3,0.00616016427105,3,0.00616016427105,11,0.0225872689938,2,0.0041067761807,1,5,5,1,6,0,0.0,1,0.00205338809035,14,0.0287474332649,473,0.971252566735,465,0.954825462012,03,Ashe,3700903
Ashe,500,494,0.988,1,0.002,1,0.002,0,0.0,3,0.006,1,0.002,1,2,2,1,3,0,0.0,1,0.002,6,0.012,494,0.988,491,0.982,04,Ashe,3700904
Ashe,585,575,0.982905982906,2,0.0034188034188,1,0.0017094017094,1,0.0017094017094,2,0.0034188034188,4,0.00683760683761,2,5,5,2,7,0,0.0,2,0.0034188034188,6,0.0102564102564,579,0.989743589744,572,0.977777777778,06,Ashe,3700906
Ashe,535,526,0.983177570093,0,0.0,0,0.0,0,0.0,2,0.00373831775701,7,0.0130841121495,0,7,7,0,7,0,0.0,0,0.0,6,0.011214953271,529,0.988785046729,522,0.975700934579,07,Ashe,3700907
Ashe,252,247,0.980158730159,1,0.00396825396825,0,0.0,0,0.0,0,0.0,4,0.015873015873,1,4,4,1,5,0,0.0,1,0.00396825396825,0,0.0,252,1.0,247,0.980158730159,08,Ashe,3700908
Ashe,3827,3603,0.941468513196,42,0.0109746537758,4,0.00104520512151,23,0.00600992944865,129,0.0337078651685,26,0.00679383328978,47,22,19,44,66,5,0.00130650640188,47,0.0122811601777,182,0.0475568330285,3645,0.952443166972,3552,0.928142147897,09,Ashe,3700909
Ashe,332,325,0.978915662651,0,0.0,2,0.00602409638554,1,0.00301204819277,0,0.0,4,0.0120481927711,1,6,5,0,6,1,0.00301204819277,1,0.00301204819277,9,0.0271084337349,323,0.972891566265,316,0.951807228916,10,Ashe,3700910
Ashe,2129,2065,0.969938938469,15,0.00704556129638,4,0.0018788163457,2,0.000939408172851,34,0.0159699389385,9,0.00422733677783,19,8,8,19,27,4,0.0018788163457,19,0.00892437764209,105,0.0493189290747,2024,0.950681070925,1996,0.937529356505,11,Ashe,3700911
Ashe,710,698,0.983098591549,2,0.00281690140845,0,0.0,1,0.00140845070423,0,0.0,9,0.012676056338,3,8,8,3,11,1,0.00140845070423,3,0.00422535211268,14,0.0197183098592,696,0.980281690141,684,0.96338028169,12,Ashe,3700912
Ashe,1122,1096,0.976827094474,5,0.00445632798574,3,0.00267379679144,3,0.00267379679144,10,0.00891265597148,5,0.00445632798574,7,5,5,7,12,2,0.0017825311943,7,0.00623885918004,64,0.0570409982175,1058,0.942959001783,1044,0.930481283422,13,Ashe,3700913
Ashe,2172,2127,0.979281767956,2,0.000920810313076,4,0.00184162062615,6,0.00276243093923,17,0.00782688766114,16,0.0073664825046,7,16,12,3,19,5,0.00230202578269,7,0.00322283609576,48,0.0220994475138,2124,0.977900552486,2102,0.967771639042,14,Ashe,3700914
Ashe,930,900,0.967741935484,3,0.00322580645161,2,0.00215053763441,3,0.00322580645161,20,0.0215053763441,2,0.00215053763441,3,3,3,3,6,0,0.0,3,0.00322580645161,31,0.0333333333333,899,0.966666666667,889,0.955913978495,15,Ashe,3700915
Ashe,2094,2024,0.966571155683,11,0.00525310410697,3,0.00143266475645,10,0.00477554918816,28,0.0133715377268,18,0.00859598853868,14,16,15,13,29,3,0.00143266475645,14,0.00668576886342,84,0.0401146131805,2010,0.959885386819,1971,0.941260744986,16,Ashe,3700916
Ashe,985,959,0.973604060914,1,0.0010152284264,2,0.00203045685279,1,0.0010152284264,14,0.0142131979695,8,0.00812182741117,3,7,7,3,10,2,0.00203045685279,3,0.00304568527919,18,0.0182741116751,967,0.981725888325,958,0.972588832487,17,Ashe,3700917
Ashe,200,193,0.965,1,0.005,1,0.005,0,0.0,0,0.0,5,0.025,1,6,6,1,7,0,0.0,1,0.005,2,0.01,198,0.99,191,0.955,18,Ashe,3700918
Ashe,3681,3417,0.928280358598,36,0.00977995110024,10,0.0027166530834,31,0.00842162455854,153,0.041564792176,34,0.00923662048356,46,29,29,46,75,10,0.0027166530834,46,0.0124966041836,290,0.0787829394186,3391,0.921217060581,3290,0.893778864439,20,Ashe,3700920
Avery,996,927,0.930722891566,5,0.00502008032129,5,0.00502008032129,4,0.00401606425703,50,0.0502008032129,5,0.00502008032129,5,9,9,5,14,0,0.0,5,0.00502008032129,97,0.0973895582329,899,0.902610441767,879,0.882530120482,01,Avery,3701101
Avery,2538,2366,0.932230102443,65,0.0256107171001,9,0.00354609929078,14,0.00551615445232,45,0.0177304964539,39,0.01536643026,72,28,26,70,98,7,0.00275807722616,72,0.0283687943262,102,0.0401891252955,2436,0.959810874704,2314,0.911741528763,02,Avery,3701102
Avery,547,539,0.985374771481,0,0.0,2,0.0036563071298,1,0.0018281535649,3,0.0054844606947,2,0.0036563071298,0,3,3,0,3,0,0.0,0,0.0,9,0.0164533820841,538,0.983546617916,535,0.978062157221,03,Avery,3701103
Avery,105,100,0.952380952381,3,0.0285714285714,0,0.0,0,0.0,0,0.0,2,0.0190476190476,3,2,2,3,5,0,0.0,3,0.0285714285714,0,0.0,105,1.0,100,0.952380952381,04,Avery,3701104
Avery,501,490,0.978043912176,4,0.00798403193613,3,0.0059880239521,0,0.0,2,0.00399201596806,2,0.00399201596806,5,5,4,4,9,1,0.00199600798403,5,0.00998003992016,3,0.0059880239521,498,0.994011976048,489,0.976047904192,05,Avery,3701105
Avery,992,952,0.959677419355,7,0.0070564516129,4,0.00403225806452,0,0.0,22,0.0221774193548,7,0.0070564516129,7,4,4,7,11,0,0.0,7,0.0070564516129,40,0.0403225806452,952,0.959677419355,939,0.946572580645,06,Avery,3701106
Avery,235,229,0.974468085106,4,0.0170212765957,1,0.00425531914894,0,0.0,1,0.00425531914894,0,0.0,4,1,1,4,5,0,0.0,4,0.0170212765957,2,0.00851063829787,233,0.991489361702,228,0.970212765957,07,Avery,3701107
Avery,345,329,0.953623188406,1,0.00289855072464,1,0.00289855072464,2,0.00579710144928,11,0.031884057971,1,0.00289855072464,1,1,1,1,2,0,0.0,1,0.00289855072464,21,0.0608695652174,324,0.939130434783,319,0.924637681159,08,Avery,3701108
Avery,365,359,0.983561643836,0,0.0,1,0.0027397260274,0,0.0,5,0.013698630137,0,0.0,0,1,1,0,1,0,0.0,0,0.0,8,0.0219178082192,357,0.978082191781,356,0.975342465753,09,Avery,3701109
Avery,2709,2029,0.748984865264,579,0.21373200443,19,0.00701365817645,11,0.00406053894426,63,0.0232558139535,8,0.00295311923219,581,26,25,580,606,2,0.000738279808047,581,0.214470284238,91,0.0335917312661,2618,0.966408268734,2001,0.738648947951,10,Avery,3701110
Avery,353,332,0.940509915014,0,0.0,1,0.0028328611898,6,0.0169971671388,7,0.0198300283286,7,0.0198300283286,0,8,8,0,8,0,0.0,0,0.0,17,0.0481586402266,336,0.951841359773,322,0.912181303116,11,Avery,3701111
Avery,320,315,0.984375,0,0.0,1,0.003125,0,0.0,2,0.00625,2,0.00625,0,3,3,0,3,0,0.0,0,0.0,3,0.009375,317,0.990625,314,0.98125,12,Avery,3701112
Avery,538,528,0.981412639405,0,0.0,1,0.00185873605948,2,0.00371747211896,5,0.0092936802974,2,0.00371747211896,0,3,3,0,3,0,0.0,0,0.0,15,0.0278810408922,523,0.972118959108,518,0.96282527881,13,Avery,3701113
Avery,930,909,0.977419354839,4,0.00430107526882,0,0.0,2,0.00215053763441,9,0.00967741935484,6,0.00645161290323,4,5,5,4,9,0,0.0,4,0.00430107526882,29,0.0311827956989,901,0.968817204301,889,0.955913978495,14,Avery,3701114
Avery,899,841,0.935483870968,1,0.00111234705228,2,0.00222469410456,3,0.00333704115684,44,0.0489432703003,8,0.00889877641824,1,7,7,1,8,0,0.0,1,0.00111234705228,51,0.0567296996663,848,0.943270300334,833,0.926585094549,15,Avery,3701115
Avery,1031,985,0.955383123181,2,0.00193986420951,2,0.00193986420951,2,0.00193986420951,35,0.0339476236663,5,0.00484966052376,2,5,5,2,7,0,0.0,2,0.00193986420951,55,0.0533462657614,976,0.946653734239,966,0.936954413191,16,Avery,3701116
Avery,555,544,0.98018018018,7,0.0126126126126,0,0.0,0,0.0,3,0.00540540540541,1,0.0018018018018,7,0,0,7,7,0,0.0,7,0.0126126126126,7,0.0126126126126,548,0.987387387387,540,0.972972972973,17,Avery,3701117
Avery,395,386,0.977215189873,0,0.0,3,0.00759493670886,0,0.0,3,0.00759493670886,3,0.00759493670886,0,5,5,0,5,0,0.0,0,0.0,11,0.0278481012658,384,0.972151898734,380,0.962025316456,18,Avery,3701118
Avery,384,380,0.989583333333,0,0.0,1,0.00260416666667,1,0.00260416666667,1,0.00260416666667,1,0.00260416666667,0,2,2,0,2,0,0.0,0,0.0,1,0.00260416666667,383,0.997395833333,380,0.989583333333,19,Avery,3701119
Beaufort,1305,695,0.532567049808,578,0.442911877395,4,0.00306513409962,2,0.00153256704981,14,0.0107279693487,12,0.00919540229885,584,12,10,582,594,6,0.00459770114943,584,0.447509578544,30,0.0229885057471,1275,0.977011494253,685,0.524904214559,AUROR,Beaufort,37013AUROR
Beaufort,1846,1645,0.891115926327,103,0.0557963163597,3,0.00162513542795,4,0.00216684723727,81,0.0438786565547,10,0.00541711809317,109,8,5,106,114,6,0.0032502708559,109,0.0590465872156,114,0.0617551462622,1732,0.938244853738,1617,0.875947995666,BEADM,Beaufort,37013BEADM
Beaufort,1833,995,0.542825968358,775,0.422804146208,12,0.00654664484452,6,0.00327332242226,28,0.0152755046372,17,0.00927441352973,787,17,15,785,802,12,0.00654664484452,787,0.429350791053,65,0.0354609929078,1768,0.964539007092,969,0.528641571195,BELHV,Beaufort,37013BELHV
Beaufort,841,552,0.656361474435,274,0.325802615933,3,0.00356718192628,2,0.00237812128419,5,0.00594530321046,5,0.00594530321046,274,8,8,274,282,0,0.0,274,0.325802615933,13,0.0154577883472,828,0.984542211653,545,0.648038049941,BLCK,Beaufort,37013BLCK
Beaufort,4524,3297,0.728779840849,1011,0.223474801061,7,0.00154730327144,18,0.00397877984085,164,0.0362511052166,27,0.00596816976127,1023,25,21,1019,1044,12,0.0026525198939,1023,0.226127320955,223,0.0492926613616,4301,0.950707338638,3245,0.717285587975,CHOCO,Beaufort,37013CHOCO
Beaufort,1190,742,0.623529411765,430,0.361344537815,4,0.00336134453782,6,0.00504201680672,2,0.00168067226891,6,0.00504201680672,432,7,6,431,438,2,0.00168067226891,432,0.363025210084,10,0.00840336134454,1180,0.991596638655,737,0.619327731092,EDWAR,Beaufort,37013EDWAR
Beaufort,1897,1681,0.886136004217,186,0.0980495519241,2,0.00105429625725,15,0.00790722192936,1,0.000527148128624,12,0.00632577754349,193,8,5,190,198,7,0.00369003690037,193,0.101739588824,15,0.00790722192936,1882,0.992092778071,1670,0.880337374802,GILEA,Beaufort,37013GILEA
Beaufort,912,796,0.872807017544,87,0.0953947368421,4,0.00438596491228,0,0.0,19,0.0208333333333,6,0.00657894736842,89,6,5,88,94,2,0.00219298245614,89,0.0975877192982,37,0.0405701754386,875,0.959429824561,783,0.858552631579,HB,Beaufort,37013HB
Beaufort,1615,1437,0.889783281734,162,0.100309597523,7,0.00433436532508,1,0.00061919504644,1,0.00061919504644,7,0.00433436532508,164,12,11,163,175,2,0.00123839009288,164,0.101547987616,18,0.0111455108359,1597,0.988854489164,1427,0.883591331269,NCRK,Beaufort,37013NCRK
Beaufort,1483,998,0.672960215779,436,0.293998651382,1,0.000674308833446,9,0.00606877950101,27,0.018206338503,12,0.00809170600135,442,5,3,440,445,6,0.00404585300067,442,0.298044504383,43,0.0289952798382,1440,0.971004720162,989,0.666891436278,OLDF,Beaufort,37013OLDF
Beaufort,1392,855,0.614224137931,469,0.336925287356,17,0.0122126436782,0,0.0,44,0.0316091954023,7,0.00502873563218,474,23,19,470,493,5,0.00359195402299,474,0.340517241379,111,0.0797413793103,1281,0.92025862069,812,0.583333333333,PANTE,Beaufort,37013PANTE
Beaufort,957,870,0.909090909091,60,0.0626959247649,3,0.00313479623824,4,0.00417972831766,13,0.0135841170324,7,0.0073145245559,64,6,6,64,70,4,0.00417972831766,64,0.0668756530825,33,0.0344827586207,924,0.965517241379,854,0.89237199582,PINET,Beaufort,37013PINET
Beaufort,1507,500,0.331785003318,922,0.611811546118,1,0.000663570006636,17,0.0112806901128,46,0.0305242203052,21,0.0139349701393,936,6,2,932,938,14,0.0092899800929,936,0.621101526211,80,0.0530856005309,1427,0.946914399469,475,0.315195753152,PSJW3,Beaufort,37013PSJW3
Beaufort,2478,1676,0.676351896691,484,0.195318805488,19,0.00766747376917,4,0.00161420500404,272,0.109765940274,23,0.0092816787732,486,28,26,484,512,2,0.000807102502018,486,0.19612590799,385,0.155367231638,2093,0.844632768362,1602,0.646489104116,RVRD,Beaufort,37013RVRD
Beaufort,1872,1750,0.934829059829,80,0.042735042735,3,0.00160256410256,3,0.00160256410256,12,0.00641025641026,24,0.0128205128205,81,24,24,81,105,1,0.000534188034188,81,0.0432692307692,23,0.0122863247863,1849,0.987713675214,1742,0.930555555556,SURBA,Beaufort,37013SURBA
Beaufort,2650,2088,0.787924528302,401,0.151320754717,15,0.00566037735849,19,0.00716981132075,101,0.0381132075472,26,0.00981132075472,411,22,20,409,431,10,0.00377358490566,411,0.155094339623,139,0.0524528301887,2511,0.947547169811,2059,0.776981132075,TCRK,Beaufort,37013TCRK
Beaufort,1690,854,0.505325443787,758,0.448520710059,5,0.00295857988166,7,0.00414201183432,48,0.0284023668639,18,0.010650887574,768,18,11,761,779,10,0.00591715976331,768,0.454437869822,90,0.0532544378698,1600,0.94674556213,819,0.484615384615,WASH1,Beaufort,37013WASH1
Beaufort,1737,812,0.467472654001,862,0.496257915947,4,0.00230282095567,15,0.00863557858377,25,0.0143926309729,19,0.0109383995394,871,12,8,867,879,9,0.00518134715026,871,0.501439263097,55,0.0316637881405,1682,0.96833621186,796,0.458261370178,WASH2,Beaufort,37013WASH2
Beaufort,2571,1777,0.691170750681,627,0.243873978996,3,0.00116686114352,6,0.00233372228705,136,0.0528977051731,22,0.00855698171918,638,14,7,631,645,11,0.00427849085959,638,0.248152469856,186,0.0723453908985,2385,0.927654609102,1735,0.674834694671,WASH4,Beaufort,37013WASH4
Beaufort,1316,938,0.712765957447,264,0.200607902736,7,0.00531914893617,7,0.00531914893617,98,0.0744680851064,2,0.00151975683891,266,9,7,264,273,2,0.00151975683891,266,0.202127659574,139,0.105623100304,1177,0.894376899696,914,0.69452887538,WASHP,Beaufort,37013WASHP
Beaufort,1616,1456,0.90099009901,120,0.0742574257426,13,0.00804455445545,3,0.00185643564356,17,0.0105198019802,7,0.00433168316832,123,17,17,123,140,3,0.00185643564356,123,0.0761138613861,46,0.0284653465347,1570,0.971534653465,1436,0.888613861386,WDPD,Beaufort,37013WDPD
Bertie,986,496,0.503042596349,471,0.477687626775,3,0.00304259634888,0,0.0,6,0.00608519269777,10,0.0101419878296,477,9,7,475,484,6,0.00608519269777,477,0.483772819473,8,0.00811359026369,978,0.991886409736,493,0.5,C1,Bertie,37015C1
Bertie,1707,589,0.345049794962,1096,0.642062097247,7,0.00410076157001,0,0.0,9,0.00527240773286,6,0.00351493848858,1096,9,9,1096,1105,0,0.0,1096,0.642062097247,16,0.00937316930287,1691,0.990626830697,585,0.342706502636,C2,Bertie,37015C2
Bertie,392,53,0.135204081633,338,0.862244897959,0,0.0,0,0.0,0,0.0,1,0.00255102040816,339,0,0,339,339,1,0.00255102040816,339,0.864795918367,4,0.0102040816327,388,0.989795918367,52,0.132653061224,IW,Bertie,37015IW
Bertie,849,418,0.49234393404,421,0.495877502945,3,0.00353356890459,1,0.00117785630153,0,0.0,6,0.00706713780919,426,8,3,421,429,5,0.00588928150766,426,0.501766784452,0,0.0,849,1.0,418,0.49234393404,M1,Bertie,37015M1
Bertie,983,388,0.394710071211,583,0.593082400814,3,0.0030518819939,1,0.00101729399797,0,0.0,8,0.00813835198372,590,9,3,584,593,7,0.00712105798576,590,0.6002034588,7,0.00712105798576,976,0.992878942014,386,0.392675483215,M2,Bertie,37015M2
Bertie,811,336,0.414303329223,464,0.572133168927,3,0.00369913686806,3,0.00369913686806,1,0.00123304562269,4,0.00493218249075,464,7,7,464,471,0,0.0,464,0.572133168927,2,0.00246609124538,809,0.997533908755,336,0.414303329223,MH,Bertie,37015MH
Bertie,1302,332,0.254992319508,956,0.73425499232,3,0.00230414746544,0,0.0,7,0.00537634408602,4,0.00307219662058,959,5,3,957,962,3,0.00230414746544,959,0.736559139785,17,0.0130568356375,1285,0.986943164363,323,0.248079877112,RX,Bertie,37015RX
Bertie,1025,222,0.216585365854,779,0.76,5,0.00487804878049,0,0.0,15,0.0146341463415,4,0.00390243902439,783,9,5,779,788,4,0.00390243902439,783,0.763902439024,26,0.0253658536585,999,0.974634146341,213,0.207804878049,SN,Bertie,37015SN
Bertie,5703,1800,0.315623356128,3723,0.652814308259,44,0.00771523759425,58,0.0101700859197,12,0.00210415570752,66,0.0115728563914,3780,86,51,3745,3831,57,0.00999473961073,3780,0.66280904787,58,0.0101700859197,5645,0.98982991408,1775,0.311239698404,W1,Bertie,37015W1
Bertie,764,729,0.954188481675,24,0.0314136125654,2,0.00261780104712,5,0.0065445026178,0,0.0,4,0.00523560209424,28,3,2,27,30,4,0.00523560209424,28,0.0366492146597,1,0.00130890052356,763,0.998691099476,728,0.952879581152,W2,Bertie,37015W2
Bertie,1050,143,0.13619047619,879,0.837142857143,1,0.000952380952381,7,0.00666666666667,9,0.00857142857143,11,0.0104761904762,881,6,4,879,885,2,0.00190476190476,881,0.839047619048,26,0.0247619047619,1024,0.975238095238,135,0.128571428571,WD,Bertie,37015WD
Bertie,1274,768,0.602825745683,499,0.391679748823,1,0.000784929356358,1,0.000784929356358,2,0.00156985871272,3,0.00235478806907,501,3,2,500,503,2,0.00156985871272,501,0.393249607535,3,0.00235478806907,1271,0.997645211931,768,0.602825745683,WH,Bertie,37015WH
Bladen,813,568,0.69864698647,205,0.252152521525,7,0.00861008610086,1,0.00123001230012,27,0.0332103321033,5,0.00615006150062,207,9,8,206,215,2,0.00246002460025,207,0.254612546125,44,0.0541205412054,769,0.945879458795,556,0.683886838868,P10,Bladen,37017P10
Bladen,3314,2322,0.700663850332,617,0.18617984309,37,0.0111647555824,2,0.00060350030175,300,0.0905250452625,36,0.0108630054315,628,64,53,617,681,11,0.00331925165963,628,0.18949909475,370,0.111647555824,2944,0.888352444176,2267,0.684067592034,P15,Bladen,37017P15
Bladen,1607,1327,0.825762289981,247,0.153702551338,15,0.00933416303671,6,0.00373366521469,4,0.00248911014312,8,0.00497822028625,252,18,18,252,270,5,0.0031113876789,252,0.156813939017,22,0.0136901057872,1585,0.986309894213,1312,0.816428126945,P201,Bladen,37017P201
Bladen,3006,2255,0.750166333999,663,0.220558882236,26,0.00864936793081,3,0.000998003992016,34,0.0113107119095,25,0.00831669993347,674,44,35,665,709,11,0.00365934797073,674,0.224218230206,74,0.0246174318031,2932,0.975382568197,2219,0.738190286094,P202,Bladen,37017P202
Bladen,1414,719,0.508486562942,609,0.430693069307,22,0.015558698727,3,0.0021216407355,48,0.033946251768,13,0.00919377652051,615,29,26,612,641,6,0.004243281471,615,0.434936350778,68,0.048090523338,1346,0.951909476662,703,0.497171145686,P25,Bladen,37017P25
Bladen,1503,302,0.200931470393,915,0.60878243513,256,0.170326014637,0,0.0,6,0.00399201596806,24,0.0159680638723,931,277,264,918,1195,16,0.0106453759148,931,0.619427811045,7,0.00465735196274,1496,0.995342648037,301,0.200266134398,P30,Bladen,37017P30
Bladen,923,463,0.501625135428,374,0.405200433369,19,0.0205850487541,4,0.00433369447454,54,0.0585048754063,9,0.00975081256771,378,24,23,377,401,4,0.00433369447454,378,0.409534127844,72,0.0780065005417,851,0.921993499458,448,0.485373781148,P35,Bladen,37017P35
Bladen,1838,1246,0.677910772579,463,0.251904243743,16,0.00870511425462,4,0.00217627856366,100,0.0544069640914,9,0.00489662676823,466,20,20,466,486,3,0.00163220892274,466,0.253536452666,126,0.0685527747552,1712,0.931447225245,1221,0.664309031556,P40,Bladen,37017P40
Bladen,739,561,0.759133964817,132,0.178619756428,8,0.0108254397835,0,0.0,36,0.0487144790257,2,0.00270635994587,133,8,8,133,141,1,0.00135317997294,133,0.179972936401,47,0.063599458728,692,0.936400541272,550,0.744248985115,P45,Bladen,37017P45
Bladen,3068,1441,0.469687092568,1482,0.483050847458,9,0.0029335071708,16,0.00521512385919,101,0.0329204693611,19,0.00619295958279,1493,22,15,1486,1508,11,0.00358539765319,1493,0.486636245111,136,0.0443285528031,2932,0.955671447197,1415,0.461212516297,P501,Bladen,37017P501
Bladen,2092,1023,0.489005736138,977,0.467017208413,14,0.00669216061185,7,0.00334608030593,52,0.0248565965583,19,0.00908221797323,986,22,20,984,1006,9,0.00430210325048,986,0.471319311663,82,0.0391969407266,2010,0.960803059273,999,0.477533460803,P502,Bladen,37017P502
Bladen,822,491,0.597323600973,302,0.367396593674,14,0.0170316301703,0,0.0,11,0.0133819951338,4,0.00486618004866,304,16,16,304,320,2,0.00243309002433,304,0.369829683698,28,0.0340632603406,794,0.965936739659,474,0.576642335766,P55,Bladen,37017P55
Bladen,1789,930,0.519843487982,707,0.395192845165,32,0.0178870877585,5,0.00279485746227,100,0.0558971492454,15,0.00838457238681,714,39,38,713,752,7,0.00391280044718,714,0.399105645612,133,0.0743432084964,1656,0.925656791504,901,0.503633314701,P60,Bladen,37017P60
Bladen,745,548,0.735570469799,163,0.218791946309,11,0.0147651006711,0,0.0,19,0.0255033557047,4,0.00536912751678,166,15,12,163,178,3,0.00402684563758,166,0.222818791946,44,0.0590604026846,701,0.940939597315,523,0.702013422819,P65,Bladen,37017P65
Bladen,551,349,0.633393829401,178,0.323049001815,5,0.00907441016334,1,0.00181488203267,14,0.0254083484574,4,0.00725952813067,179,8,7,178,186,1,0.00181488203267,179,0.324863883848,23,0.0417422867514,528,0.958257713249,339,0.615245009074,P70,Bladen,37017P70
Bladen,1439,521,0.362056984017,832,0.578179291174,42,0.0291869353718,2,0.00138985406532,28,0.0194579569145,14,0.00972897845726,839,54,49,834,888,7,0.00486448922863,839,0.583043780403,41,0.0284920083391,1398,0.971507991661,512,0.355802640723,P75,Bladen,37017P75
Bladen,1410,822,0.582978723404,387,0.274468085106,11,0.00780141843972,6,0.00425531914894,170,0.120567375887,14,0.00992907801418,393,20,18,391,411,6,0.00425531914894,393,0.278723404255,209,0.148226950355,1201,0.851773049645,799,0.566666666667,P80,Bladen,37017P80
Brunswick,2003,1383,0.690464303545,518,0.258612081877,21,0.0104842735896,7,0.00349475786321,40,0.0199700449326,34,0.0169745381927,537,44,34,527,571,19,0.00948577134299,537,0.26809785322,82,0.0409385921118,1921,0.959061407888,1343,0.670494258612,01,Brunswick,3701901
Brunswick,5287,3649,0.690183468886,1167,0.22073009268,70,0.0132400226972,31,0.00586343862304,293,0.0554189521468,77,0.0145640249669,1208,107,89,1190,1297,41,0.00775487043692,1208,0.228484963117,552,0.104407036126,4735,0.895592963874,3424,0.647626253074,02,Brunswick,3701902
Brunswick,1842,1118,0.606948968512,588,0.319218241042,15,0.00814332247557,15,0.00814332247557,70,0.0380021715527,36,0.0195439739414,604,35,30,599,634,16,0.00868621064061,604,0.327904451683,127,0.0689467969598,1715,0.93105320304,1066,0.578718783931,03,Brunswick,3701903
Brunswick,10931,9141,0.836245540207,1312,0.120025615223,51,0.00466562986003,145,0.0132650260726,152,0.0139054066417,130,0.0118927819962,1360,113,89,1336,1449,48,0.00439118104474,1360,0.124416796267,382,0.034946482481,10549,0.965053517519,8944,0.818223401336,04,Brunswick,3701904
Brunswick,3979,3264,0.820306609701,524,0.131691379744,49,0.0123146519226,16,0.00402111083187,74,0.0185976375974,52,0.0130686102036,537,82,74,529,611,13,0.00326715255089,537,0.134958532295,144,0.0361899974868,3835,0.963810002513,3214,0.807740638351,05,Brunswick,3701905
Brunswick,1944,1410,0.725308641975,479,0.246399176955,13,0.00668724279835,1,0.000514403292181,9,0.00462962962963,32,0.0164609053498,492,35,28,485,520,13,0.00668724279835,492,0.253086419753,29,0.0149176954733,1915,0.985082304527,1395,0.717592592593,06,Brunswick,3701906
Brunswick,2693,2371,0.88043074638,225,0.0835499443,14,0.00519866320089,15,0.00556999628667,42,0.0155959896027,26,0.00965466023023,228,35,35,228,263,3,0.00111399925733,228,0.0846639435574,97,0.0360193093205,2596,0.96398069068,2323,0.862606758262,07,Brunswick,3701907
Brunswick,3945,3428,0.868948035488,364,0.0922686945501,14,0.00354879594423,36,0.00912547528517,46,0.0116603295311,57,0.0144486692015,374,45,40,369,414,10,0.00253485424588,374,0.0948035487959,128,0.0324461343473,3817,0.967553865653,3360,0.851711026616,08,Brunswick,3701908
Brunswick,1067,1029,0.964386129335,5,0.00468603561387,6,0.00562324273664,7,0.00656044985942,15,0.0140581068416,5,0.00468603561387,5,11,11,5,16,0,0.0,5,0.00468603561387,19,0.0178069353327,1048,0.982193064667,1026,0.961574507966,09,Brunswick,3701909
Brunswick,5600,5200,0.928571428571,302,0.0539285714286,14,0.0025,21,0.00375,30,0.00535714285714,33,0.00589285714286,310,33,31,308,341,8,0.00142857142857,310,0.0553571428571,73,0.0130357142857,5527,0.986964285714,5169,0.923035714286,10,Brunswick,3701910
Brunswick,2734,1607,0.587783467447,1004,0.367227505486,30,0.0109729334309,4,0.00146305779078,64,0.0234089246525,25,0.00914411119239,1013,47,41,1007,1054,9,0.00329188002926,1013,0.370519385516,112,0.0409656181419,2622,0.959034381858,1571,0.57461594733,11,Brunswick,3701911
Brunswick,3151,2871,0.911139320851,202,0.064106632815,26,0.00825134877817,5,0.00158679784195,25,0.00793398920977,22,0.0069819105046,210,41,39,208,249,8,0.00253887654713,210,0.0666455093621,53,0.0168200571247,3098,0.983179942875,2848,0.903840050778,12,Brunswick,3701912
Brunswick,4102,3444,0.839590443686,422,0.102876645539,47,0.011457825451,21,0.00511945392491,113,0.0275475377864,55,0.0134080936129,452,67,58,443,510,30,0.00731350560702,452,0.110190151146,238,0.0580204778157,3864,0.941979522184,3346,0.815699658703,13,Brunswick,3701913
Brunswick,4246,3957,0.931935939708,155,0.0365049458314,15,0.00353273669336,34,0.00800753650495,65,0.0153085256712,20,0.00471031559114,161,27,24,158,185,6,0.00141309467734,161,0.0379180405087,158,0.03721149317,4088,0.96278850683,3873,0.912152614225,14,Brunswick,3701914
Brunswick,4918,4311,0.876575843839,341,0.0693371289142,41,0.00833672224481,31,0.00630337535584,148,0.0300935339569,46,0.0093533956893,347,54,54,347,401,6,0.00122000813339,347,0.0705571370476,289,0.0587637250915,4629,0.941236274908,4203,0.854615697438,15,Brunswick,3701915
Brunswick,4341,4149,0.955770559779,90,0.0207325501037,16,0.0036857866851,15,0.00345542501728,51,0.0117484450587,20,0.00460723335637,92,28,28,92,120,2,0.000460723335637,92,0.0211932734393,135,0.0310988251555,4206,0.968901174845,4072,0.938032711357,16,Brunswick,3701916
Brunswick,5008,3868,0.772364217252,984,0.196485623003,21,0.00419329073482,15,0.00299520766773,83,0.0165734824281,37,0.00738817891374,994,44,39,989,1033,10,0.00199680511182,994,0.198482428115,150,0.0299520766773,4858,0.970047923323,3811,0.760982428115,17,Brunswick,3701917
Brunswick,2448,2058,0.84068627451,175,0.0714869281046,21,0.00857843137255,2,0.000816993464052,173,0.0706699346405,19,0.0077614379085,175,24,24,175,199,0,0.0,175,0.0714869281046,247,0.10089869281,2201,0.89910130719,2002,0.817810457516,18,Brunswick,3701918
Brunswick,4318,4073,0.943260768874,113,0.0261695229273,20,0.00463177396943,20,0.00463177396943,62,0.0143584993052,30,0.00694766095415,119,35,33,117,152,6,0.00138953219083,119,0.0275590551181,158,0.0365910143585,4160,0.963408985642,3999,0.926123205188,19,Brunswick,3701919
Brunswick,3584,3355,0.936104910714,102,0.0284598214286,31,0.00864955357143,6,0.00167410714286,50,0.0139508928571,40,0.0111607142857,111,51,51,111,162,9,0.00251116071429,111,0.0309709821429,118,0.0329241071429,3466,0.967075892857,3300,0.920758928571,20,Brunswick,3701920
Brunswick,4520,4257,0.941814159292,134,0.0296460176991,15,0.0033185840708,25,0.00553097345133,29,0.00641592920354,60,0.0132743362832,150,55,50,145,200,16,0.00353982300885,150,0.033185840708,92,0.0203539823009,4428,0.979646017699,4197,0.928539823009,21,Brunswick,3701921
Brunswick,2259,2191,0.969898185038,15,0.0066401062417,11,0.00486941124391,8,0.00354138999557,9,0.00398406374502,25,0.0110668437362,17,31,29,15,46,2,0.000885347498893,17,0.00752545374059,35,0.0154935812306,2224,0.984506418769,2164,0.957945993803,22,Brunswick,3701922
Brunswick,2350,2306,0.981276595745,11,0.00468085106383,12,0.00510638297872,4,0.00170212765957,1,0.000425531914894,16,0.0068085106383,13,21,20,12,33,2,0.000851063829787,13,0.00553191489362,12,0.00510638297872,2338,0.994893617021,2297,0.977446808511,23,Brunswick,3701923
Buncombe,2124,1442,0.678907721281,615,0.289548022599,5,0.00235404896422,21,0.00988700564972,8,0.00376647834275,33,0.0155367231638,637,19,7,625,644,22,0.0103578154426,637,0.299905838041,66,0.0310734463277,2058,0.968926553672,1390,0.654425612053,01.1,Buncombe,3702101.1
Buncombe,3264,2396,0.734068627451,744,0.227941176471,11,0.00337009803922,32,0.00980392156863,18,0.00551470588235,63,0.0193014705882,775,46,28,757,803,31,0.00949754901961,775,0.23743872549,69,0.0211397058824,3195,0.978860294118,2346,0.71875,02.1,Buncombe,3702102.1
Buncombe,2413,1991,0.825113966017,334,0.138416908413,10,0.00414421881475,20,0.00828843762951,12,0.0049730625777,46,0.0190634065479,348,37,32,343,380,14,0.00580190634065,348,0.144218814753,70,0.0290095317033,2343,0.970990468297,1947,0.806879403232,03.1,Buncombe,3702103.1
Buncombe,1251,1186,0.948041566747,37,0.0295763389289,1,0.000799360511591,9,0.00719424460432,5,0.00399680255795,13,0.0103916866507,39,6,6,39,45,2,0.00159872102318,39,0.031175059952,23,0.0183852917666,1228,0.981614708233,1169,0.93445243805,04.1,Buncombe,3702104.1
Buncombe,2244,2159,0.962121212121,22,0.00980392156863,0,0.0,21,0.00935828877005,25,0.0111408199643,17,0.00757575757576,22,7,7,22,29,0,0.0,22,0.00980392156863,50,0.0222816399287,2194,0.977718360071,2133,0.950534759358,05.1,Buncombe,3702105.1
Buncombe,1395,1270,0.910394265233,79,0.0566308243728,4,0.00286738351254,13,0.00931899641577,18,0.0129032258065,11,0.0078853046595,83,7,7,83,90,4,0.00286738351254,83,0.0594982078853,35,0.0250896057348,1360,0.974910394265,1255,0.899641577061,06.1,Buncombe,3702106.1
Buncombe,1571,1332,0.847867600255,182,0.115849777212,6,0.00381922342457,12,0.00763844684914,9,0.00572883513686,30,0.0190961171229,194,17,13,190,207,12,0.00763844684914,194,0.123488224061,33,0.0210057288351,1538,0.978994271165,1312,0.835136855506,07.1,Buncombe,3702107.1
Buncombe,3266,2672,0.818126148194,385,0.117881200245,17,0.00520514390692,21,0.00642988364972,115,0.0352112676056,56,0.0171463563993,401,40,35,396,436,16,0.00489895897122,401,0.122780159216,208,0.0636864666258,3058,0.936313533374,2592,0.793631353337,09.1,Buncombe,3702109.1
Buncombe,2284,1192,0.521891418564,1027,0.449649737303,10,0.00437828371278,10,0.00437828371278,10,0.00437828371278,35,0.0153239929947,1049,25,18,1042,1067,22,0.00963222416813,1049,0.459281961471,33,0.0144483362522,2251,0.985551663748,1173,0.51357267951,10.1,Buncombe,3702110.1
Buncombe,7282,5277,0.724663553969,1402,0.192529524856,37,0.00508102169734,97,0.0133205163417,325,0.0446305959901,144,0.0197747871464,1456,104,85,1437,1541,54,0.0074155451799,1456,0.199945070036,610,0.0837681955507,6672,0.916231804449,5037,0.691705575391,100.1,Buncombe,37021100.1
Buncombe,7904,6682,0.845394736842,553,0.0699645748988,17,0.0021508097166,214,0.0270748987854,348,0.044028340081,90,0.0113866396761,579,46,41,574,620,26,0.00328947368421,579,0.073254048583,847,0.107160931174,7057,0.892839068826,6223,0.787322874494,101.1,Buncombe,37021101.1
Buncombe,5027,4613,0.91764471852,239,0.0475432663616,9,0.00179033220609,72,0.0143226576487,37,0.00736025462502,57,0.0113387706386,254,38,35,251,289,15,0.00298388701015,254,0.0505271533718,104,0.0206882832703,4923,0.97931171673,4552,0.905510244679,102.1,Buncombe,37021102.1
Buncombe,3939,3486,0.884996191927,318,0.0807311500381,15,0.003808073115,42,0.010662604722,15,0.003808073115,63,0.015993907083,342,42,32,332,374,24,0.00609291698401,342,0.0868240670221,89,0.022594567149,3850,0.977405432851,3422,0.868748413303,103.1,Buncombe,37021103.1
Buncombe,2671,2583,0.967053538001,34,0.0127293148633,4,0.00149756645451,17,0.00636465743167,6,0.00224634968177,27,0.010108573568,40,12,11,39,51,6,0.00224634968177,40,0.0149756645451,40,0.0149756645451,2631,0.985024335455,2555,0.956570572819,104.1,Buncombe,37021104.1
Buncombe,4540,3686,0.811894273128,370,0.0814977973568,32,0.00704845814978,22,0.00484581497797,349,0.076872246696,81,0.0178414096916,394,59,53,388,447,24,0.00528634361233,394,0.0867841409692,657,0.144713656388,3883,0.855286343612,3422,0.753744493392,105.1,Buncombe,37021105.1
Buncombe,4849,4040,0.833161476593,317,0.0653743039802,23,0.00474324603011,128,0.026397195298,233,0.0480511445659,108,0.0222726335327,346,60,56,342,402,29,0.0059806145597,346,0.0713549185399,483,0.0996081666323,4366,0.900391833368,3836,0.791090946587,106.1,Buncombe,37021106.1
Buncombe,5795,5558,0.95910267472,33,0.00569456427955,18,0.00310612597066,20,0.00345125107852,97,0.0167385677308,69,0.0119068162209,55,63,55,47,110,22,0.00379637618637,55,0.00949094046592,178,0.0307161345988,5617,0.969283865401,5484,0.946333045729,107.1,Buncombe,37021107.1
Buncombe,1423,902,0.633872101195,461,0.323963457484,13,0.00913562895292,3,0.00210822206606,8,0.00562192550949,36,0.0252986647927,480,37,26,469,506,19,0.013352073085,480,0.337315530569,36,0.0252986647927,1387,0.974701335207,881,0.619114546732,11.1,Buncombe,3702111.1
Buncombe,1841,1638,0.889733840304,121,0.0657251493753,8,0.00434546442151,12,0.00651819663227,32,0.017381857686,30,0.0162954915807,128,17,15,126,143,7,0.00380228136882,128,0.0695274307442,104,0.0564910374796,1737,0.94350896252,1573,0.854426941879,12.1,Buncombe,3702112.1
Buncombe,2317,1795,0.774708675011,408,0.176089771256,5,0.00215796288304,13,0.0056107034959,51,0.022011221407,45,0.0194216659473,425,27,22,420,447,17,0.00733707380233,425,0.183426845058,117,0.0504963314631,2200,0.949503668537,1736,0.749244712991,13.1,Buncombe,3702113.1
Buncombe,2403,1836,0.76404494382,370,0.153974198918,3,0.00124843945069,15,0.00624219725343,135,0.0561797752809,44,0.0183104452767,388,19,10,379,398,18,0.00749063670412,388,0.161464835622,280,0.116521015397,2123,0.883478984603,1707,0.710362047441,14.2,Buncombe,3702114.2
Buncombe,1895,1792,0.945646437995,44,0.0232189973615,6,0.00316622691293,8,0.00422163588391,17,0.0089709762533,28,0.0147757255937,49,19,19,49,68,5,0.00263852242744,49,0.0258575197889,51,0.0269129287599,1844,0.97308707124,1757,0.927176781003,15.1,Buncombe,3702115.1
Buncombe,1559,1415,0.90763309814,82,0.0525978191148,2,0.00128287363695,27,0.0173187940988,15,0.0096215522771,18,0.0115458627325,91,8,7,90,98,9,0.00577293136626,91,0.0583707504811,40,0.0256574727389,1519,0.974342527261,1388,0.890314304041,17.1,Buncombe,3702117.1
Buncombe,1830,1437,0.785245901639,209,0.114207650273,5,0.00273224043716,84,0.0459016393443,76,0.0415300546448,19,0.0103825136612,215,17,14,212,229,6,0.00327868852459,215,0.117486338798,118,0.0644808743169,1712,0.935519125683,1400,0.765027322404,19.1,Buncombe,3702119.1
Buncombe,999,844,0.844844844845,122,0.122122122122,1,0.001001001001,22,0.022022022022,4,0.004004004004,6,0.00600600600601,122,5,5,122,127,0,0.0,122,0.122122122122,16,0.016016016016,983,0.983983983984,834,0.834834834835,20.1,Buncombe,3702120.1
Buncombe,2485,2230,0.897384305835,109,0.0438631790744,13,0.00523138832998,18,0.00724346076459,81,0.0325955734406,34,0.0136820925553,122,26,21,117,143,13,0.00523138832998,122,0.0490945674044,173,0.0696177062374,2312,0.930382293763,2145,0.863179074447,24.1,Buncombe,3702124.1
Buncombe,2542,2192,0.86231313926,187,0.073564122738,17,0.00668764752164,54,0.021243115657,40,0.0157356412274,52,0.0204563335956,209,38,37,208,246,22,0.00865460267506,209,0.0822187254131,110,0.0432730133753,2432,0.956726986625,2134,0.839496459481,25.1,Buncombe,3702125.1
Buncombe,1758,1477,0.8401592719,95,0.0540386803185,4,0.00227531285552,36,0.0204778156997,120,0.0682593856655,26,0.0147895335609,102,12,11,101,113,7,0.00398179749716,102,0.0580204778157,207,0.117747440273,1551,0.882252559727,1407,0.800341296928,26.1,Buncombe,3702126.1
Buncombe,2739,2505,0.91456736035,112,0.0408908360716,8,0.00292077400511,34,0.0124132895217,28,0.0102227090179,52,0.0189850310332,133,22,18,129,151,21,0.00766703176342,133,0.048557867835,95,0.0346841913107,2644,0.965315808689,2440,0.890836071559,28.1,Buncombe,3702128.1
Buncombe,4062,3761,0.925898572132,94,0.0231413096997,18,0.00443131462334,87,0.0214180206795,58,0.014278680453,44,0.0108321024126,108,38,34,104,142,14,0.00344657804037,108,0.02658788774,169,0.0416051206302,3893,0.95839487937,3655,0.899803052683,30.1,Buncombe,3702130.1
Buncombe,1053,1043,0.990503323837,5,0.00474833808167,0,0.0,2,0.00189933523267,1,0.000949667616334,2,0.00189933523267,5,2,2,5,7,0,0.0,5,0.00474833808167,8,0.00759734093067,1045,0.992402659069,1035,0.982905982906,31.1,Buncombe,3702131.1
Buncombe,2174,1990,0.915363385465,90,0.0413983440662,11,0.0050597976081,9,0.00413983440662,31,0.0142594296228,43,0.0197792088316,102,37,32,97,134,12,0.00551977920883,102,0.0469181232751,130,0.0597976080957,2044,0.940202391904,1907,0.877184912603,32.1,Buncombe,3702132.1
Buncombe,1242,1184,0.953301127214,36,0.0289855072464,1,0.000805152979066,6,0.0048309178744,2,0.00161030595813,13,0.0104669887279,42,7,6,41,48,6,0.0048309178744,42,0.0338164251208,12,0.00966183574879,1230,0.990338164251,1175,0.946054750403,33.2,Buncombe,3702133.2
Buncombe,2066,1874,0.907066795741,115,0.0556631171346,9,0.00435624394966,9,0.00435624394966,14,0.00677637947725,45,0.0217812197483,121,38,37,120,158,6,0.00290416263311,121,0.0585672797677,56,0.027105517909,2010,0.972894482091,1843,0.89206195547,33.3,Buncombe,3702133.3
Buncombe,1087,1045,0.961361545538,26,0.0239190432383,0,0.0,4,0.00367985280589,4,0.00367985280589,8,0.00735970561178,28,5,4,27,32,2,0.00183992640294,28,0.0257589696412,13,0.0119595216191,1074,0.988040478381,1037,0.954001839926,34.1,Buncombe,3702134.1
Buncombe,2021,1763,0.872340425532,186,0.0920336467095,4,0.00197921820881,16,0.00791687283523,19,0.00940128649184,33,0.0163285502227,198,26,20,192,218,12,0.00593765462642,198,0.097971301336,48,0.0237506185057,1973,0.976249381494,1740,0.860959920831,35.1,Buncombe,3702135.1
Buncombe,2276,2134,0.937609841828,72,0.0316344463972,4,0.00175746924429,13,0.00571177504394,25,0.0109841827768,28,0.01230228471,80,18,17,79,97,8,0.00351493848858,80,0.0351493848858,47,0.0206502636204,2229,0.97934973638,2112,0.927943760984,36.1,Buncombe,3702136.1
Buncombe,1412,1382,0.978753541076,0,0.0,4,0.0028328611898,8,0.0056657223796,2,0.0014164305949,16,0.0113314447592,1,14,14,1,15,1,0.00070821529745,1,0.00070821529745,12,0.00849858356941,1400,0.991501416431,1373,0.972379603399,37.1,Buncombe,3702137.1
Buncombe,1634,1585,0.970012239902,5,0.0030599755202,4,0.00244798041616,5,0.0030599755202,18,0.0110159118727,17,0.0104039167687,12,9,9,12,21,7,0.00428396572827,12,0.00734394124847,29,0.0177478580171,1605,0.982252141983,1570,0.960832313341,38.2,Buncombe,3702138.2
Buncombe,3176,2963,0.932934508816,114,0.0358942065491,21,0.0066120906801,16,0.00503778337531,27,0.00850125944584,35,0.0110201511335,119,44,41,116,160,5,0.00157430730479,119,0.0374685138539,77,0.0242443324937,3099,0.975755667506,2920,0.919395465995,38.3,Buncombe,3702138.3
Buncombe,3827,3716,0.970995557878,25,0.00653253200941,18,0.00470342304677,11,0.00287431408414,23,0.00600992944865,34,0.00888424353279,29,41,41,29,70,4,0.00104520512151,29,0.00757773713091,69,0.018029788346,3758,0.981970211654,3669,0.958714397701,39.1,Buncombe,3702139.1
Buncombe,3302,3130,0.947910357359,27,0.00817686250757,12,0.00363416111448,9,0.00272562083586,82,0.0248334342823,42,0.0127195639007,46,31,29,44,75,19,0.00575408843125,46,0.0139309509388,267,0.0808600847971,3035,0.919139915203,2971,0.899757722592,41.1,Buncombe,3702141.1
Buncombe,4056,3806,0.938362919132,60,0.0147928994083,19,0.00468441814596,60,0.0147928994083,72,0.0177514792899,39,0.00961538461538,73,38,34,69,107,13,0.00320512820513,73,0.0179980276134,160,0.0394477317554,3896,0.960552268245,3729,0.919378698225,44.1,Buncombe,3702144.1
Buncombe,4486,4122,0.918858671422,89,0.0198395006687,24,0.00534997770843,27,0.00601872492198,162,0.0361123495319,62,0.0138207757468,106,53,48,101,154,17,0.00378956754347,106,0.0236290682122,309,0.068880962996,4177,0.931119037004,3998,0.891217119929,45.1,Buncombe,3702145.1
Buncombe,1339,1266,0.945481702763,6,0.00448095593727,12,0.00896191187453,17,0.0126960418223,28,0.0209111277072,10,0.00746825989544,9,17,16,8,25,3,0.00224047796863,9,0.0067214339059,54,0.0403286034354,1285,0.959671396565,1243,0.928304705004,46.1,Buncombe,3702146.1
Buncombe,4545,4369,0.961276127613,26,0.00572057205721,17,0.0037403740374,16,0.0035203520352,66,0.0145214521452,51,0.0112211221122,37,54,50,33,87,11,0.0024202420242,37,0.00814081408141,137,0.0301430143014,4408,0.969856985699,4302,0.946534653465,47.1,Buncombe,3702147.1
Buncombe,4049,3719,0.918498394665,83,0.0204988886145,26,0.00642133860212,25,0.0061743640405,156,0.0385280316127,40,0.00987898246481,92,48,44,88,136,9,0.00222277105458,92,0.0227216596691,249,0.0614966658434,3800,0.938503334157,3645,0.900222277105,48.1,Buncombe,3702148.1
Buncombe,4361,4218,0.967209355652,36,0.00825498738821,26,0.00596193533593,17,0.00389818848888,32,0.0073377665673,32,0.0073377665673,47,43,41,45,88,11,0.00252235725751,47,0.0107773446457,100,0.0229305205228,4261,0.977069479477,4157,0.953221738133,49.1,Buncombe,3702149.1
Buncombe,1613,1577,0.97768133912,1,0.000619962802232,3,0.0018598884067,3,0.0018598884067,8,0.00495970241785,21,0.0130192188469,5,15,15,5,20,4,0.00247985120893,5,0.00309981401116,10,0.00619962802232,1603,0.993800371978,1573,0.975201487911,50.1,Buncombe,3702150.1
Buncombe,4108,3890,0.946932814021,30,0.00730282375852,24,0.00584225900682,58,0.0141187925998,53,0.0129016553067,53,0.0129016553067,41,60,57,38,98,11,0.00267770204479,41,0.00998052580331,135,0.0328627069133,3973,0.967137293087,3813,0.928188899708,52.1,Buncombe,3702152.1
Buncombe,3129,3010,0.961968680089,39,0.0124640460211,17,0.0054330457015,8,0.00255672738894,29,0.00926813678492,26,0.00830936401406,40,36,36,40,76,1,0.000319590923618,40,0.0127836369447,68,0.021732182806,3061,0.978267817194,2976,0.951102588686,53.1,Buncombe,3702153.1
Buncombe,2870,2674,0.931707317073,99,0.0344947735192,8,0.00278745644599,45,0.0156794425087,21,0.00731707317073,23,0.00801393728223,106,17,16,105,122,7,0.00243902439024,106,0.0369337979094,47,0.0163763066202,2823,0.98362369338,2651,0.923693379791,55.1,Buncombe,3702155.1
Buncombe,2681,2511,0.936590824319,68,0.0253636702723,12,0.00447594181276,56,0.0208877284595,17,0.00634091756807,17,0.00634091756807,71,17,17,71,88,3,0.00111898545319,71,0.0264826557255,60,0.0223797090638,2621,0.977620290936,2470,0.921298023126,57.1,Buncombe,3702157.1
Buncombe,1863,1788,0.959742351047,23,0.0123456790123,6,0.00322061191626,15,0.00805152979066,19,0.0101986044015,12,0.00644122383253,25,16,16,25,41,2,0.00107353730542,25,0.0134192163178,73,0.0391841116479,1790,0.960815888352,1736,0.931830381106,58.1,Buncombe,3702158.1
Buncombe,3404,3287,0.96562867215,25,0.00734430082256,15,0.00440658049354,17,0.00499412455934,6,0.00176263219741,54,0.0158636897767,32,53,50,29,82,7,0.00205640423032,32,0.00940070505288,40,0.0117508813161,3364,0.988249118684,3257,0.956815511163,59.1,Buncombe,3702159.1
Buncombe,1050,943,0.898095238095,17,0.0161904761905,4,0.00380952380952,14,0.0133333333333,56,0.0533333333333,16,0.0152380952381,19,13,13,19,32,2,0.00190476190476,19,0.0180952380952,103,0.0980952380952,947,0.901904761905,904,0.860952380952,60.2,Buncombe,3702160.2
Buncombe,2316,2237,0.965889464594,27,0.0116580310881,2,0.000863557858377,21,0.00906735751295,5,0.00215889464594,24,0.0103626943005,34,15,15,34,49,7,0.00302245250432,34,0.0146804835924,25,0.0107944732297,2291,0.98920552677,2219,0.958117443869,61.1,Buncombe,3702161.1
Buncombe,3079,2868,0.931471256902,97,0.0315037349789,9,0.0029230269568,21,0.00682039623254,45,0.014615134784,39,0.0126664501462,106,27,25,104,131,9,0.0029230269568,106,0.0344267619357,116,0.0376745696655,2963,0.962325430335,2799,0.909061383566,62.1,Buncombe,3702162.1
Buncombe,601,584,0.971713810316,4,0.00665557404326,3,0.00499168053245,3,0.00499168053245,3,0.00499168053245,4,0.00665557404326,4,4,4,4,8,0,0.0,4,0.00665557404326,14,0.0232945091514,587,0.976705490849,573,0.953410981697,63.1,Buncombe,3702163.1
Buncombe,2158,1979,0.917052826691,90,0.0417052826691,16,0.00741427247451,15,0.00695088044486,31,0.0143651529194,27,0.0125115848007,95,35,32,92,127,5,0.00231696014829,95,0.0440222428174,54,0.0250231696015,2104,0.974976830399,1962,0.909175162187,64.1,Buncombe,3702164.1
Buncombe,3409,3214,0.942798474626,67,0.0196538574362,13,0.00381343502493,42,0.0123203285421,26,0.00762687004987,47,0.0137870343209,80,30,25,75,105,13,0.00381343502493,80,0.0234672924611,120,0.0352009386917,3289,0.964799061308,3137,0.920211205632,65.1,Buncombe,3702165.1
Buncombe,2052,1865,0.908869395712,64,0.0311890838207,14,0.00682261208577,35,0.0170565302144,45,0.0219298245614,29,0.0141325536062,73,29,27,71,100,9,0.00438596491228,73,0.0355750487329,140,0.0682261208577,1912,0.931773879142,1774,0.864522417154,66.1,Buncombe,3702166.1
Buncombe,2213,2126,0.960686850429,19,0.00858563036602,0,0.0,5,0.00225937641211,13,0.00587437867149,50,0.0225937641211,32,44,32,20,64,13,0.00587437867149,32,0.0144600090375,37,0.0167193854496,2176,0.98328061455,2104,0.950745594216,67.1,Buncombe,3702167.1
Buncombe,4819,4424,0.918032786885,87,0.0180535380784,30,0.00622535795808,36,0.0074704295497,184,0.0381821954762,58,0.0120356920523,95,59,59,95,154,8,0.00166009545549,95,0.0197136335339,331,0.0686864494708,4488,0.931313550529,4287,0.88960365221,68.1,Buncombe,3702168.1
Buncombe,3169,2947,0.929946355317,77,0.0242978857684,17,0.00536446828653,25,0.00788892395077,64,0.020195645314,39,0.0123067213632,92,30,28,90,120,15,0.00473335437046,92,0.0290312401388,148,0.0467024297886,3021,0.953297570211,2871,0.905964026507,69.1,Buncombe,3702169.1
Buncombe,2818,2524,0.895670688432,84,0.0298083747339,17,0.00603264726757,40,0.014194464159,109,0.0386799148332,44,0.0156139105749,96,34,31,93,127,12,0.00425833924769,96,0.0340667139815,243,0.0862313697658,2575,0.913768630234,2411,0.855571327182,70.1,Buncombe,3702170.1
Buncombe,4348,3898,0.896504139834,192,0.0441582336707,13,0.00298988040478,56,0.0128794848206,149,0.0342686292548,40,0.00919963201472,199,29,28,198,227,7,0.00160993560258,199,0.0457681692732,256,0.0588776448942,4092,0.941122355106,3804,0.8748850046,71.1,Buncombe,3702171.1
Burke,3809,3355,0.880808611184,193,0.0506694670517,13,0.00341296928328,154,0.0404305592019,65,0.0170648464164,29,0.00761354686269,205,23,20,202,225,12,0.00315043318456,205,0.0538199002363,104,0.0273037542662,3705,0.972696245734,3331,0.874507744815,0001,Burke,370230001
Burke,1356,1260,0.929203539823,15,0.0110619469027,2,0.00147492625369,51,0.037610619469,18,0.0132743362832,10,0.00737463126844,16,9,9,16,25,1,0.000737463126844,16,0.0117994100295,22,0.0162241887906,1334,0.983775811209,1258,0.927728613569,0003,Burke,370230003
Burke,3430,3169,0.923906705539,36,0.0104956268222,8,0.00233236151603,152,0.0443148688047,34,0.00991253644315,31,0.00903790087464,44,28,27,43,71,8,0.00233236151603,44,0.0128279883382,65,0.0189504373178,3365,0.981049562682,3142,0.916034985423,0011,Burke,370230011
Burke,2068,2009,0.971470019342,8,0.00386847195358,3,0.00145067698259,30,0.0145067698259,5,0.00241779497099,13,0.00628626692456,9,12,12,9,21,1,0.000483558994197,9,0.00435203094778,11,0.00531914893617,2057,0.994680851064,2003,0.968568665377,0012,Burke,370230012
Burke,3525,3299,0.935886524823,44,0.0124822695035,8,0.0022695035461,112,0.0317730496454,38,0.010780141844,24,0.0068085106383,49,20,20,49,69,5,0.00141843971631,49,0.0139007092199,71,0.0201418439716,3454,0.979858156028,3269,0.927375886525,0013,Burke,370230013
Burke,2674,2522,0.94315632012,9,0.00336574420344,2,0.00074794315632,78,0.0291697830965,45,0.0168287210172,18,0.00673148840688,11,9,8,10,19,2,0.00074794315632,11,0.00411368735976,65,0.0243081525804,2609,0.97569184742,2503,0.936050860135,0014,Burke,370230014
Burke,1947,1767,0.907550077042,31,0.0159219311762,13,0.00667693888033,76,0.0390344119158,47,0.0241397021058,13,0.00667693888033,34,22,19,31,53,3,0.00154083204931,34,0.0174627632255,77,0.0395480225989,1870,0.960451977401,1740,0.893682588598,0015,Burke,370230015
Burke,564,551,0.97695035461,1,0.00177304964539,0,0.0,2,0.00354609929078,2,0.00354609929078,8,0.0141843971631,1,8,8,1,9,0,0.0,1,0.00177304964539,7,0.0124113475177,557,0.987588652482,546,0.968085106383,0018,Burke,370230018
Burke,565,526,0.930973451327,33,0.058407079646,1,0.00176991150442,1,0.00176991150442,1,0.00176991150442,3,0.00530973451327,35,4,2,33,37,2,0.00353982300885,35,0.0619469026549,5,0.00884955752212,560,0.991150442478,522,0.92389380531,0019,Burke,370230019
Burke,853,709,0.831184056272,132,0.154747948417,4,0.00468933177022,7,0.00820633059789,0,0.0,1,0.00117233294256,132,4,4,132,136,0,0.0,132,0.154747948417,3,0.00351699882767,850,0.996483001172,706,0.827667057444,0020,Burke,370230020
Burke,1682,1614,0.959571938169,16,0.00951248513674,3,0.00178359096314,29,0.0172413793103,10,0.00594530321046,10,0.00594530321046,17,8,8,17,25,1,0.000594530321046,17,0.0101070154578,23,0.0136741973841,1659,0.986325802616,1601,0.951843043995,0021,Burke,370230021
Burke,2290,2145,0.936681222707,34,0.0148471615721,3,0.00131004366812,78,0.0340611353712,19,0.00829694323144,11,0.00480349344978,35,4,4,35,39,1,0.000436681222707,35,0.0152838427948,28,0.0122270742358,2262,0.987772925764,2141,0.934934497817,0022,Burke,370230022
Burke,2770,2634,0.950902527076,32,0.0115523465704,3,0.00108303249097,61,0.0220216606498,21,0.00758122743682,19,0.00685920577617,36,15,14,35,50,4,0.0014440433213,36,0.0129963898917,53,0.0191335740072,2717,0.980866425993,2607,0.941155234657,0024,Burke,370230024
Burke,2746,2556,0.930808448653,62,0.0225782957028,8,0.00291332847779,75,0.0273124544792,6,0.00218499635834,39,0.0142024763292,66,42,41,65,107,4,0.00145666423889,66,0.0240349599417,24,0.00873998543336,2722,0.991260014567,2539,0.924617625637,0029,Burke,370230029
Burke,2767,1666,0.602096132996,480,0.173473075533,12,0.00433682688833,111,0.040115648717,418,0.15106613661,80,0.0289121792555,497,30,25,492,522,17,0.0061438380918,497,0.179616913625,647,0.233827249729,2120,0.766172750271,1535,0.554752439465,0031,Burke,370230031
Burke,2349,1860,0.791826309068,186,0.0791826309068,43,0.0183056619838,42,0.0178799489144,173,0.0736483610047,45,0.0191570881226,201,60,56,197,257,15,0.00638569604087,201,0.0855683269476,317,0.134951042997,2032,0.865048957003,1788,0.761174968072,0034,Burke,370230034
Burke,1886,1281,0.679215270414,276,0.146341463415,14,0.00742311770944,22,0.0116648992577,267,0.141569459173,26,0.0137857900318,283,23,19,279,302,7,0.00371155885472,283,0.150053022269,369,0.195652173913,1517,0.804347826087,1216,0.644750795334,0035,Burke,370230035
Burke,2230,2059,0.92331838565,37,0.0165919282511,5,0.00224215246637,62,0.027802690583,44,0.019730941704,23,0.0103139013453,39,21,21,39,60,2,0.000896860986547,39,0.0174887892377,58,0.0260089686099,2172,0.97399103139,2048,0.918385650224,0036,Burke,370230036
Burke,2711,2231,0.822943563261,175,0.0645518258945,16,0.00590188122464,127,0.0468461822206,144,0.0531169310218,18,0.00663961637772,180,22,22,180,202,5,0.0018443378827,180,0.0663961637772,221,0.0815197344153,2490,0.918480265585,2174,0.801918111398,0038,Burke,370230038
Burke,2558,2014,0.787333854574,324,0.126661454261,8,0.00312744331509,123,0.0480844409695,44,0.017200938233,45,0.0175918686474,340,25,21,336,361,16,0.00625488663018,340,0.132916340891,117,0.0457388584832,2441,0.954261141517,1969,0.769741985927,0039,Burke,370230039
Burke,2050,1786,0.871219512195,124,0.060487804878,11,0.00536585365854,71,0.0346341463415,36,0.0175609756098,22,0.0107317073171,128,22,21,127,149,4,0.0019512195122,128,0.0624390243902,89,0.0434146341463,1961,0.956585365854,1761,0.859024390244,0040,Burke,370230040
Burke,3693,2977,0.806119685892,572,0.154887625237,12,0.00324939073924,50,0.0135391280802,25,0.00676956404008,57,0.0154346060114,609,35,24,598,633,37,0.0100189547793,609,0.164906580016,48,0.0129975629569,3645,0.987002437043,2953,0.799620904414,0047,Burke,370230047
Burke,2034,1829,0.899213372665,139,0.0683382497542,4,0.00196656833825,32,0.015732546706,19,0.00934119960669,11,0.00540806293019,146,5,5,146,151,7,0.00344149459194,146,0.0717797443461,47,0.0231071779744,1987,0.976892822026,1809,0.889380530973,0048,Burke,370230048
Burke,3694,3148,0.852192744992,287,0.0776935571197,9,0.00243638332431,190,0.0514347590688,28,0.00757985923119,32,0.00866269626421,306,26,18,298,324,19,0.00514347590688,306,0.0828370330265,65,0.0175961017867,3629,0.982403898213,3117,0.843800757986,0051,Burke,370230051
Burke,1737,1377,0.79274611399,151,0.0869314910766,7,0.00402993667242,185,0.1065054692,10,0.00575705238918,7,0.00402993667242,154,11,8,151,162,3,0.00172711571675,154,0.0886586067933,29,0.0166954519286,1708,0.983304548071,1364,0.785261945884,0052,Burke,370230052
Burke,2791,2626,0.940881404515,17,0.0060910068076,4,0.00143317807238,91,0.0326048011465,28,0.0100322465066,25,0.00895736295235,23,22,22,23,45,6,0.00214976710856,23,0.00824077391616,46,0.0164815478323,2745,0.983518452168,2614,0.936581870297,0053,Burke,370230053
Burke,930,881,0.947311827957,25,0.0268817204301,1,0.0010752688172,5,0.00537634408602,4,0.00430107526882,14,0.0150537634409,27,10,9,26,36,2,0.00215053763441,27,0.0290322580645,8,0.00860215053763,922,0.991397849462,877,0.943010752688,0062,Burke,370230062
Burke,844,810,0.95971563981,11,0.0130331753555,3,0.00355450236967,8,0.00947867298578,3,0.00355450236967,9,0.010663507109,11,9,9,11,20,0,0.0,11,0.0130331753555,4,0.00473933649289,840,0.995260663507,809,0.958530805687,0064,Burke,370230064
Burke,2704,1663,0.615014792899,925,0.342085798817,4,0.00147928994083,37,0.0136834319527,57,0.0210798816568,18,0.00665680473373,931,15,13,929,944,6,0.00221893491124,931,0.344304733728,75,0.0277366863905,2629,0.972263313609,1650,0.610207100592,0065,Burke,370230065
Burke,2729,2253,0.825577134481,295,0.108098204471,14,0.00513008427996,64,0.0234518138512,77,0.0282154635398,26,0.00952729937706,299,30,30,299,329,4,0.0014657383657,299,0.109563942836,108,0.0395749358739,2621,0.960425064126,2234,0.818614877244,0066,Burke,370230066
Burke,2738,2608,0.952520087655,25,0.009130752374,6,0.00219138056976,21,0.00766983199416,55,0.0200876552228,23,0.00840029218408,31,22,21,30,52,6,0.00219138056976,31,0.0113221329438,71,0.0259313367421,2667,0.974068663258,2592,0.946676406136,0070,Burke,370230070
Cabarrus,2234,2063,0.92345568487,106,0.047448522829,10,0.00447627573859,14,0.00626678603402,22,0.00984780662489,19,0.00850492390331,114,13,13,114,127,8,0.00358102059087,114,0.0510295434199,83,0.0371530886303,2151,0.96284691137,2010,0.899731423456,01-02,Cabarrus,3702501-02
Cabarrus,3457,2598,0.751518657796,658,0.190338443737,9,0.00260341336419,131,0.0378941278565,24,0.00694243563784,37,0.0107029216083,664,29,26,661,690,6,0.00173560890946,664,0.192074052647,80,0.0231414521261,3377,0.976858547874,2546,0.736476713914,01-04,Cabarrus,3702501-04
Cabarrus,2530,1974,0.78023715415,377,0.149011857708,13,0.00513833992095,134,0.0529644268775,8,0.00316205533597,24,0.00948616600791,389,19,14,384,403,12,0.00474308300395,389,0.153754940711,64,0.0252964426877,2466,0.974703557312,1932,0.763636363636,01-06,Cabarrus,3702501-06
Cabarrus,2231,1940,0.869565217391,205,0.0918870461676,7,0.0031376064545,61,0.0273419991035,6,0.002689376961,12,0.00537875392201,210,15,12,207,222,5,0.0022411474675,210,0.0941281936351,44,0.019722097714,2187,0.980277902286,1911,0.85656656208,01-07,Cabarrus,3702501-07
Cabarrus,3085,2453,0.795137763371,466,0.151053484603,16,0.00518638573744,46,0.0149108589951,63,0.0204213938412,41,0.0132901134522,493,29,20,484,513,27,0.00875202593193,493,0.159805510535,179,0.0580226904376,2906,0.941977309562,2350,0.761750405186,01-08,Cabarrus,3702501-08
Cabarrus,968,927,0.957644628099,19,0.0196280991736,7,0.00723140495868,6,0.00619834710744,6,0.00619834710744,3,0.00309917355372,20,8,8,20,28,1,0.00103305785124,20,0.0206611570248,16,0.0165289256198,952,0.98347107438,919,0.949380165289,01-09,Cabarrus,3702501-09
Cabarrus,2838,2349,0.827695560254,302,0.106412966878,14,0.00493305144468,90,0.0317124735729,41,0.0144467935166,42,0.014799154334,316,29,27,314,343,14,0.00493305144468,316,0.111346018323,122,0.0429880197322,2716,0.957011980268,2265,0.798097251586,01-10,Cabarrus,3702501-10
Cabarrus,3342,2670,0.798922800718,438,0.131059245961,9,0.00269299820467,70,0.0209455415919,106,0.0317175344105,49,0.0146618791143,463,33,26,456,489,25,0.00748055056852,463,0.138539796529,238,0.0712148414123,3104,0.928785158588,2564,0.767205266308,02-01,Cabarrus,3702502-01
Cabarrus,4369,3368,0.770885786221,534,0.122224765393,25,0.00572213321126,120,0.0274662394141,283,0.0647745479515,39,0.00892652780957,549,37,33,545,582,15,0.00343327992676,549,0.125658045319,565,0.129320210575,3804,0.870679789425,3121,0.714351110094,02-02,Cabarrus,3702502-02
Cabarrus,5529,4558,0.824380538976,653,0.1181045397,17,0.00307469705191,138,0.0249593054802,106,0.0191716404413,57,0.0103092783505,669,39,36,666,705,16,0.00289383251944,669,0.120998372219,308,0.0557062759993,5221,0.944293724001,4380,0.792186652198,02-03,Cabarrus,3702502-03
Cabarrus,3624,2940,0.811258278146,388,0.10706401766,4,0.00110375275938,112,0.0309050772627,142,0.0391832229581,38,0.0104856512141,395,19,17,393,412,7,0.00193156732892,395,0.108995584989,256,0.0706401766004,3368,0.9293598234,2836,0.782560706402,02-05,Cabarrus,3702502-05
Cabarrus,3846,2728,0.709308372335,727,0.189027561102,21,0.00546021840874,76,0.0197607904316,238,0.061882475299,56,0.0145605824233,751,35,30,746,781,24,0.00624024960998,751,0.195267810712,406,0.105564222569,3440,0.894435777431,2589,0.673166926677,02-06,Cabarrus,3702502-06
Cabarrus,2582,2336,0.904725019365,139,0.0538342370256,5,0.00193648334624,75,0.0290472501936,15,0.00580945003873,12,0.00464756003098,141,12,11,140,152,2,0.000774593338497,141,0.0546088303641,59,0.0228505034857,2523,0.977149496514,2297,0.889620449264,02-07,Cabarrus,3702502-07
Cabarrus,5023,3857,0.767867808083,771,0.153493927932,14,0.00278717897671,260,0.0517618952817,69,0.0137368106709,52,0.0103523790563,798,26,20,792,818,27,0.00537527374079,798,0.158869201672,266,0.0529564005574,4757,0.947043599443,3681,0.732828986661,02-08,Cabarrus,3702502-08
Cabarrus,4395,2995,0.681456200228,850,0.193401592719,7,0.00159271899886,423,0.0962457337884,53,0.0120591581342,67,0.015244596132,873,29,19,863,892,23,0.00523321956769,873,0.198634812287,239,0.0543799772469,4156,0.945620022753,2824,0.642548350398,02-09,Cabarrus,3702502-09
Cabarrus,3463,3062,0.884204447011,271,0.078255847531,10,0.00288766965059,43,0.0124169794975,43,0.0124169794975,34,0.00981807681201,279,29,28,278,307,8,0.00231013572047,279,0.0805659832515,91,0.0262777938204,3372,0.97372220618,3017,0.871209933584,03-00,Cabarrus,3702503-00
Cabarrus,3155,2172,0.688431061807,783,0.248177496038,6,0.00190174326466,27,0.00855784469097,129,0.0408874801902,38,0.0120443740095,803,16,12,799,815,20,0.00633914421553,803,0.254516640254,239,0.0757527733756,2916,0.924247226624,2077,0.658320126783,04-01,Cabarrus,3702504-01
Cabarrus,3012,1847,0.613213811421,864,0.286852589641,12,0.00398406374502,51,0.0169322709163,184,0.0610889774236,54,0.0179282868526,889,26,20,883,909,25,0.00830013280212,889,0.295152722444,340,0.112881806109,2672,0.887118193891,1731,0.574701195219,04-02,Cabarrus,3702504-02
Cabarrus,2945,2000,0.679117147708,745,0.252971137521,9,0.00305602716469,17,0.00577249575552,146,0.0495755517827,28,0.00950764006791,760,22,16,754,776,15,0.00509337860781,760,0.258064516129,192,0.06519524618,2753,0.93480475382,1964,0.666893039049,04-03,Cabarrus,3702504-03
Cabarrus,1584,1012,0.638888888889,503,0.317550505051,1,0.000631313131313,5,0.00315656565657,54,0.0340909090909,9,0.00568181818182,509,5,4,508,513,6,0.00378787878788,509,0.321338383838,84,0.0530303030303,1500,0.94696969697,984,0.621212121212,04-04,Cabarrus,3702504-04
Cabarrus,2201,1646,0.74784189005,377,0.171285779191,10,0.00454338936847,18,0.00817810086324,120,0.0545206724216,30,0.0136301681054,381,24,22,379,403,4,0.00181735574739,381,0.173103134939,227,0.103134938664,1974,0.896865061336,1558,0.707860063607,04-05,Cabarrus,3702504-05
Cabarrus,2540,1591,0.626377952756,591,0.232677165354,13,0.00511811023622,39,0.0153543307087,263,0.103543307087,43,0.0169291338583,611,27,22,606,633,20,0.00787401574803,611,0.240551181102,365,0.143700787402,2175,0.856299212598,1519,0.598031496063,04-06,Cabarrus,3702504-06
Cabarrus,1928,1604,0.831950207469,119,0.0617219917012,1,0.00051867219917,11,0.00570539419087,175,0.0907676348548,18,0.00933609958506,126,3,3,126,129,7,0.00363070539419,126,0.0653526970954,251,0.130186721992,1677,0.869813278008,1536,0.796680497925,04-07,Cabarrus,3702504-07
Cabarrus,1432,1245,0.869413407821,119,0.0831005586592,6,0.00418994413408,11,0.00768156424581,33,0.0230446927374,18,0.0125698324022,124,14,12,122,136,5,0.00349162011173,124,0.0865921787709,68,0.0474860335196,1364,0.95251396648,1218,0.850558659218,04-08,Cabarrus,3702504-08
Cabarrus,2273,1855,0.816102067752,332,0.146062472503,11,0.00483941926969,35,0.0153981522217,26,0.0114386273647,14,0.00615926088869,338,20,17,335,355,6,0.00263968323801,338,0.148702155741,55,0.0241970963484,2218,0.975802903652,1832,0.805983282006,04-09,Cabarrus,3702504-09
Cabarrus,3571,2955,0.827499299916,449,0.125735088211,11,0.00308036964436,53,0.0148417810137,66,0.0184822178661,37,0.0103612433492,460,23,23,460,483,11,0.00308036964436,460,0.128815457855,183,0.0512461495379,3388,0.948753850462,2851,0.798375805097,04-10,Cabarrus,3702504-10
Cabarrus,2923,2683,0.91789257612,155,0.0530277112556,11,0.00376325692781,16,0.00547382825864,31,0.0106055422511,27,0.00923708518645,164,30,26,160,190,9,0.00307902839548,164,0.056106739651,75,0.0256585699624,2848,0.974341430038,2644,0.90455011974,05-00,Cabarrus,3702505-00
Cabarrus,1994,1910,0.957873620863,22,0.0110330992979,6,0.00300902708124,12,0.00601805416249,34,0.0170511534604,10,0.00501504513541,25,11,11,25,36,3,0.00150451354062,25,0.0125376128385,52,0.0260782347041,1942,0.973921765296,1897,0.951354062187,06-00,Cabarrus,3702506-00
Cabarrus,1078,1055,0.97866419295,5,0.00463821892393,9,0.00834879406308,3,0.00278293135436,1,0.000927643784787,5,0.00463821892393,5,12,12,5,17,0,0.0,5,0.00463821892393,10,0.00927643784787,1068,0.990723562152,1048,0.972170686456,07-00,Cabarrus,3702507-00
Cabarrus,4334,4017,0.926857406553,250,0.057683433318,6,0.00138440239963,11,0.00253807106599,29,0.00669127826488,21,0.00484540839871,252,17,17,252,269,2,0.000461467466544,252,0.0581449007845,52,0.0119981541301,4282,0.98800184587,3999,0.922704199354,08-00,Cabarrus,3702508-00
Cabarrus,2630,2505,0.95247148289,55,0.0209125475285,14,0.00532319391635,12,0.00456273764259,27,0.0102661596958,17,0.006463878327,60,25,22,57,82,5,0.00190114068441,60,0.0228136882129,68,0.025855513308,2562,0.974144486692,2468,0.938403041825,09-00,Cabarrus,3702509-00
Cabarrus,4775,4393,0.92,234,0.0490052356021,28,0.00586387434555,36,0.00753926701571,42,0.00879581151832,42,0.00879581151832,242,49,46,239,288,8,0.00167539267016,242,0.0506806282723,118,0.0247120418848,4657,0.975287958115,4332,0.90722513089,10-00,Cabarrus,3702510-00
Cabarrus,5408,3846,0.711168639053,899,0.166235207101,33,0.00610207100592,34,0.00628698224852,493,0.0911612426036,103,0.0190458579882,939,65,54,928,993,40,0.00739644970414,939,0.173631656805,939,0.173631656805,4469,0.826368343195,3484,0.644230769231,11-01,Cabarrus,3702511-01
Cabarrus,3160,2897,0.916772151899,139,0.0439873417722,8,0.00253164556962,20,0.00632911392405,60,0.0189873417722,36,0.0113924050633,161,22,17,156,178,22,0.00696202531646,161,0.0509493670886,121,0.0382911392405,3039,0.961708860759,2846,0.900632911392,11-02,Cabarrus,3702511-02
Cabarrus,716,454,0.634078212291,144,0.201117318436,1,0.00139664804469,1,0.00139664804469,109,0.152234636872,7,0.00977653631285,145,2,2,145,147,1,0.00139664804469,145,0.20251396648,165,0.230446927374,551,0.769553072626,417,0.582402234637,12-01,Cabarrus,3702512-01
Cabarrus,2780,1374,0.494244604317,805,0.289568345324,20,0.00719424460432,16,0.00575539568345,509,0.18309352518,56,0.0201438848921,828,34,30,824,858,23,0.00827338129496,828,0.297841726619,719,0.258633093525,2061,0.741366906475,1217,0.437769784173,12-02,Cabarrus,3702512-02
Cabarrus,2237,1724,0.770675011176,323,0.144389807778,9,0.00402324541797,80,0.0357621814931,80,0.0357621814931,21,0.00938757264193,331,15,14,330,345,8,0.00357621814931,331,0.147966025928,159,0.0710773357175,2078,0.928922664283,1656,0.740277156907,12-03,Cabarrus,3702512-03
Cabarrus,3605,2498,0.692926490985,663,0.183911234397,8,0.00221914008322,25,0.00693481276006,355,0.0984743411928,56,0.0155339805825,693,28,17,682,710,30,0.00832177531207,693,0.192233009709,505,0.140083217753,3100,0.859916782247,2375,0.658807212205,12-04,Cabarrus,3702512-04
Cabarrus,2058,1901,0.92371234208,114,0.0553935860058,5,0.00242954324587,14,0.00680272108844,9,0.00437317784257,15,0.00728862973761,121,8,8,121,129,7,0.00340136054422,121,0.05879494655,51,0.0247813411079,2007,0.975218658892,1859,0.903304178814,12-05,Cabarrus,3702512-05
Cabarrus,1695,1148,0.677286135693,374,0.220648967552,6,0.00353982300885,10,0.00589970501475,136,0.0802359882006,21,0.012389380531,381,13,9,377,390,7,0.00412979351032,381,0.224778761062,243,0.143362831858,1452,0.856637168142,1066,0.628908554572,12-06,Cabarrus,3702512-06
Cabarrus,1620,282,0.174074074074,1143,0.705555555556,5,0.00308641975309,5,0.00308641975309,157,0.0969135802469,28,0.0172839506173,1168,14,6,1160,1174,25,0.0154320987654,1168,0.720987654321,292,0.18024691358,1328,0.81975308642,177,0.109259259259,12-07,Cabarrus,3702512-07
Cabarrus,2209,1474,0.667270258035,383,0.173381620643,10,0.00452693526483,13,0.00588501584427,290,0.13128112268,39,0.0176550475328,398,23,21,396,419,15,0.00679040289724,398,0.18017202354,459,0.207786328656,1750,0.792213671344,1350,0.611136260751,12-08,Cabarrus,3702512-08
Cabarrus,2485,2077,0.835814889336,277,0.111468812877,7,0.00281690140845,20,0.00804828973843,69,0.0277665995976,35,0.0140845070423,289,12,12,289,301,12,0.00482897384306,289,0.11629778672,158,0.0635814889336,2327,0.936418511066,2012,0.809657947686,12-09,Cabarrus,3702512-09
Cabarrus,1112,1040,0.935251798561,33,0.0296762589928,2,0.00179856115108,12,0.0107913669065,15,0.0134892086331,10,0.0089928057554,37,7,5,35,42,4,0.00359712230216,37,0.033273381295,31,0.0278776978417,1081,0.972122302158,1023,0.919964028777,12-10,Cabarrus,3702512-10
Cabarrus,2061,1495,0.725376031053,359,0.174187287724,4,0.00194080543426,26,0.0126152353227,143,0.0693837942746,34,0.0164968461912,368,13,11,366,379,9,0.00436681222707,368,0.178554099951,273,0.132459970888,1788,0.867540029112,1399,0.678796700631,12-11,Cabarrus,3702512-11
Cabarrus,2193,1710,0.77975376197,323,0.147286821705,13,0.00592795257638,16,0.00729594163247,103,0.046967624259,28,0.0127678978568,333,22,20,331,353,10,0.00455996352029,333,0.151846785226,213,0.0971272229822,1980,0.902872777018,1617,0.737346101231,12-12,Cabarrus,3702512-12
Caldwell,4350,3830,0.880459770115,361,0.0829885057471,8,0.00183908045977,20,0.00459770114943,94,0.0216091954023,37,0.00850574712644,371,29,25,367,396,10,0.00229885057471,371,0.0852873563218,136,0.0312643678161,4214,0.968735632184,3802,0.874022988506,PR01,Caldwell,37027PR01
Caldwell,1862,1805,0.969387755102,29,0.015574650913,0,0.0,2,0.00107411385607,16,0.00859291084855,10,0.00537056928034,33,5,4,32,37,4,0.00214822771214,33,0.0177228786251,21,0.0112781954887,1841,0.988721804511,1799,0.966165413534,PR02,Caldwell,37027PR02
Caldwell,3939,3732,0.947448591013,60,0.01523229246,18,0.004569687738,13,0.003300330033,89,0.022594567149,27,0.00685453160701,65,35,34,64,99,5,0.001269357705,65,0.016501650165,168,0.042650418888,3771,0.957349581112,3670,0.931708555471,PR05,Caldwell,37027PR05
Caldwell,2842,2674,0.940886699507,109,0.0383532723434,10,0.00351864883885,8,0.00281491907108,25,0.00879662209711,16,0.00562983814215,111,19,19,111,130,2,0.000703729767769,111,0.0390570021112,65,0.0228712174525,2777,0.977128782548,2640,0.928923293455,PR06,Caldwell,37027PR06
Caldwell,2189,2074,0.947464595706,75,0.0342622201919,4,0.00182731841023,6,0.00274097761535,9,0.00411146642302,21,0.00959342165372,81,19,18,80,99,6,0.00274097761535,81,0.0370031978072,19,0.00867976244861,2170,0.991320237551,2066,0.943809958885,PR07,Caldwell,37027PR07
Caldwell,1349,1288,0.954781319496,53,0.0392883617494,0,0.0,2,0.00148257968866,4,0.00296515937732,2,0.00148257968866,53,2,2,53,55,0,0.0,53,0.0392883617494,9,0.00667160859896,1340,0.993328391401,1283,0.951074870274,PR08,Caldwell,37027PR08
Caldwell,1378,795,0.576923076923,463,0.335994194485,14,0.0101596516691,5,0.00362844702467,80,0.0580551523948,21,0.0152394775036,470,24,21,467,491,7,0.00507982583454,470,0.341074020319,159,0.115384615385,1219,0.884615384615,743,0.539187227866,PR09,Caldwell,37027PR09
Caldwell,2888,2313,0.800900277008,428,0.148199445983,12,0.00415512465374,9,0.0031163434903,102,0.0353185595568,24,0.00831024930748,441,20,20,441,461,13,0.00450138504155,441,0.152700831025,167,0.0578254847645,2721,0.942174515235,2253,0.78012465374,PR12,Caldwell,37027PR12
Caldwell,3531,3461,0.980175587652,3,0.000849617672048,15,0.00424808836024,15,0.00424808836024,11,0.00311526479751,26,0.00736335315775,9,31,31,9,40,6,0.0016992353441,9,0.00254885301614,26,0.00736335315775,3505,0.992636646842,3447,0.976210705183,PR13,Caldwell,37027PR13
Caldwell,3744,3505,0.936164529915,63,0.0168269230769,14,0.00373931623932,18,0.00480769230769,109,0.0291132478632,35,0.00934829059829,70,29,25,66,95,7,0.00186965811966,70,0.0186965811966,211,0.0563568376068,3533,0.943643162393,3428,0.915598290598,PR14,Caldwell,37027PR14
Caldwell,3014,2903,0.963171864632,24,0.00796284007963,6,0.00199071001991,37,0.0122760451228,27,0.00895819508958,17,0.0056403450564,30,14,12,28,42,6,0.00199071001991,30,0.00995355009954,67,0.0222295952223,2947,0.977770404778,2870,0.952222959522,PR15,Caldwell,37027PR15
Caldwell,1985,1440,0.725440806045,404,0.203526448363,3,0.00151133501259,19,0.0095717884131,87,0.0438287153652,32,0.016120906801,418,17,13,414,431,14,0.00705289672544,418,0.210579345088,112,0.0564231738035,1873,0.943576826196,1420,0.715365239295,PR16,Caldwell,37027PR16
Caldwell,2012,1859,0.923956262425,57,0.0283300198807,4,0.00198807157058,21,0.0104373757455,51,0.0253479125249,20,0.00994035785288,65,15,12,62,77,8,0.00397614314115,65,0.0323061630219,83,0.0412524850895,1929,0.958747514911,1832,0.910536779324,PR17,Caldwell,37027PR17
Caldwell,4106,3967,0.966147101802,67,0.0163175840234,5,0.001217730151,35,0.00852411105699,13,0.0031660983926,19,0.00462737457379,73,17,14,70,87,6,0.0014612761812,73,0.0177788602046,48,0.0116902094496,4058,0.98830979055,3936,0.958597174866,PR18,Caldwell,37027PR18
Caldwell,1772,1443,0.814334085779,226,0.127539503386,2,0.00112866817156,3,0.00169300225734,68,0.038374717833,30,0.0169300225734,238,16,12,234,250,12,0.00677200902935,238,0.134311512415,95,0.053611738149,1677,0.946388261851,1423,0.803047404063,PR19,Caldwell,37027PR19
Caldwell,3483,3387,0.972437553833,26,0.00746482917026,14,0.00401952339937,7,0.00200976169968,29,0.00832615561298,20,0.00574217628481,31,26,25,30,56,5,0.0014355440712,31,0.00890037324146,50,0.014355440712,3433,0.985644559288,3365,0.96612115992,PR21,Caldwell,37027PR21
Caldwell,3843,3670,0.954983086131,67,0.0174342961228,12,0.00312256049961,22,0.00572469424928,53,0.0137913088733,19,0.00494405412438,71,22,21,70,92,4,0.00104085349987,71,0.0184751496227,106,0.0275826177466,3737,0.972417382253,3630,0.944574551132,PR22,Caldwell,37027PR22
Caldwell,1925,1879,0.976103896104,21,0.0109090909091,5,0.0025974025974,1,0.000519480519481,6,0.00311688311688,13,0.00675324675325,23,11,11,23,34,2,0.00103896103896,23,0.0119480519481,14,0.00727272727273,1911,0.992727272727,1871,0.971948051948,PR23,Caldwell,37027PR23
Caldwell,2334,2211,0.947300771208,27,0.0115681233933,5,0.00214224507284,7,0.00299914310197,59,0.0252784918595,25,0.0107112253642,28,17,17,28,45,1,0.000428449014567,28,0.0119965724079,113,0.0484147386461,2221,0.951585261354,2162,0.926306769494,PR24,Caldwell,37027PR24
Caldwell,2305,2223,0.96442516269,14,0.0060737527115,7,0.00303687635575,4,0.00173535791757,41,0.0177874186551,16,0.00694143167028,18,16,16,18,34,4,0.00173535791757,18,0.00780911062907,62,0.0268980477223,2243,0.973101952278,2202,0.955314533623,PR25,Caldwell,37027PR25
Caldwell,944,920,0.974576271186,9,0.00953389830508,1,0.0010593220339,1,0.0010593220339,4,0.00423728813559,9,0.00953389830508,10,8,8,10,18,1,0.0010593220339,10,0.010593220339,6,0.00635593220339,938,0.993644067797,918,0.972457627119,PR27,Caldwell,37027PR27
Caldwell,4496,4357,0.969083629893,22,0.00489323843416,6,0.00133451957295,29,0.00645017793594,41,0.00911921708185,41,0.00911921708185,29,34,31,26,60,7,0.00155693950178,29,0.00645017793594,92,0.020462633452,4404,0.979537366548,4315,0.959741992883,PR28,Caldwell,37027PR28
Caldwell,3952,3214,0.813259109312,363,0.0918522267206,21,0.00531376518219,33,0.00835020242915,257,0.0650303643725,64,0.0161943319838,388,42,41,387,429,25,0.00632591093117,388,0.0981781376518,386,0.0976720647773,3566,0.902327935223,3119,0.789220647773,PR29,Caldwell,37027PR29
Camden,2816,2331,0.827769886364,416,0.147727272727,5,0.00177556818182,28,0.00994318181818,4,0.00142045454545,32,0.0113636363636,427,21,17,423,444,11,0.00390625,427,0.151633522727,34,0.0120738636364,2782,0.987926136364,2309,0.819957386364,CH,Camden,37029CH
Camden,1919,1658,0.863991662324,165,0.0859822824388,9,0.00468994267848,54,0.0281396560709,20,0.0104220948411,13,0.00677436164669,168,15,14,167,182,3,0.00156331422616,168,0.0875455966649,37,0.019280875456,1882,0.980719124544,1644,0.856696195935,SH,Camden,37029SH
Camden,2688,2157,0.802455357143,433,0.161086309524,11,0.00409226190476,29,0.0107886904762,20,0.00744047619048,38,0.0141369047619,442,30,28,440,470,9,0.00334821428571,442,0.16443452381,54,0.0200892857143,2634,0.979910714286,2134,0.793898809524,SM,Camden,37029SM
Carteret,1360,1293,0.950735294118,14,0.0102941176471,8,0.00588235294118,14,0.0102941176471,13,0.00955882352941,18,0.0132352941176,15,19,19,15,34,1,0.000735294117647,15,0.0110294117647,21,0.0154411764706,1339,0.984558823529,1287,0.946323529412,ABCH,Carteret,37031ABCH
Carteret,584,569,0.974315068493,1,0.00171232876712,2,0.00342465753425,0,0.0,5,0.00856164383562,7,0.0119863013699,3,5,5,3,8,2,0.00342465753425,3,0.00513698630137,10,0.0171232876712,574,0.982876712329,566,0.969178082192,ATLN,Carteret,37031ATLN
Carteret,2275,2117,0.930549450549,54,0.0237362637363,24,0.0105494505495,12,0.00527472527473,27,0.0118681318681,41,0.018021978022,69,47,44,66,113,15,0.00659340659341,69,0.0303296703297,61,0.0268131868132,2214,0.973186813187,2088,0.917802197802,BCRK,Carteret,37031BCRK
Carteret,343,336,0.979591836735,2,0.00583090379009,1,0.00291545189504,1,0.00291545189504,0,0.0,3,0.00874635568513,2,2,2,2,4,0,0.0,2,0.00583090379009,0,0.0,343,1.0,336,0.979591836735,BETT,Carteret,37031BETT
Carteret,1529,1191,0.778940483976,298,0.194898626553,5,0.00327011118378,11,0.00719424460432,3,0.00196206671027,21,0.0137344669719,307,14,10,303,317,9,0.0058862001308,307,0.200784826684,32,0.0209287115762,1497,0.979071288424,1169,0.764551994768,BFT1,Carteret,37031BFT1
Carteret,3624,3237,0.89321192053,288,0.0794701986755,10,0.00275938189845,25,0.00689845474614,22,0.0060706401766,42,0.0115894039735,300,40,34,294,334,12,0.00331125827815,300,0.0827814569536,64,0.0176600441501,3560,0.98233995585,3196,0.881898454746,BFT2,Carteret,37031BFT2
Carteret,2286,2084,0.911636045494,116,0.0507436570429,15,0.00656167979003,28,0.0122484689414,21,0.00918635170604,22,0.00962379702537,118,27,27,118,145,2,0.00087489063867,118,0.0516185476815,65,0.0284339457568,2221,0.971566054243,2039,0.891951006124,BOGU,Carteret,37031BOGU
Carteret,2645,2552,0.964839319471,21,0.00793950850662,10,0.00378071833648,28,0.0105860113422,18,0.00680529300567,16,0.00604914933837,25,22,20,23,45,4,0.00151228733459,25,0.00945179584121,41,0.0155009451796,2604,0.98449905482,2534,0.958034026465,CCCP,Carteret,37031CCCP
Carteret,251,250,0.996015936255,0,0.0,0,0.0,1,0.00398406374502,0,0.0,0,0.0,0,0,0,0,0,0,0.0,0,0.0,3,0.0119521912351,248,0.988047808765,247,0.98406374502,CDIS,Carteret,37031CDIS
Carteret,352,347,0.985795454545,0,0.0,1,0.00284090909091,1,0.00284090909091,0,0.0,3,0.00852272727273,0,2,2,0,2,0,0.0,0,0.0,0,0.0,352,1.0,347,0.985795454545,DAVI,Carteret,37031DAVI
Carteret,3123,3038,0.972782580852,21,0.00672430355427,7,0.00224143451809,19,0.00608389369196,15,0.00480307396734,23,0.00736471341659,23,17,17,23,40,2,0.000640409862312,23,0.00736471341659,53,0.0169708613513,3070,0.983029138649,2998,0.959974383606,EMIS,Carteret,37031EMIS
Carteret,1055,1041,0.98672985782,0,0.0,3,0.00284360189573,2,0.00189573459716,0,0.0,9,0.0085308056872,0,10,10,0,10,0,0.0,0,0.0,0,0.0,1055,1.0,1041,0.98672985782,HAIS,Carteret,37031HAIS
Carteret,699,671,0.959942775393,10,0.0143061516452,1,0.00143061516452,4,0.00572246065808,7,0.0100143061516,6,0.00858369098712,10,3,3,10,13,0,0.0,10,0.0143061516452,8,0.0114449213162,691,0.988555078684,668,0.9556509299,HARL,Carteret,37031HARL
Carteret,322,319,0.990683229814,1,0.00310559006211,0,0.0,1,0.00310559006211,0,0.0,1,0.00310559006211,1,1,1,1,2,0,0.0,1,0.00310559006211,0,0.0,322,1.0,319,0.990683229814,IBSP,Carteret,37031IBSP
Carteret,452,447,0.988938053097,0,0.0,0,0.0,2,0.00442477876106,0,0.0,3,0.00663716814159,0,2,2,0,2,0,0.0,0,0.0,1,0.00221238938053,451,0.997787610619,446,0.986725663717,MARS,Carteret,37031MARS
Carteret,572,545,0.952797202797,6,0.0104895104895,7,0.0122377622378,3,0.00524475524476,1,0.00174825174825,10,0.0174825174825,9,13,13,9,22,3,0.00524475524476,9,0.0157342657343,10,0.0174825174825,562,0.982517482517,539,0.942307692308,MCRK,Carteret,37031MCRK
Carteret,535,465,0.869158878505,58,0.108411214953,3,0.00560747663551,0,0.0,3,0.00560747663551,6,0.011214953271,58,9,9,58,67,0,0.0,58,0.108411214953,12,0.0224299065421,523,0.977570093458,458,0.856074766355,MERR,Carteret,37031MERR
Carteret,2526,2124,0.840855106888,288,0.114014251781,10,0.00395882818686,40,0.0158353127474,42,0.0166270783848,22,0.00870942201108,299,17,14,296,313,11,0.00435471100554,299,0.118368962787,237,0.0938242280285,2289,0.906175771971,1938,0.767220902613,MHD1,Carteret,37031MHD1
Carteret,3148,2611,0.829415501906,322,0.102287166455,16,0.00508259212198,51,0.0162007623888,81,0.0257306226175,67,0.0212833545108,346,47,35,334,381,24,0.00762388818297,346,0.109911054638,127,0.0403430749682,3021,0.959656925032,2573,0.817344345616,MHD2,Carteret,37031MHD2
Carteret,3265,2976,0.911485451761,167,0.0511485451761,15,0.00459418070444,32,0.00980091883614,39,0.0119448698315,36,0.0110260336907,178,32,30,176,208,11,0.00336906584992,178,0.054517611026,79,0.0241960183767,3186,0.975803981623,2938,0.899846860643,MHD3,Carteret,37031MHD3
Carteret,2545,2453,0.963850687623,19,0.00746561886051,7,0.00275049115914,46,0.0180746561886,6,0.00235756385069,14,0.00550098231827,24,12,11,23,35,5,0.00196463654224,24,0.00943025540275,34,0.0133595284872,2511,0.986640471513,2426,0.953241650295,MHD4,Carteret,37031MHD4
Carteret,4488,3770,0.840017825312,447,0.0995989304813,31,0.0069073083779,73,0.016265597148,81,0.0180481283422,86,0.0191622103387,470,69,62,463,532,23,0.0051247771836,470,0.104723707665,178,0.0396613190731,4310,0.960338680927,3689,0.82196969697,NPT1,Carteret,37031NPT1
Carteret,3076,2798,0.909622886866,143,0.046488946684,22,0.00715214564369,24,0.00780234070221,53,0.0172301690507,36,0.0117035110533,151,34,32,149,183,8,0.00260078023407,151,0.0490897269181,114,0.0370611183355,2962,0.962938881664,2745,0.892392717815,NPT2,Carteret,37031NPT2
Carteret,650,264,0.406153846154,365,0.561538461538,3,0.00461538461538,1,0.00153846153846,9,0.0138461538462,8,0.0123076923077,369,10,7,366,376,4,0.00615384615385,369,0.567692307692,14,0.0215384615385,636,0.978461538462,261,0.401538461538,NRIV,Carteret,37031NRIV
Carteret,1960,1925,0.982142857143,8,0.00408163265306,5,0.00255102040816,5,0.00255102040816,2,0.00102040816327,15,0.00765306122449,8,15,15,8,23,0,0.0,8,0.00408163265306,13,0.00663265306122,1947,0.993367346939,1915,0.977040816327,OTST,Carteret,37031OTST
Carteret,1228,1173,0.955211726384,6,0.00488599348534,7,0.0057003257329,12,0.00977198697068,19,0.0154723127036,11,0.00895765472313,7,11,11,7,18,1,0.000814332247557,7,0.0057003257329,37,0.0301302931596,1191,0.96986970684,1156,0.941368078176,PELE,Carteret,37031PELE
Carteret,1205,1178,0.977593360996,4,0.00331950207469,1,0.000829875518672,11,0.00912863070539,5,0.00414937759336,6,0.00497925311203,4,3,3,4,7,0,0.0,4,0.00331950207469,8,0.00663900414938,1197,0.993360995851,1173,0.973443983402,PKNL,Carteret,37031PKNL
Carteret,468,465,0.99358974359,3,0.00641025641026,0,0.0,0,0.0,0,0.0,0,0.0,3,0,0,3,3,0,0.0,3,0.00641025641026,3,0.00641025641026,465,0.99358974359,462,0.987179487179,SLVL,Carteret,37031SLVL
Carteret,284,281,0.989436619718,1,0.00352112676056,0,0.0,1,0.00352112676056,0,0.0,1,0.00352112676056,1,0,0,1,1,0,0.0,1,0.00352112676056,3,0.0105633802817,281,0.989436619718,279,0.982394366197,SMYR,Carteret,37031SMYR
Carteret,176,172,0.977272727273,0,0.0,0,0.0,0,0.0,3,0.0170454545455,1,0.00568181818182,0,1,1,0,1,0,0.0,0,0.0,5,0.0284090909091,171,0.971590909091,170,0.965909090909,STAC,Carteret,37031STAC
Carteret,1272,1184,0.930817610063,57,0.0448113207547,10,0.00786163522013,5,0.00393081761006,3,0.00235849056604,13,0.0102201257862,59,18,17,58,76,2,0.00157232704403,59,0.0463836477987,27,0.0212264150943,1245,0.978773584906,1164,0.915094339623,STEL,Carteret,37031STEL
Carteret,3966,3539,0.892334846193,233,0.058749369642,28,0.00706001008573,40,0.0100857286939,64,0.0161371659102,62,0.0156328794755,252,52,48,248,300,19,0.0047907211296,252,0.0635400907716,176,0.0443772062532,3790,0.955622793747,3438,0.866868381241,WILD,Carteret,37031WILD
Carteret,331,330,0.996978851964,1,0.00302114803625,0,0.0,0,0.0,0,0.0,0,0.0,1,0,0,1,1,0,0.0,1,0.00302114803625,2,0.00604229607251,329,0.993957703927,328,0.990936555891,WILL,Carteret,37031WILL
Carteret,1299,1137,0.875288683603,131,0.100846805235,6,0.00461893764434,5,0.00384911470362,2,0.00153964588145,18,0.013856812933,135,19,19,135,154,4,0.00307929176289,135,0.103926096998,13,0.0100076982294,1286,0.989992301771,1126,0.866820631255,WIRE,Carteret,37031WIRE
Caswell,894,667,0.746085011186,196,0.219239373602,4,0.00447427293065,2,0.00223713646532,13,0.0145413870246,12,0.0134228187919,197,13,13,197,210,1,0.00111856823266,197,0.220357941834,29,0.0324384787472,865,0.967561521253,653,0.730425055928,ANDE,Caswell,37033ANDE
Caswell,1076,649,0.603159851301,400,0.371747211896,5,0.0046468401487,1,0.00092936802974,18,0.0167286245353,3,0.00278810408922,402,6,5,401,407,2,0.00185873605948,402,0.373605947955,32,0.0297397769517,1044,0.970260223048,637,0.592007434944,HIGH,Caswell,37033HIGH
Caswell,721,425,0.589459084605,281,0.389736477115,1,0.00138696255201,4,0.00554785020804,2,0.00277392510402,8,0.0110957004161,285,7,3,281,288,4,0.00554785020804,285,0.395284327323,8,0.0110957004161,713,0.988904299584,420,0.582524271845,LEAS,Caswell,37033LEAS
Caswell,2380,1166,0.489915966387,1189,0.499579831933,5,0.00210084033613,0,0.0,10,0.00420168067227,10,0.00420168067227,1194,13,9,1190,1203,5,0.00210084033613,1194,0.501680672269,33,0.0138655462185,2347,0.986134453782,1147,0.481932773109,LOCU,Caswell,37033LOCU
Caswell,2256,1098,0.48670212766,1116,0.494680851064,10,0.00443262411348,5,0.00221631205674,10,0.00443262411348,17,0.00753546099291,1126,23,16,1119,1142,10,0.00443262411348,1126,0.499113475177,42,0.0186170212766,2214,0.981382978723,1072,0.475177304965,MILT,Caswell,37033MILT
Caswell,3514,2749,0.782299373933,667,0.189812179852,11,0.00313033579966,17,0.00483779169038,39,0.0110984632897,31,0.0088218554354,674,33,28,669,702,7,0.00199203187251,674,0.191804211725,91,0.0258964143426,3423,0.974103585657,2707,0.770347182698,PELH,Caswell,37033PELH
Caswell,971,812,0.836251287333,129,0.132852729145,2,0.00205973223481,1,0.0010298661174,18,0.0185375901133,9,0.00926879505664,134,4,4,134,138,5,0.00514933058702,134,0.138002059732,22,0.0226570545829,949,0.977342945417,809,0.83316168898,PROS,Caswell,37033PROS
Caswell,914,683,0.747264770241,217,0.237417943107,6,0.00656455142232,2,0.00218818380744,2,0.00218818380744,4,0.00437636761488,217,10,10,217,227,0,0.0,217,0.237417943107,10,0.0109409190372,904,0.989059080963,675,0.738512035011,PROVI,Caswell,37033PROVI
Caswell,2486,1851,0.744569589702,562,0.226065969429,4,0.00160901045857,0,0.0,45,0.0181013676589,24,0.00965406275141,571,10,9,570,580,9,0.00362027353178,571,0.229686242961,76,0.0305711987128,2410,0.969428801287,1828,0.735317779566,STON,Caswell,37033STON
Caswell,2652,1358,0.512066365008,1175,0.443061840121,19,0.00716440422323,13,0.00490196078431,43,0.0162141779789,44,0.0165912518854,1206,37,25,1194,1231,31,0.0116892911011,1206,0.454751131222,107,0.040346907994,2545,0.959653092006,1311,0.494343891403,YAN2,Caswell,37033YAN2
Caswell,966,387,0.400621118012,544,0.56314699793,6,0.00621118012422,1,0.00103519668737,15,0.0155279503106,13,0.0134575569358,556,12,7,551,563,12,0.0124223602484,556,0.575569358178,25,0.0258799171843,941,0.974120082816,380,0.393374741201,YAN4,Caswell,37033YAN4
Catawba,3788,3562,0.940337909187,82,0.0216473072862,20,0.00527983104541,37,0.009767687434,54,0.0142555438226,33,0.00871172122492,86,38,38,86,124,4,0.00105596620908,86,0.0227032734952,102,0.0269271383316,3686,0.973072861668,3526,0.930834213305,01,Catawba,3703501
Catawba,2382,2269,0.952560873216,30,0.0125944584383,4,0.0016792611251,41,0.0172124265323,21,0.0088161209068,17,0.0071368597817,30,17,17,30,47,0,0.0,30,0.0125944584383,34,0.0142737195634,2348,0.985726280437,2256,0.947103274559,02,Catawba,3703502
Catawba,2779,2473,0.889888449082,174,0.0626124505218,11,0.00395825836632,75,0.0269881252249,24,0.00863620007197,22,0.00791651673264,178,22,22,178,200,4,0.00143936667866,178,0.0640518172004,77,0.0277078085642,2702,0.972292191436,2425,0.872616048938,03,Catawba,3703503
Catawba,932,653,0.700643776824,186,0.199570815451,1,0.00107296137339,65,0.0697424892704,17,0.0182403433476,10,0.0107296137339,190,6,4,188,194,4,0.00429184549356,190,0.203862660944,50,0.0536480686695,882,0.94635193133,620,0.665236051502,04,Catawba,3703504
Catawba,3697,3103,0.839329185826,411,0.111171219908,19,0.00513930213687,53,0.014335948066,89,0.0240735731674,22,0.00595077089532,417,28,28,417,445,6,0.00162293751691,417,0.112794157425,147,0.0397619691642,3550,0.960238030836,3060,0.827698133622,05,Catawba,3703505
Catawba,2265,2049,0.904635761589,132,0.0582781456954,6,0.00264900662252,41,0.0181015452539,31,0.0136865342163,6,0.00264900662252,134,8,8,134,142,2,0.000883002207506,134,0.0591611479029,55,0.0242825607064,2210,0.975717439294,2027,0.894922737307,06,Catawba,3703506
Catawba,3639,2746,0.754602912888,451,0.123935147018,4,0.00109920307777,137,0.0376477054136,243,0.0667765869744,58,0.0159384446276,473,25,20,468,493,22,0.00604561692773,473,0.129980763946,499,0.137125583952,3140,0.862874416048,2517,0.691673536686,07,Catawba,3703507
Catawba,2770,2509,0.905776173285,95,0.0342960288809,2,0.00072202166065,87,0.0314079422383,40,0.014440433213,37,0.013357400722,98,17,17,98,115,3,0.00108303249097,98,0.0353790613718,102,0.0368231046931,2668,0.963176895307,2466,0.890252707581,08,Catawba,3703508
Catawba,2712,2511,0.925884955752,111,0.0409292035398,1,0.000368731563422,28,0.0103244837758,39,0.0143805309735,22,0.00811209439528,117,9,6,114,123,6,0.00221238938053,117,0.0431415929204,85,0.0313421828909,2627,0.968657817109,2477,0.913348082596,09,Catawba,3703509
Catawba,744,425,0.57123655914,238,0.319892473118,10,0.0134408602151,7,0.00940860215054,51,0.0685483870968,13,0.0174731182796,242,19,18,241,260,4,0.00537634408602,242,0.325268817204,87,0.116935483871,657,0.883064516129,397,0.533602150538,10,Catawba,3703510
Catawba,1604,1289,0.8036159601,222,0.138403990025,4,0.00249376558603,15,0.00935162094763,45,0.0280548628429,29,0.0180798004988,234,10,9,233,243,12,0.0074812967581,234,0.145885286783,139,0.0866583541147,1465,0.913341645885,1202,0.749376558603,11,Catawba,3703511
Catawba,2013,943,0.468455042226,915,0.454545454545,4,0.0019870839543,58,0.0288127173373,72,0.0357675111773,21,0.0104321907601,928,7,7,928,935,13,0.00645802285147,928,0.461003477397,229,0.113760556384,1784,0.886239443616,798,0.396423248882,12,Catawba,3703512
Catawba,2284,1464,0.640980735552,442,0.193520140105,9,0.00394045534151,76,0.0332749562172,254,0.111208406305,39,0.0170753064799,466,18,15,463,481,24,0.0105078809107,466,0.204028021016,410,0.179509632224,1874,0.820490367776,1329,0.581873905429,13,Catawba,3703513
Catawba,1572,1482,0.942748091603,50,0.0318066157761,2,0.00127226463104,14,0.0089058524173,18,0.0114503816794,6,0.00381679389313,51,4,4,51,55,1,0.000636132315522,51,0.0324427480916,43,0.0273536895674,1529,0.972646310433,1460,0.928753180662,14,Catawba,3703514
Catawba,858,102,0.118881118881,715,0.833333333333,2,0.002331002331,18,0.020979020979,15,0.0174825174825,6,0.00699300699301,721,3,2,720,723,6,0.00699300699301,721,0.840326340326,25,0.0291375291375,833,0.970862470862,93,0.108391608392,15,Catawba,3703515
Catawba,3258,2640,0.810313075506,345,0.105893186004,18,0.00552486187845,65,0.0199508901166,132,0.0405156537753,58,0.0178023327195,372,32,29,369,401,27,0.00828729281768,372,0.114180478821,361,0.11080417434,2897,0.88919582566,2440,0.748925721301,16,Catawba,3703516
Catawba,2444,1878,0.768412438625,264,0.108019639935,7,0.00286415711948,110,0.0450081833061,151,0.0617839607201,34,0.0139116202946,279,18,16,277,295,15,0.00613747954173,279,0.114157119476,245,0.100245499182,2199,0.899754500818,1793,0.733633387889,17,Catawba,3703517
Catawba,1365,1058,0.775091575092,193,0.141391941392,4,0.0029304029304,76,0.0556776556777,17,0.0124542124542,17,0.0124542124542,198,14,14,198,212,5,0.003663003663,198,0.145054945055,64,0.0468864468864,1301,0.953113553114,1012,0.741391941392,19,Catawba,3703519
Catawba,3672,3139,0.854847494553,328,0.0893246187364,20,0.00544662309368,40,0.0108932461874,109,0.0296840958606,36,0.00980392156863,336,31,31,336,367,8,0.00217864923747,336,0.0915032679739,207,0.0563725490196,3465,0.94362745098,3061,0.833605664488,20,Catawba,3703520
Catawba,1909,1784,0.934520691461,77,0.0403352540597,8,0.00419067574646,11,0.00576217915139,20,0.0104766893662,9,0.00471451021477,79,15,14,78,93,2,0.00104766893662,79,0.0413829229963,38,0.0199057097957,1871,0.980094290204,1769,0.926663174437,21,Catawba,3703521
Catawba,4105,3459,0.842630937881,282,0.0686967113276,12,0.00292326431181,181,0.0440925700365,128,0.0311814859927,43,0.0104750304507,296,38,33,291,329,14,0.00341047503045,296,0.0721071863581,259,0.0630937880633,3846,0.936906211937,3336,0.812667478685,22,Catawba,3703522
Catawba,3840,3499,0.911197916667,189,0.04921875,14,0.00364583333333,73,0.0190104166667,27,0.00703125,38,0.00989583333333,209,29,28,208,237,20,0.00520833333333,209,0.0544270833333,85,0.0221354166667,3755,0.977864583333,3447,0.89765625,23,Catawba,3703523
Catawba,4300,3933,0.914651162791,168,0.0390697674419,9,0.00209302325581,110,0.0255813953488,46,0.0106976744186,34,0.00790697674419,175,23,23,175,198,7,0.00162790697674,175,0.0406976744186,98,0.0227906976744,4202,0.977209302326,3883,0.903023255814,24,Catawba,3703524
Catawba,2878,2229,0.774496177901,334,0.116052814454,9,0.00312717164698,64,0.0222376650452,200,0.0694927032662,42,0.0145934676859,347,25,22,344,369,13,0.0045170257123,347,0.120569840167,435,0.151146629604,2443,0.848853370396,2013,0.699444058374,25,Catawba,3703525
Catawba,1809,1660,0.917634051962,78,0.0431177446103,3,0.0016583747927,28,0.0154781647319,23,0.0127142067441,17,0.00939745715865,81,7,6,80,87,3,0.0016583747927,81,0.044776119403,48,0.0265339966833,1761,0.973466003317,1640,0.906578220011,26,Catawba,3703526
Catawba,4442,3936,0.886087348041,155,0.0348941918055,10,0.002251238181,248,0.0558307068888,66,0.0148581719946,27,0.0060783430887,163,25,22,160,185,8,0.0018009905448,163,0.0366951823503,130,0.029266096353,4312,0.970733903647,3882,0.873930661864,27,Catawba,3703527
Catawba,4367,3373,0.772383787497,271,0.0620563315777,21,0.00480879322189,150,0.0343485230135,505,0.115640027479,47,0.0107625372109,278,40,39,277,317,7,0.00160293107396,278,0.0636592626517,804,0.184108083352,3563,0.815891916648,3100,0.709869475613,28,Catawba,3703528
Catawba,2842,2519,0.886347642505,71,0.0249824067558,8,0.00281491907108,54,0.0190007037298,168,0.0591133004926,22,0.00774102744546,76,19,19,76,95,5,0.00175932441942,76,0.0267417311752,252,0.0886699507389,2590,0.911330049261,2435,0.856790992259,29,Catawba,3703529
Catawba,4153,3452,0.83120635685,289,0.0695882494582,18,0.00433421622923,199,0.0479171683121,139,0.0334697808813,56,0.0134842282687,321,27,25,319,346,32,0.00770527329641,321,0.0772935227546,266,0.0640500842764,3887,0.935949915724,3354,0.80760895738,30,Catawba,3703530
Catawba,4193,3899,0.929883138564,205,0.0488910088242,7,0.0016694490818,33,0.00787025995707,20,0.00476985451944,29,0.00691628905318,208,20,20,208,228,3,0.000715478177916,208,0.0496064870021,80,0.0190794180777,4113,0.980920581922,3850,0.918196994992,31,Catawba,3703531
Catawba,3452,2563,0.742468134415,470,0.136152954809,11,0.0031865585168,139,0.0402665121669,217,0.0628621089224,52,0.0150637311703,487,25,23,485,510,17,0.00492468134415,487,0.141077636153,369,0.106894553882,3083,0.893105446118,2443,0.707705677868,32,Catawba,3703532
Catawba,7073,6115,0.864555351336,239,0.0337904708045,29,0.00410009896791,391,0.0552806447052,243,0.0343560016966,56,0.00791743248975,260,44,42,258,302,21,0.00296903718366,260,0.0367595079881,464,0.0656015834865,6609,0.934398416514,5932,0.838682313021,33,Catawba,3703533
Catawba,4915,4423,0.8998982706,188,0.0382502543235,9,0.00183112919634,179,0.0364191251272,85,0.0172939979654,31,0.00630722278739,201,23,18,196,219,13,0.00264496439471,201,0.0408952187182,173,0.0351983723296,4742,0.96480162767,4347,0.884435401831,34,Catawba,3703534
Catawba,3468,2700,0.778546712803,311,0.0896770472895,12,0.00346020761246,181,0.0521914648212,221,0.0637254901961,43,0.012399077278,325,30,25,320,350,14,0.0040369088812,325,0.0937139561707,463,0.133506343714,3005,0.866493656286,2488,0.717416378316,35,Catawba,3703535
Catawba,2296,2070,0.901567944251,112,0.0487804878049,5,0.00217770034843,41,0.0178571428571,44,0.0191637630662,24,0.0104529616725,121,16,11,116,132,9,0.00391986062718,121,0.0527003484321,102,0.044425087108,2194,0.955574912892,2021,0.880226480836,36,Catawba,3703536
Catawba,3049,2407,0.78943916038,340,0.111511971138,3,0.000983929157101,61,0.0200065595277,195,0.0639553952115,43,0.0141029845851,359,16,13,356,372,19,0.0062315513283,359,0.117743522466,441,0.144637586094,2608,0.855362413906,2184,0.716300426369,37,Catawba,3703537
Catawba,2577,2373,0.920838183935,89,0.034536282499,8,0.00310438494373,86,0.0333721381451,19,0.00737291424137,2,0.000776096235933,89,9,9,89,98,0,0.0,89,0.034536282499,57,0.0221187427241,2520,0.977881257276,2335,0.906092355452,38,Catawba,3703538
Catawba,1980,1872,0.945454545455,24,0.0121212121212,2,0.0010101010101,57,0.0287878787879,12,0.00606060606061,13,0.00656565656566,28,2,2,28,30,4,0.0020202020202,28,0.0141414141414,44,0.0222222222222,1936,0.977777777778,1844,0.931313131313,39,Catawba,3703539
Catawba,1961,1531,0.780724120347,319,0.162672106068,5,0.00254971953085,36,0.0183579806221,49,0.0249872514023,21,0.0107088220296,322,13,12,321,334,3,0.00152983171851,322,0.164201937787,171,0.0872004079551,1790,0.912799592045,1433,0.730749617542,40,Catawba,3703540
Catawba,3176,3079,0.969458438287,30,0.00944584382872,6,0.00188916876574,11,0.00346347607053,23,0.00724181360202,27,0.00850125944584,35,18,18,35,53,5,0.00157430730479,35,0.0110201511335,62,0.0195214105793,3114,0.980478589421,3046,0.959068010076,41,Catawba,3703541
Chatham,1969,1650,0.837988826816,252,0.127983748095,5,0.00253936008126,18,0.00914169629253,29,0.0147282884713,15,0.00761808024378,257,12,11,256,268,5,0.00253936008126,257,0.130523108177,53,0.0269172168614,1916,0.973082783139,1627,0.826307770442,15,Chatham,3703715
Chatham,2642,1985,0.751324753974,598,0.226343679031,13,0.00492051476154,4,0.00151400454201,10,0.00378501135503,32,0.0121120363361,610,23,22,609,632,12,0.00454201362604,610,0.230885692657,51,0.0193035579107,2591,0.980696442089,1956,0.740348221045,18,Chatham,3703718
Chatham,1958,1484,0.757916241062,382,0.195097037794,16,0.00817160367722,8,0.00408580183861,45,0.0229826353422,23,0.011746680286,387,34,29,382,416,5,0.00255362614913,387,0.197650663943,75,0.038304392237,1883,0.961695607763,1461,0.746169560776,20,Chatham,3703720
Chatham,1377,1310,0.951343500363,29,0.0210602759622,2,0.00145243282498,6,0.00435729847495,13,0.00944081336238,17,0.0123456790123,35,12,10,33,45,6,0.00435729847495,35,0.0254175744372,44,0.0319535221496,1333,0.96804647785,1281,0.930283224401,21,Chatham,3703721
Chatham,839,816,0.972586412396,12,0.0143027413588,2,0.00238379022646,1,0.00119189511323,6,0.00715137067938,2,0.00238379022646,12,2,2,12,14,0,0.0,12,0.0143027413588,15,0.0178784266985,824,0.982121573302,808,0.96305125149,24,Chatham,3703724
Chatham,2016,1732,0.859126984127,159,0.078869047619,14,0.00694444444444,7,0.00347222222222,86,0.0426587301587,18,0.00892857142857,161,24,24,161,185,2,0.000992063492063,161,0.0798611111111,129,0.0639880952381,1887,0.936011904762,1693,0.839781746032,3,Chatham,370373
Chatham,1680,1360,0.809523809524,248,0.147619047619,1,0.000595238095238,2,0.00119047619048,50,0.0297619047619,19,0.0113095238095,255,6,6,255,261,7,0.00416666666667,255,0.151785714286,79,0.0470238095238,1601,0.952976190476,1340,0.797619047619,30,Chatham,3703730
Chatham,1587,1433,0.902961562697,102,0.0642722117202,8,0.00504095778198,20,0.0126023944549,11,0.00693131695022,13,0.00819155639572,104,13,13,104,117,2,0.00126023944549,104,0.0655324511657,47,0.0296156269691,1540,0.970384373031,1403,0.884057971014,42,Chatham,3703742
Chatham,948,782,0.824894514768,139,0.146624472574,4,0.0042194092827,2,0.00210970464135,16,0.0168776371308,5,0.00527426160338,139,9,9,139,148,0,0.0,139,0.146624472574,30,0.0316455696203,918,0.96835443038,769,0.811181434599,45,Chatham,3703745
Chatham,880,799,0.907954545455,60,0.0681818181818,5,0.00568181818182,7,0.00795454545455,7,0.00795454545455,2,0.00227272727273,61,6,6,61,67,1,0.00113636363636,61,0.0693181818182,12,0.0136363636364,868,0.986363636364,797,0.905681818182,6,Chatham,370376
Chatham,2497,2176,0.871445734882,180,0.0720865038046,6,0.00240288346015,90,0.0360432519023,29,0.0116139367241,16,0.00640768922707,186,8,6,184,192,6,0.00240288346015,186,0.0744893872647,64,0.0256307569083,2433,0.974369243092,2138,0.856227472968,75,Chatham,3703775
Chatham,3908,3692,0.944728761515,84,0.021494370522,8,0.00204708290686,49,0.0125383828045,50,0.0127942681679,25,0.00639713408393,92,20,18,90,110,8,0.00204708290686,92,0.0235414534289,104,0.0266120777892,3804,0.973387922211,3639,0.931166837257,78,Chatham,3703778
Chatham,3853,2357,0.611731118609,683,0.177264469245,37,0.00960290682585,29,0.00752660264729,666,0.172852322865,81,0.0210225798079,709,71,60,698,769,26,0.00674798858033,709,0.184012457825,1155,0.29976641578,2698,0.70023358422,1958,0.508175447703,85,Chatham,3703785
Chatham,1654,1408,0.851269649335,195,0.117896009674,6,0.00362756952842,10,0.00604594921403,17,0.0102781136638,18,0.0108827085852,198,16,14,196,212,3,0.00181378476421,198,0.119709794438,61,0.0368802902056,1593,0.963119709794,1367,0.826481257557,9,Chatham,370379
Chatham,5912,3069,0.519113667118,1354,0.229025710419,71,0.0120094722598,21,0.00355209742896,1281,0.216677943166,116,0.0196211096076,1396,94,91,1393,1487,42,0.00710419485792,1396,0.236129905277,2011,0.340155615697,3901,0.659844384303,2492,0.42151556157,ESC114,Chatham,37037ESC114
Chatham,4227,3714,0.878637331441,327,0.0773598296664,12,0.0028388928318,72,0.0170333569908,64,0.0151407617696,38,0.00898982730069,333,29,28,332,361,6,0.0014194464159,333,0.0787792760823,144,0.0340667139815,4083,0.965933286018,3636,0.860184528034,MCH110,Chatham,37037MCH110
Chatham,5209,4280,0.821654828182,467,0.0896525244769,10,0.00191975427145,131,0.025148780956,268,0.0514494144749,53,0.0101746976387,490,27,18,481,508,23,0.00441543482434,490,0.0940679593012,551,0.105778460357,4658,0.894221539643,4014,0.770589364561,NWM117,Chatham,37037NWM117
Chatham,6508,4773,0.733405039951,1442,0.221573448064,20,0.00307314074985,66,0.0101413644745,151,0.0232022126613,56,0.00860479409957,1463,49,39,1453,1502,21,0.00322679778734,1463,0.224800245851,309,0.0474800245851,6199,0.952519975415,4634,0.712046711739,PIT113,Chatham,37037PIT113
Cherokee,1838,1714,0.932535364527,13,0.00707290533188,16,0.00870511425462,7,0.0038084874864,41,0.0223068552775,47,0.025571273123,14,59,59,14,73,1,0.000544069640914,14,0.0076169749728,83,0.0451577801959,1755,0.954842219804,1684,0.916213275299,ANNW,Cherokee,37039ANNW
Cherokee,1819,1700,0.934579439252,37,0.020340846619,17,0.00934579439252,1,0.000549752611325,14,0.00769653655855,50,0.0274876305662,45,51,51,45,96,8,0.0043980208906,45,0.0247388675096,38,0.0208905992303,1781,0.97910940077,1685,0.926333150082,ANSW,Cherokee,37039ANSW
Cherokee,1101,1047,0.950953678474,1,0.000908265213442,29,0.0263396911898,3,0.00272479564033,2,0.00181653042688,19,0.0172570390554,1,48,48,1,49,0,0.0,1,0.000908265213442,13,0.0118074477748,1088,0.988192552225,1039,0.943687556767,BEAV,Cherokee,37039BEAV
Cherokee,1141,1102,0.965819456617,4,0.00350569675723,5,0.00438212094654,6,0.00525854513585,2,0.00175284837862,22,0.0192813321648,7,25,24,6,31,3,0.00262927256792,7,0.00613496932515,20,0.0175284837862,1121,0.982471516214,1084,0.950043821209,BELL,Cherokee,37039BELL
Cherokee,648,611,0.942901234568,3,0.00462962962963,7,0.0108024691358,9,0.0138888888889,8,0.0123456790123,10,0.0154320987654,5,14,14,5,19,2,0.00308641975309,5,0.00771604938272,13,0.0200617283951,635,0.979938271605,609,0.939814814815,BRAS,Cherokee,37039BRAS
Cherokee,755,729,0.965562913907,1,0.00132450331126,10,0.0132450331126,0,0.0,1,0.00132450331126,14,0.0185430463576,4,22,19,1,23,3,0.00397350993377,4,0.00529801324503,8,0.0105960264901,747,0.98940397351,723,0.95761589404,HANG,Cherokee,37039HANG
Cherokee,1897,1836,0.967843964154,2,0.00105429625725,24,0.012651555087,2,0.00105429625725,2,0.00105429625725,31,0.0163415919873,2,55,55,2,57,0,0.0,2,0.00105429625725,17,0.00896151818661,1880,0.991038481813,1823,0.960991038482,HIWA,Cherokee,37039HIWA
Cherokee,1296,1253,0.966820987654,8,0.00617283950617,3,0.00231481481481,2,0.00154320987654,4,0.00308641975309,26,0.0200617283951,10,22,22,10,32,2,0.00154320987654,10,0.00771604938272,17,0.0131172839506,1279,0.986882716049,1241,0.957561728395,HOTH,Cherokee,37039HOTH
Cherokee,1486,1399,0.941453566622,15,0.0100942126514,27,0.0181695827725,7,0.00471063257066,6,0.00403768506057,32,0.021534320323,16,57,56,15,72,1,0.000672947510094,16,0.0107671601615,18,0.0121130551817,1468,0.987886944818,1395,0.938761776581,MARB,Cherokee,37039MARB
Cherokee,2328,2058,0.884020618557,124,0.053264604811,60,0.0257731958763,19,0.00816151202749,21,0.0090206185567,46,0.0197594501718,137,88,87,136,224,13,0.00558419243986,137,0.0588487972509,54,0.0231958762887,2274,0.976804123711,2029,0.871563573883,MURN,Cherokee,37039MURN
Cherokee,2427,2280,0.939431396786,23,0.00947672023074,45,0.0185414091471,31,0.0127729707458,6,0.00247218788628,42,0.017305315204,24,72,72,24,96,1,0.00041203131438,24,0.00988875154512,51,0.0210135970334,2376,0.978986402967,2245,0.925010300783,MURS,Cherokee,37039MURS
Cherokee,2461,2358,0.958147094677,10,0.00406338886631,21,0.00853311661926,13,0.00528240552621,6,0.00243803331979,53,0.0215359609915,12,66,66,12,78,2,0.000812677773263,12,0.00487606663958,31,0.0125965054856,2430,0.987403494514,2339,0.950426655831,NOTL,Cherokee,37039NOTL
Cherokee,2442,2335,0.956183456183,16,0.00655200655201,31,0.0126945126945,4,0.001638001638,20,0.00819000819001,36,0.014742014742,21,57,55,19,76,5,0.0020475020475,21,0.00859950859951,59,0.0241605241605,2383,0.975839475839,2302,0.94266994267,PCHT,Cherokee,37039PCHT
Cherokee,518,504,0.972972972973,4,0.00772200772201,1,0.0019305019305,0,0.0,1,0.0019305019305,8,0.015444015444,5,7,7,5,12,1,0.0019305019305,5,0.00965250965251,4,0.00772200772201,514,0.992277992278,502,0.969111969112,TOPT,Cherokee,37039TOPT
Chowan,2477,1081,0.436415018167,1300,0.524828421478,2,0.000807428340735,14,0.00565199838514,62,0.0250302785628,18,0.00726685506661,1309,11,11,1309,1320,9,0.00363342753331,1309,0.528461849011,80,0.0322971336294,2397,0.967702866371,1070,0.431974162293,1,Chowan,370411
Chowan,3437,2012,0.585394239162,1333,0.387838231015,12,0.00349141693337,22,0.00640093104452,31,0.00901949374454,27,0.00785568810009,1340,26,20,1334,1360,7,0.0020366598778,1340,0.389874890893,56,0.0162932790224,3381,0.983706720978,1997,0.581029967995,2,Chowan,370412
Chowan,1841,1706,0.926670287887,78,0.0423682781097,11,0.00597501357958,3,0.00162954915807,28,0.0152091254753,15,0.00814774579033,82,21,19,80,101,4,0.00217273221076,82,0.0445410103205,67,0.0363932645301,1774,0.96360673547,1675,0.909831613254,3,Chowan,370413
Chowan,994,520,0.523138832998,433,0.435613682093,7,0.00704225352113,3,0.00301810865191,15,0.0150905432596,16,0.0160965794769,440,13,9,436,449,7,0.00704225352113,440,0.442655935614,23,0.023138832998,971,0.976861167002,516,0.519114688129,4,Chowan,370414
Chowan,1053,807,0.766381766382,204,0.193732193732,1,0.000949667616334,6,0.00569800569801,27,0.025641025641,8,0.00759734093067,204,5,5,204,209,0,0.0,204,0.193732193732,48,0.045584045584,1005,0.954415954416,792,0.752136752137,5,Chowan,370415
Chowan,1674,1245,0.743727598566,401,0.239545997611,3,0.00179211469534,2,0.00119474313023,16,0.00955794504182,7,0.00418160095579,401,9,9,401,410,0,0.0,401,0.239545997611,21,0.0125448028674,1653,0.987455197133,1239,0.740143369176,6,Chowan,370416
Clay,861,846,0.982578397213,3,0.00348432055749,4,0.00464576074332,1,0.00116144018583,5,0.00580720092915,2,0.00232288037166,3,6,6,3,9,0,0.0,3,0.00348432055749,14,0.0162601626016,847,0.983739837398,837,0.97212543554,BRAS,Clay,37043BRAS
Clay,1102,1071,0.971869328494,13,0.0117967332123,3,0.002722323049,0,0.0,4,0.00362976406534,11,0.00998185117967,15,12,12,15,27,2,0.00181488203267,15,0.013611615245,18,0.016333938294,1084,0.983666061706,1057,0.959165154265,HAY1,Clay,37043HAY1
Clay,1476,1429,0.968157181572,7,0.00474254742547,8,0.00542005420054,5,0.00338753387534,20,0.0135501355014,7,0.00474254742547,8,14,14,8,22,1,0.000677506775068,8,0.00542005420054,36,0.0243902439024,1440,0.975609756098,1415,0.958672086721,HAY2,Clay,37043HAY2
Clay,544,527,0.96875,2,0.00367647058824,3,0.00551470588235,0,0.0,5,0.00919117647059,7,0.0128676470588,2,9,9,2,11,0,0.0,2,0.00367647058824,9,0.0165441176471,535,0.983455882353,523,0.961397058824,HAYC,Clay,37043HAYC
Clay,1314,1286,0.978691019787,8,0.00608828006088,3,0.00228310502283,4,0.00304414003044,0,0.0,13,0.00989345509893,8,12,12,8,20,0,0.0,8,0.00608828006088,34,0.0258751902588,1280,0.974124809741,1254,0.954337899543,HIAW,Clay,37043HIAW
Clay,1236,1203,0.973300970874,4,0.00323624595469,3,0.00242718446602,7,0.00566343042071,8,0.00647249190939,11,0.0088996763754,4,9,9,4,13,0,0.0,4,0.00323624595469,17,0.0137540453074,1219,0.986245954693,1197,0.968446601942,SHCR,Clay,37043SHCR
Clay,688,675,0.981104651163,2,0.00290697674419,1,0.00145348837209,1,0.00145348837209,1,0.00145348837209,8,0.0116279069767,3,7,7,3,10,1,0.00145348837209,3,0.00436046511628,10,0.0145348837209,678,0.985465116279,668,0.970930232558,SWEE,Clay,37043SWEE
Clay,624,612,0.980769230769,1,0.00160256410256,1,0.00160256410256,0,0.0,8,0.0128205128205,2,0.00320512820513,1,2,2,1,3,0,0.0,1,0.00160256410256,9,0.0144230769231,615,0.985576923077,611,0.979166666667,TUSQ,Clay,37043TUSQ
Clay,759,739,0.973649538867,4,0.00527009222661,3,0.00395256916996,3,0.00395256916996,1,0.00131752305665,9,0.0118577075099,5,5,5,5,10,1,0.00131752305665,5,0.00658761528327,14,0.0184453227931,745,0.981554677207,728,0.959156785244,WARN,Clay,37043WARN
Cleveland,1957,1691,0.864077669903,192,0.0981093510475,5,0.00255493101686,39,0.0199284619315,14,0.00715380684722,16,0.00817577925396,194,16,15,193,209,2,0.00102197240675,194,0.0991313234543,44,0.0224833929484,1913,0.977516607052,1662,0.849259070005,BETHWR,Cleveland,37045BETHWR
Cleveland,5028,4336,0.862370723946,581,0.115552903739,6,0.00119331742243,25,0.00497215592681,32,0.00636435958632,48,0.00954653937947,609,21,16,604,625,28,0.00556881463803,609,0.121121718377,93,0.0184964200477,4935,0.981503579952,4280,0.85123309467,BSPGS,Cleveland,37045BSPGS
Cleveland,1437,1419,0.987473903967,3,0.00208768267223,5,0.00347947112039,4,0.00278357689631,3,0.00208768267223,3,0.00208768267223,4,6,6,4,10,1,0.000695894224078,4,0.00278357689631,11,0.00765483646486,1426,0.992345163535,1414,0.983994432846,CASAR,Cleveland,37045CASAR
Cleveland,1847,1757,0.951272333514,63,0.0341093665403,6,0.00324851109908,7,0.00378992961559,7,0.00378992961559,7,0.00378992961559,66,11,9,64,75,3,0.00162425554954,66,0.0357336220899,18,0.00974553329724,1829,0.990254466703,1746,0.945316729832,FALSTN,Cleveland,37045FALSTN
Cleveland,3752,3077,0.820095948827,503,0.134061833689,14,0.00373134328358,85,0.0226545842217,41,0.0109275053305,32,0.00852878464819,512,27,26,511,538,9,0.0023987206823,512,0.136460554371,80,0.0213219616205,3672,0.97867803838,3045,0.811567164179,GROVER,Cleveland,37045GROVER
Cleveland,822,768,0.934306569343,43,0.0523114355231,1,0.00121654501217,1,0.00121654501217,4,0.00486618004866,5,0.00608272506083,45,6,4,43,49,2,0.00243309002433,45,0.0547445255474,11,0.0133819951338,811,0.986618004866,761,0.925790754258,H-SPGS,Cleveland,37045H-SPGS
Cleveland,924,417,0.451298701299,486,0.525974025974,2,0.0021645021645,9,0.00974025974026,4,0.004329004329,6,0.00649350649351,490,6,4,488,494,4,0.004329004329,490,0.530303030303,8,0.00865800865801,916,0.991341991342,414,0.448051948052,KINGST,Cleveland,37045KINGST
Cleveland,2872,2238,0.779247910864,564,0.196378830084,6,0.00208913649025,23,0.00800835654596,13,0.00452646239554,28,0.00974930362117,577,21,15,571,592,13,0.00452646239554,577,0.200905292479,27,0.00940111420613,2845,0.990598885794,2228,0.775766016713,KM1,Cleveland,37045KM1
Cleveland,2587,1984,0.766911480479,558,0.215693853885,4,0.00154619250097,18,0.00695786625435,11,0.00425202937766,12,0.0046385775029,563,8,7,562,570,5,0.00193274062621,563,0.217626594511,36,0.0139157325087,2551,0.986084267491,1959,0.757247777348,KM2,Cleveland,37045KM2
Cleveland,2909,2325,0.799243726366,417,0.143348229632,4,0.00137504297009,111,0.0381574424201,25,0.00859401856308,27,0.00928154004813,425,10,9,424,434,8,0.00275008594019,425,0.146098315572,68,0.0233757304916,2841,0.976624269508,2290,0.787212100378,KM3,Cleveland,37045KM3
Cleveland,1735,1256,0.723919308357,423,0.243804034582,8,0.00461095100865,5,0.0028818443804,21,0.0121037463977,22,0.0126801152738,432,24,19,427,451,9,0.00518731988473,432,0.248991354467,35,0.0201729106628,1700,0.979827089337,1244,0.717002881844,KM4,Cleveland,37045KM4
Cleveland,3395,3033,0.893372606775,267,0.0786450662739,5,0.00147275405007,13,0.00382916053019,51,0.0150220913108,26,0.00765832106038,274,19,17,272,291,7,0.0020618556701,274,0.080706921944,131,0.0385861561119,3264,0.961413843888,2958,0.871281296024,LATT,Cleveland,37045LATT
Cleveland,1969,1308,0.664296597257,613,0.311325545962,3,0.00152361604876,1,0.000507872016252,30,0.0152361604876,14,0.00711020822753,618,13,10,615,628,5,0.00253936008126,618,0.313864906044,45,0.0228542407313,1924,0.977145759269,1298,0.659217877095,LAWNDL,Cleveland,37045LAWNDL
Cleveland,1727,1554,0.899826288361,146,0.0845396641575,4,0.0023161551824,3,0.0017371163868,15,0.00868558193399,5,0.002895193978,148,6,5,147,153,2,0.0011580775912,148,0.0856977417487,27,0.0156340474812,1700,0.984365952519,1543,0.89345686161,MRB-YO,Cleveland,37045MRB-YO
Cleveland,2464,2364,0.959415584416,55,0.0223214285714,7,0.00284090909091,5,0.00202922077922,25,0.0101461038961,8,0.00324675324675,56,10,9,55,65,1,0.000405844155844,56,0.0227272727273,68,0.0275974025974,2396,0.972402597403,2323,0.942775974026,MULLS,Cleveland,37045MULLS
Cleveland,3861,3511,0.90934990935,214,0.0554260554261,5,0.001295001295,41,0.010619010619,53,0.013727013727,37,0.00958300958301,225,20,17,222,242,11,0.002849002849,225,0.0582750582751,96,0.024864024864,3765,0.975135975136,3475,0.900025900026,OAKGR,Cleveland,37045OAKGR
Cleveland,2707,2537,0.937199852235,122,0.0450683413373,4,0.00147765053565,5,0.00184706316956,27,0.00997414111563,12,0.00443295160694,125,9,7,123,132,3,0.00110823790174,125,0.046176579239,58,0.0214259327669,2649,0.978574067233,2508,0.926486885851,POLKVL,Cleveland,37045POLKVL
Cleveland,4375,3440,0.786285714286,843,0.192685714286,9,0.00205714285714,11,0.00251428571429,30,0.00685714285714,42,0.0096,853,31,30,852,883,10,0.00228571428571,853,0.194971428571,73,0.0166857142857,4302,0.983314285714,3410,0.779428571429,RIPPY,Cleveland,37045RIPPY
Cleveland,2211,1103,0.498869289914,1051,0.475350520127,7,0.00316598824062,7,0.00316598824062,26,0.0117593848937,17,0.00768882858435,1059,15,12,1056,1071,8,0.00361827227499,1059,0.478968792402,44,0.0199004975124,2167,0.980099502488,1091,0.493441881502,S1,Cleveland,37045S1
Cleveland,3356,2366,0.705005959476,904,0.26936829559,10,0.00297973778308,28,0.00834326579261,26,0.007747318236,22,0.00655542312277,920,20,16,916,936,16,0.00476758045292,920,0.274135876043,86,0.0256257449344,3270,0.974374255066,2313,0.689213349225,S2,Cleveland,37045S2
Cleveland,2209,1312,0.593933906745,831,0.376188320507,11,0.00497962879131,14,0.00633770937076,15,0.00679040289724,26,0.0117700316885,846,24,17,839,863,15,0.00679040289724,846,0.382978723404,62,0.0280669986419,2147,0.971933001358,1267,0.573562698053,S3,Cleveland,37045S3
Cleveland,2483,1372,0.552557390254,1060,0.426902939992,4,0.00161095449054,6,0.0024164317358,19,0.00765203383004,22,0.00886024969795,1069,20,14,1063,1083,9,0.00362464760371,1069,0.430527587596,71,0.028594442207,2412,0.971405557793,1337,0.538461538462,S4,Cleveland,37045S4
Cleveland,2725,1816,0.666422018349,841,0.308623853211,7,0.00256880733945,18,0.00660550458716,28,0.0102752293578,15,0.00550458715596,849,9,9,849,858,8,0.00293577981651,849,0.311559633028,61,0.0223853211009,2664,0.977614678899,1787,0.655779816514,S5,Cleveland,37045S5
Cleveland,3536,2284,0.64592760181,1123,0.317590497738,12,0.00339366515837,20,0.00565610859729,48,0.0135746606335,49,0.0138574660633,1144,36,29,1137,1173,21,0.00593891402715,1144,0.323529411765,110,0.0311085972851,3426,0.968891402715,2238,0.632918552036,S6,Cleveland,37045S6
Cleveland,2967,2097,0.706774519717,772,0.260195483654,6,0.00202224469161,41,0.0138186720593,29,0.0097741826761,22,0.00741489720256,786,13,9,782,795,14,0.00471857094708,786,0.264914054601,90,0.0303336703741,2877,0.969666329626,2051,0.691270643748,S7,Cleveland,37045S7
Cleveland,2511,1734,0.690561529271,682,0.271604938272,8,0.00318598168061,17,0.00677021107129,43,0.0171246515333,27,0.010752688172,693,21,17,689,710,11,0.00438072481083,693,0.275985663082,86,0.0342493030665,2425,0.965750696933,1704,0.678614097969,S8,Cleveland,37045S8
Cleveland,2965,2443,0.823946037099,472,0.159190556492,8,0.0026981450253,9,0.00303541315346,10,0.00337268128162,23,0.00775716694772,483,28,18,473,501,11,0.00370994940978,483,0.162900505902,34,0.0114671163575,2931,0.988532883642,2428,0.818887015177,SHANGI,Cleveland,37045SHANGI
Cleveland,3749,2844,0.758602293945,783,0.208855694852,10,0.00266737796746,33,0.00880234729261,53,0.0141371032275,26,0.00693518271539,793,22,19,790,812,10,0.00266737796746,793,0.211523072819,87,0.0232061883169,3662,0.976793811683,2815,0.750866897839,WACO,Cleveland,37045WACO
Columbus,2138,1428,0.66791393826,573,0.26800748363,58,0.0271281571562,14,0.00654817586529,48,0.022450888681,17,0.00795135640786,585,73,63,575,648,12,0.00561272217025,585,0.2736202058,71,0.033208606174,2067,0.966791393826,1417,0.662768942937,P01,Columbus,37047P01
Columbus,1204,369,0.306478405316,497,0.412790697674,305,0.253322259136,2,0.00166112956811,4,0.00332225913621,27,0.0224252491694,509,321,314,502,823,12,0.00996677740864,509,0.422757475083,24,0.0199335548173,1180,0.980066445183,356,0.295681063123,P02,Columbus,37047P02
Columbus,793,567,0.71500630517,112,0.141235813367,7,0.00882723833544,5,0.0063051702396,85,0.107187894073,17,0.0214375788146,112,18,18,112,130,0,0.0,112,0.141235813367,103,0.129886506936,690,0.870113493064,553,0.697351828499,P03,Columbus,37047P03
Columbus,517,264,0.510638297872,206,0.398452611219,2,0.00386847195358,0,0.0,44,0.0851063829787,1,0.00193423597679,207,2,2,207,209,1,0.00193423597679,207,0.400386847195,46,0.0889748549323,471,0.911025145068,264,0.510638297872,P04,Columbus,37047P04
Columbus,500,410,0.82,41,0.082,0,0.0,0,0.0,47,0.094,2,0.004,41,1,1,41,42,0,0.0,41,0.082,56,0.112,444,0.888,401,0.802,P05,Columbus,37047P05
Columbus,1107,830,0.749774164408,215,0.194218608853,14,0.0126467931346,1,0.000903342366757,32,0.0289069557362,15,0.0135501355014,222,24,20,218,242,7,0.0063233965673,222,0.20054200542,48,0.0433604336043,1059,0.956639566396,815,0.736224028907,P06,Columbus,37047P06
Columbus,3648,2042,0.55975877193,1459,0.399945175439,84,0.0230263157895,6,0.00164473684211,41,0.0112390350877,16,0.00438596491228,1465,97,94,1462,1559,6,0.00164473684211,1465,0.401589912281,82,0.0224780701754,3566,0.977521929825,2018,0.553179824561,P07,Columbus,37047P07
Columbus,521,484,0.928982725528,14,0.0268714011516,5,0.00959692898273,0,0.0,15,0.0287907869482,3,0.00575815738964,14,7,7,14,21,0,0.0,14,0.0268714011516,25,0.0479846449136,496,0.952015355086,475,0.911708253359,P08,Columbus,37047P08
Columbus,1403,767,0.546685673557,580,0.413399857448,4,0.00285103349964,0,0.0,42,0.0299358517463,10,0.00712758374911,586,9,8,585,594,6,0.00427655024947,586,0.417676407698,47,0.0334996436208,1356,0.966500356379,763,0.543834640057,P09,Columbus,37047P09
Columbus,985,938,0.952284263959,15,0.0152284263959,9,0.00913705583756,1,0.0010152284264,17,0.0172588832487,5,0.00507614213198,15,12,12,15,27,0,0.0,15,0.0152284263959,25,0.0253807106599,960,0.97461928934,931,0.945177664975,P10,Columbus,37047P10
Columbus,1693,1056,0.62374483166,513,0.303012404017,36,0.021264028352,10,0.00590667454223,65,0.0383933845245,13,0.0076786769049,518,42,40,516,558,5,0.00295333727112,518,0.305965741288,97,0.0572947430597,1596,0.94270525694,1026,0.606024808033,P11,Columbus,37047P11
Columbus,272,267,0.981617647059,3,0.0110294117647,1,0.00367647058824,0,0.0,0,0.0,1,0.00367647058824,3,1,1,3,4,0,0.0,3,0.0110294117647,0,0.0,272,1.0,267,0.981617647059,P12,Columbus,37047P12
Columbus,824,696,0.844660194175,47,0.0570388349515,2,0.00242718446602,0,0.0,73,0.0885922330097,6,0.00728155339806,47,5,5,47,52,0,0.0,47,0.0570388349515,112,0.135922330097,712,0.864077669903,661,0.802184466019,P13,Columbus,37047P13
Columbus,3605,2174,0.603051317614,1230,0.341192787795,51,0.0141470180305,6,0.00166435506241,103,0.0285714285714,41,0.0113730929265,1251,82,67,1236,1318,21,0.00582524271845,1251,0.347018030513,168,0.0466019417476,3437,0.953398058252,2129,0.590568654646,P14,Columbus,37047P14
Columbus,2533,1564,0.61744966443,925,0.365179628899,26,0.010264508488,1,0.000394788787998,8,0.00315831030399,9,0.00355309909199,931,31,28,928,959,6,0.00236873272799,931,0.367548361627,19,0.00750098697197,2514,0.992499013028,1558,0.615080931702,P15,Columbus,37047P15
Columbus,1677,947,0.564698867024,235,0.140131186643,444,0.264758497317,1,0.000596302921884,21,0.0125223613596,29,0.0172927847346,246,470,461,237,707,11,0.00655933214073,246,0.146690518784,25,0.0149075730471,1652,0.985092426953,946,0.564102564103,P16,Columbus,37047P16
Columbus,1367,545,0.398683247988,661,0.483540599854,89,0.0651060716898,1,0.000731528895391,32,0.0234089246525,39,0.0285296269203,687,122,100,665,787,26,0.0190197512802,687,0.502560351134,56,0.0409656181419,1311,0.959034381858,522,0.381858083394,P17,Columbus,37047P17
Columbus,636,421,0.661949685535,192,0.301886792453,11,0.0172955974843,0,0.0,9,0.0141509433962,3,0.00471698113208,194,14,12,192,206,2,0.00314465408805,194,0.305031446541,14,0.0220125786164,622,0.977987421384,416,0.654088050314,P18,Columbus,37047P18
Columbus,2972,1860,0.625841184388,1006,0.338492597577,24,0.00807537012113,29,0.00975773889637,31,0.0104306864065,22,0.00740242261104,1020,33,27,1014,1047,14,0.00471063257066,1020,0.343203230148,61,0.0205248990579,2911,0.979475100942,1840,0.619111709287,P19,Columbus,37047P19
Columbus,1218,524,0.430213464696,599,0.491789819376,19,0.0155993431856,6,0.00492610837438,45,0.0369458128079,25,0.0205254515599,613,38,29,604,642,14,0.0114942528736,613,0.50328407225,62,0.0509031198686,1156,0.949096880131,512,0.420361247947,P20,Columbus,37047P20
Columbus,1129,815,0.721877767936,254,0.22497785651,17,0.0150575730735,6,0.00531443755536,28,0.0248007085917,9,0.00797165633304,258,23,19,254,277,4,0.00354295837024,258,0.22852081488,34,0.030115146147,1095,0.969884853853,812,0.719220549159,P21,Columbus,37047P21
Columbus,2534,1842,0.726913970008,539,0.21270718232,23,0.00907655880032,11,0.0043409629045,92,0.0363062352013,27,0.0106550907656,549,41,37,545,586,10,0.00394632991318,549,0.216653512234,155,0.0611681136543,2379,0.938831886346,1796,0.708760852407,P22,Columbus,37047P22
Columbus,2216,1366,0.61642599278,777,0.350631768953,28,0.0126353790614,12,0.00541516245487,14,0.00631768953069,19,0.00857400722022,791,40,32,783,823,14,0.00631768953069,791,0.356949458484,40,0.0180505415162,2176,0.981949458484,1346,0.607400722022,P23,Columbus,37047P23
Columbus,2218,1947,0.877817853922,207,0.0933273219116,8,0.00360685302074,3,0.00135256988278,37,0.0166816952209,16,0.00721370604148,210,17,15,208,225,3,0.00135256988278,210,0.0946798917944,66,0.0297565374211,2152,0.970243462579,1920,0.865644724977,P24,Columbus,37047P24
Columbus,1569,1468,0.9356277884,68,0.0433397068196,12,0.00764818355641,2,0.0012746972594,10,0.006373486297,9,0.0057361376673,71,16,16,71,87,3,0.0019120458891,71,0.0452517527087,16,0.0101975780752,1553,0.989802421925,1463,0.932441045252,P25,Columbus,37047P25
Columbus,5287,2659,0.502931719312,2419,0.457537355778,60,0.0113485908833,24,0.00453943635332,79,0.0149423113297,46,0.00870058634386,2433,95,85,2423,2518,14,0.00264800453944,2433,0.460185360318,105,0.0198600340458,5182,0.980139965954,2627,0.496879137507,P26,Columbus,37047P26
Craven,3299,3200,0.969990906335,54,0.0163685965444,5,0.00151561079115,16,0.00484995453168,5,0.00151561079115,19,0.00575932100637,60,12,12,60,72,6,0.00181873294938,60,0.0181873294938,37,0.0112155198545,3262,0.988784480145,3169,0.96059411943,03,Craven,3704903
Craven,889,587,0.660292463442,269,0.302587176603,9,0.0101237345332,11,0.0123734533183,1,0.00112485939258,12,0.0134983127109,277,16,10,271,287,8,0.00899887514061,277,0.311586051744,16,0.0179977502812,873,0.982002249719,575,0.646794150731,04,Craven,3704904
Craven,2699,2429,0.89996294924,209,0.0774360874398,5,0.00185253797703,28,0.0103742126714,7,0.00259355316784,21,0.00778065950352,222,15,10,217,232,13,0.00481659874027,222,0.0822526861801,50,0.0185253797703,2649,0.98147462023,2392,0.88625416821,05,Craven,3704905
Craven,1395,838,0.600716845878,499,0.35770609319,4,0.00286738351254,18,0.0129032258065,19,0.0136200716846,17,0.0121863799283,504,14,12,502,516,5,0.00358422939068,504,0.361290322581,47,0.0336917562724,1348,0.966308243728,819,0.587096774194,06,Craven,3704906
Craven,2527,1669,0.660466956866,777,0.307479224377,13,0.00514444004749,5,0.0019786307875,39,0.0154333201425,24,0.00949742777998,786,25,21,782,807,9,0.00356153541749,786,0.311040759794,71,0.0280965571824,2456,0.971903442818,1644,0.650573802928,07,Craven,3704907
Craven,983,618,0.628687690743,329,0.334689725331,2,0.00203458799593,5,0.00508646998983,12,0.0122075279756,17,0.0172939979654,333,6,6,333,339,4,0.00406917599186,333,0.338758901322,25,0.0254323499491,958,0.974567650051,615,0.625635808749,08,Craven,3704908
Craven,634,356,0.561514195584,272,0.429022082019,1,0.00157728706625,3,0.00473186119874,0,0.0,2,0.00315457413249,272,3,3,272,275,0,0.0,272,0.429022082019,4,0.00630914826498,630,0.993690851735,354,0.558359621451,09,Craven,3704909
Craven,1130,742,0.656637168142,318,0.281415929204,4,0.00353982300885,5,0.00442477876106,52,0.046017699115,9,0.00796460176991,322,7,5,320,327,4,0.00353982300885,322,0.284955752212,83,0.0734513274336,1047,0.926548672566,719,0.636283185841,10,Craven,3704910
Craven,3373,2969,0.880225318707,255,0.0756003557664,16,0.00474355173436,19,0.00563296768455,71,0.0210495108212,43,0.0127482952861,263,40,36,259,299,8,0.00237177586718,263,0.0779721316336,136,0.0403201897421,3237,0.959679810258,2919,0.865401719538,11,Craven,3704911
Craven,559,523,0.935599284436,20,0.0357781753131,5,0.00894454382826,3,0.00536672629696,6,0.0107334525939,2,0.00357781753131,20,7,7,20,27,0,0.0,20,0.0357781753131,17,0.0304114490161,542,0.969588550984,515,0.921288014311,12,Craven,3704912
Craven,851,730,0.857814336075,92,0.108108108108,8,0.00940070505288,1,0.00117508813161,13,0.0152761457109,7,0.00822561692127,94,11,11,94,105,2,0.00235017626322,94,0.110458284371,19,0.0223266745006,832,0.977673325499,724,0.850763807286,13,Craven,3704913
Craven,4655,2884,0.61954887218,1560,0.335123523093,48,0.0103114930183,13,0.00279269602578,85,0.0182599355532,65,0.0139634801289,1591,86,65,1570,1656,31,0.00665950590763,1591,0.341783029001,167,0.0358754027927,4488,0.964124597207,2807,0.603007518797,14,Craven,3704914
Craven,1060,755,0.712264150943,274,0.258490566038,4,0.00377358490566,2,0.00188679245283,16,0.0150943396226,9,0.00849056603774,274,12,12,274,286,0,0.0,274,0.258490566038,49,0.0462264150943,1011,0.953773584906,723,0.682075471698,15,Craven,3704915
Craven,4175,3525,0.844311377246,447,0.107065868263,16,0.00383233532934,46,0.0110179640719,73,0.0174850299401,68,0.0162874251497,472,44,37,465,509,25,0.0059880239521,472,0.113053892216,170,0.0407185628743,4005,0.959281437126,3443,0.824670658683,16,Craven,3704916
Craven,2225,1922,0.863820224719,174,0.078202247191,9,0.00404494382022,63,0.0283146067416,25,0.0112359550562,32,0.0143820224719,184,23,20,181,204,10,0.00449438202247,184,0.0826966292135,100,0.0449438202247,2125,0.955056179775,1850,0.831460674157,17,Craven,3704917
Craven,6051,4050,0.669310857709,1335,0.220624690134,45,0.00743678730788,253,0.0418112708643,187,0.0309039828128,181,0.0299124111717,1410,88,73,1395,1483,75,0.0123946455131,1410,0.233019335647,499,0.0824657081474,5552,0.917534291853,3802,0.628325896546,18,Craven,3704918
Craven,2897,1661,0.573351743183,1115,0.384880911288,12,0.00414221608561,32,0.0110459095616,27,0.00931998619261,50,0.01725923369,1136,38,28,1126,1164,21,0.00724887814981,1136,0.392129789437,81,0.0279599585778,2816,0.972040041422,1612,0.556437694166,19,Craven,3704919
Craven,3148,2991,0.950127064803,112,0.0355781448539,4,0.0012706480305,15,0.00476493011436,12,0.00381194409149,14,0.00444726810673,120,6,6,120,126,8,0.00254129606099,120,0.0381194409149,51,0.0162007623888,3097,0.983799237611,2955,0.938691232529,20,Craven,3704920
Craven,2240,1999,0.892410714286,195,0.0870535714286,1,0.000446428571429,20,0.00892857142857,1,0.000446428571429,24,0.0107142857143,207,5,4,206,211,12,0.00535714285714,207,0.0924107142857,27,0.0120535714286,2213,0.987946428571,1978,0.883035714286,21,Craven,3704921
Craven,10395,8016,0.77113997114,1261,0.121308321308,82,0.00788840788841,334,0.0321308321308,437,0.0420394420394,265,0.025493025493,1363,156,139,1346,1502,102,0.00981240981241,1363,0.131120731121,1192,0.114670514671,9203,0.885329485329,7386,0.710533910534,22,Craven,3704922
Craven,4276,3499,0.818288119738,546,0.127689429373,17,0.00397567820393,96,0.022450888681,72,0.0168381665108,46,0.010757717493,559,34,26,551,585,13,0.00304022450889,559,0.130729653882,194,0.0453695042095,4082,0.95463049579,3398,0.794667913938,23,Craven,3704923
Craven,2648,1364,0.515105740181,1167,0.440709969789,7,0.00264350453172,50,0.0188821752266,30,0.011329305136,30,0.011329305136,1185,19,12,1178,1197,18,0.00679758308157,1185,0.44750755287,82,0.0309667673716,2566,0.969033232628,1328,0.501510574018,N1,Craven,37049N1
Craven,2688,868,0.322916666667,1731,0.643973214286,10,0.00372023809524,19,0.00706845238095,26,0.00967261904762,34,0.0126488095238,1758,25,13,1746,1771,27,0.0100446428571,1758,0.654017857143,67,0.0249255952381,2621,0.975074404762,844,0.313988095238,N2,Craven,37049N2
Craven,2177,1595,0.732659623335,450,0.206706476803,8,0.00367478180983,68,0.0312356453836,25,0.0114836931557,31,0.0142397795131,462,21,18,459,480,12,0.00551217271475,462,0.212218649518,60,0.0275608635737,2117,0.972439136426,1564,0.718419843822,N3,Craven,37049N3
Craven,5124,2967,0.579039812646,1571,0.306596409055,24,0.00468384074941,179,0.0349336455894,271,0.0528883684621,112,0.0218579234973,1606,58,48,1596,1654,35,0.0068306010929,1606,0.313427010148,515,0.100507416081,4609,0.899492583919,2786,0.543715846995,N4,Craven,37049N4
Craven,2417,1140,0.471659081506,1097,0.45386843194,9,0.00372362432768,89,0.0368225072404,52,0.0215142738933,30,0.0124120810923,1112,23,15,1104,1127,15,0.00620604054613,1112,0.460074472487,97,0.0401323955317,2320,0.959867604468,1106,0.457592056268,N5,Craven,37049N5
Craven,4787,3760,0.785460622519,705,0.147273866722,12,0.00250678922081,220,0.0459578023814,52,0.0108627532902,38,0.00793816586589,722,29,22,715,744,17,0.00355128472948,722,0.150825151452,141,0.0294547733445,4646,0.970545226656,3688,0.770419887194,N6,Craven,37049N6
Cumberland,3875,1670,0.430967741935,1774,0.457806451613,42,0.0108387096774,113,0.0291612903226,124,0.032,152,0.0392258064516,1839,91,67,1815,1906,65,0.0167741935484,1839,0.474580645161,376,0.0970322580645,3499,0.902967741935,1505,0.388387096774,AH49,Cumberland,37051AH49
Cumberland,4441,3393,0.764017113263,749,0.168655708174,181,0.0407565863544,32,0.00720558432785,29,0.00653006079712,57,0.012834947084,766,221,210,755,976,17,0.00382796667417,766,0.172483674848,128,0.0288223373114,4313,0.971177662689,3319,0.747354199505,AL51,Cumberland,37051AL51
Cumberland,2622,627,0.239130434783,1870,0.713196033562,40,0.0152555301297,39,0.0148741418764,11,0.00419527078566,35,0.0133485888635,1892,56,46,1882,1938,22,0.00839054157132,1892,0.721586575133,69,0.0263157894737,2553,0.973684210526,589,0.224637681159,CC01,Cumberland,37051CC01
Cumberland,1817,638,0.351128233352,912,0.501926252064,23,0.0126582278481,54,0.0297193175564,134,0.0737479361585,56,0.0308200330215,945,43,30,932,975,33,0.0181618051734,945,0.520088057237,268,0.147495872317,1549,0.852504127683,528,0.290588882774,CC03,Cumberland,37051CC03
Cumberland,1286,976,0.758942457232,242,0.188180404355,8,0.00622083981337,16,0.0124416796267,14,0.0108864696734,30,0.0233281493002,257,24,17,250,274,15,0.0116640746501,257,0.199844479005,59,0.0458786936236,1227,0.954121306376,940,0.730948678072,CC04,Cumberland,37051CC04
Cumberland,2324,434,0.186746987952,1782,0.76678141136,15,0.00645438898451,13,0.00559380378657,37,0.0159208261618,43,0.0185025817556,1814,36,19,1797,1833,32,0.013769363167,1814,0.780550774527,84,0.0361445783133,2240,0.963855421687,407,0.17512908778,CC05,Cumberland,37051CC05
Cumberland,1516,1094,0.721635883905,327,0.215699208443,14,0.00923482849604,30,0.0197889182058,18,0.0118733509235,33,0.0217678100264,342,23,19,338,361,15,0.0098944591029,342,0.225593667546,70,0.0461741424802,1446,0.95382585752,1054,0.695250659631,CC06,Cumberland,37051CC06
Cumberland,1280,1111,0.86796875,114,0.0890625,14,0.0109375,11,0.00859375,15,0.01171875,15,0.01171875,120,19,17,118,137,6,0.0046875,120,0.09375,43,0.03359375,1237,0.96640625,1087,0.84921875,CC07,Cumberland,37051CC07
Cumberland,1311,1041,0.794050343249,227,0.173150266972,8,0.00610221205187,20,0.0152555301297,4,0.00305110602593,11,0.00839054157132,233,14,11,230,244,6,0.0045766590389,233,0.177726926011,30,0.0228832951945,1281,0.977116704805,1018,0.7765064836,CC08,Cumberland,37051CC08
Cumberland,1400,680,0.485714285714,640,0.457142857143,11,0.00785714285714,35,0.025,18,0.0128571428571,16,0.0114285714286,651,15,12,648,663,11,0.00785714285714,651,0.465,61,0.0435714285714,1339,0.956428571429,644,0.46,CC10,Cumberland,37051CC10
Cumberland,1594,1450,0.909661229611,79,0.0495608531995,8,0.00501882057716,36,0.0225846925972,7,0.00439146800502,14,0.00878293601004,82,15,13,80,95,3,0.00188205771644,82,0.0514429109159,57,0.0357590966123,1537,0.964240903388,1408,0.883312421581,CC12,Cumberland,37051CC12
Cumberland,2887,497,0.172151021822,2304,0.798060270177,10,0.00346380325598,5,0.00173190162799,21,0.00727398683755,50,0.0173190162799,2346,33,12,2325,2358,42,0.0145479736751,2346,0.812608243852,63,0.0218219605126,2824,0.978178039487,475,0.164530654659,CC13,Cumberland,37051CC13
Cumberland,3326,2179,0.655141310884,750,0.225496091401,33,0.00992182802165,160,0.0481058328322,100,0.0300661455201,104,0.031268791341,801,66,46,781,847,51,0.0153337342153,801,0.240829825616,258,0.077570655442,3068,0.922429344558,2063,0.620264582081,CC14,Cumberland,37051CC14
Cumberland,3094,2327,0.752100840336,522,0.168713639302,21,0.00678733031674,124,0.0400775694893,44,0.0142210730446,56,0.0180995475113,540,36,30,534,570,18,0.00581771170006,540,0.174531351002,124,0.0400775694893,2970,0.959922430511,2257,0.729476405947,CC15,Cumberland,37051CC15
Cumberland,1931,65,0.0336613153806,1799,0.931641636458,14,0.0072501294666,2,0.00103573278094,11,0.00569653029518,40,0.0207146556189,1832,34,19,1817,1851,33,0.0170895908856,1832,0.948731227343,30,0.0155359917141,1901,0.984464008286,56,0.0290005178664,CC16,Cumberland,37051CC16
Cumberland,2874,489,0.170146137787,2219,0.772094641614,18,0.0062630480167,49,0.0170494084899,43,0.0149617258177,56,0.0194850382742,2265,43,24,2246,2289,46,0.0160055671538,2265,0.788100208768,117,0.0407098121086,2757,0.959290187891,449,0.156228253305,CC17,Cumberland,37051CC17
Cumberland,1762,1300,0.737797956867,313,0.177639046538,22,0.0124858115778,64,0.0363223609535,23,0.0130533484677,40,0.0227014755959,331,45,33,319,364,18,0.0102156640182,331,0.187854710556,70,0.0397275822928,1692,0.960272417707,1268,0.71963677639,CC18,Cumberland,37051CC18
Cumberland,1068,43,0.0402621722846,962,0.90074906367,17,0.0159176029963,6,0.00561797752809,4,0.00374531835206,36,0.0337078651685,991,36,19,974,1010,29,0.0271535580524,991,0.927902621723,18,0.0168539325843,1050,0.983146067416,39,0.0365168539326,CC19,Cumberland,37051CC19
Cumberland,4174,1690,0.404887398179,2094,0.501677048395,44,0.0105414470532,101,0.0241974125539,89,0.0213224724485,156,0.0373742213704,2188,100,69,2157,2257,94,0.0225203641591,2188,0.524197412554,294,0.0704360325827,3880,0.929563967417,1567,0.375419262099,CC21,Cumberland,37051CC21
Cumberland,1993,1229,0.616658304064,499,0.25037631711,21,0.0105368790768,101,0.0506773707978,68,0.0341194179629,75,0.0376317109885,534,39,27,522,561,35,0.0175614651279,534,0.267937782238,227,0.113898645258,1766,0.886101354742,1116,0.559959859508,CC24,Cumberland,37051CC24
Cumberland,2563,1439,0.561451424112,763,0.297698010144,12,0.0046820132657,159,0.0620366757706,98,0.0382364416699,92,0.0358954350371,815,31,19,803,834,52,0.0202887241514,815,0.317986734296,262,0.102223956301,2301,0.897776043699,1314,0.512680452595,CC25,Cumberland,37051CC25
Cumberland,4571,2050,0.448479544957,1920,0.420039378692,29,0.00634434478232,248,0.0542550864144,146,0.0319404944214,178,0.0389411507329,1987,92,61,1956,2048,67,0.0146576241523,1987,0.434697002844,475,0.103915992124,4096,0.896084007876,1828,0.399912491796,CC26,Cumberland,37051CC26
Cumberland,5889,2576,0.437425708949,2467,0.418916624215,58,0.00984887077602,285,0.048395313296,261,0.0443199184921,242,0.0410935642724,2595,125,87,2557,2682,128,0.021735438954,2595,0.440652063169,707,0.120054338597,5182,0.879945661403,2269,0.385294617083,CC27,Cumberland,37051CC27
Cumberland,3235,1526,0.47171561051,1271,0.392890262751,30,0.00927357032457,104,0.0321483771252,188,0.058114374034,116,0.035857805255,1332,64,45,1313,1377,61,0.01885625966,1332,0.411746522411,427,0.13199381762,2808,0.86800618238,1347,0.416383307573,CC29,Cumberland,37051CC29
Cumberland,2706,1465,0.541389504804,875,0.323355506282,61,0.0225424981523,66,0.0243902439024,136,0.050258684405,103,0.0380635624538,920,104,85,901,1005,45,0.0166297117517,920,0.339985218034,271,0.10014781966,2435,0.89985218034,1371,0.506651884701,CC31,Cumberland,37051CC31
Cumberland,1831,616,0.336428181322,930,0.507919169853,11,0.00600764609503,106,0.0578918623703,93,0.0507919169853,75,0.0409612233752,972,38,24,958,996,42,0.0229382850901,972,0.530857454943,204,0.111414527581,1627,0.888585472419,549,0.299836155106,CC32,Cumberland,37051CC32
Cumberland,2762,1298,0.469949312093,1149,0.416002896452,14,0.00506879073135,148,0.05358435916,68,0.0246198406951,85,0.0307748008689,1189,50,33,1172,1222,40,0.0144822592324,1189,0.430485155684,232,0.0839971035482,2530,0.916002896452,1172,0.42433019551,CC33,Cumberland,37051CC33
Cumberland,2273,1523,0.670039595249,370,0.162780466344,21,0.00923889133304,273,0.12010558733,41,0.0180378354597,45,0.0197976242851,388,39,31,380,419,18,0.00791904971403,388,0.170699516058,135,0.0593928728553,2138,0.940607127145,1455,0.640123185218,CC34,Cumberland,37051CC34
Cumberland,6234,2406,0.385948026949,3132,0.502406159769,47,0.00753930060956,212,0.0340070580687,213,0.0341674687199,224,0.0359319858839,3270,121,75,3224,3345,138,0.0221366698749,3270,0.524542829644,765,0.122714148219,5469,0.877285851781,2039,0.327077317934,CL57,Cumberland,37051CL57
Cumberland,2410,1557,0.646058091286,619,0.256846473029,41,0.0170124481328,56,0.0232365145228,55,0.0228215767635,82,0.0340248962656,656,74,63,645,719,37,0.0153526970954,656,0.272199170124,222,0.0921161825726,2188,0.907883817427,1420,0.589211618257,CU02,Cumberland,37051CU02
Cumberland,2815,2122,0.753818827709,564,0.200355239787,47,0.0166962699822,30,0.0106571936057,29,0.0103019538188,23,0.00817051509769,572,61,57,568,629,8,0.00284191829485,572,0.203197158082,72,0.0255772646536,2743,0.974422735346,2089,0.742095914742,EO61-1,Cumberland,37051EO61-1
Cumberland,1990,1289,0.647738693467,594,0.298492462312,34,0.0170854271357,11,0.00552763819095,29,0.0145728643216,33,0.0165829145729,612,61,46,597,658,18,0.00904522613065,612,0.307537688442,59,0.029648241206,1931,0.970351758794,1263,0.634673366834,EO61-2,Cumberland,37051EO61-2
Cumberland,6581,3636,0.552499620119,2324,0.353137821,288,0.043762346148,104,0.0158030694423,96,0.014587448716,133,0.0202096945753,2387,368,335,2354,2722,63,0.00957301321988,2387,0.36271083422,260,0.0395076736058,6321,0.960492326394,3534,0.537000455858,G1,Cumberland,37051G1
Cumberland,10011,6967,0.695934472081,2012,0.200978923184,244,0.0243731894916,293,0.029267805414,207,0.0206772550195,288,0.0287683548097,2092,361,330,2061,2422,80,0.00799120966936,2092,0.208970132854,683,0.0682249525522,9328,0.931775047448,6597,0.65897512736,G10,Cumberland,37051G10
Cumberland,21761,13175,0.605440926428,5509,0.253159321722,267,0.0122696567253,798,0.0366711088645,1114,0.0511925003447,898,0.0412664859152,5917,514,436,5839,6353,408,0.0187491383668,5917,0.271908460089,3086,0.141813335784,18675,0.858186664216,11706,0.537934837553,G11,Cumberland,37051G11
Cumberland,25793,13047,0.50583491645,10602,0.411041755515,218,0.00845190555577,658,0.0255107975032,578,0.0224091807855,690,0.0267514441903,10972,464,329,10837,11301,370,0.0143449773194,10972,0.425386732834,1735,0.0672663125654,24058,0.932733687435,12191,0.472647617571,G2,Cumberland,37051G2
Cumberland,10755,5959,0.554067875407,3669,0.341143654114,373,0.0346815434682,171,0.01589958159,336,0.0312412831241,247,0.0229660622966,3788,492,446,3742,4234,119,0.0110646211065,3788,0.352208275221,817,0.0759646675965,9938,0.924035332404,5605,0.521152952115,G3,Cumberland,37051G3
Cumberland,6648,3893,0.585589651023,1976,0.297232250301,198,0.0297833935018,119,0.0179001203369,257,0.0386582430806,205,0.0308363417569,2058,288,250,2020,2308,82,0.0123345367028,2058,0.309566787004,647,0.0973225030084,6001,0.902677496992,3616,0.543922984356,G4,Cumberland,37051G4
Cumberland,14830,5431,0.366217127444,7835,0.528320971005,142,0.00957518543493,499,0.0336480107889,428,0.0288604180715,495,0.0333782872556,8120,333,213,8000,8333,285,0.0192178017532,8120,0.547538772758,1232,0.0830748482805,13598,0.916925151719,4920,0.331759946055,G5,Cumberland,37051G5
Cumberland,7956,6069,0.762820512821,1397,0.17559074912,223,0.0280291603821,47,0.00590749120161,109,0.0137003519356,111,0.01395173454,1428,305,283,1406,1711,31,0.00389643036702,1428,0.179487179487,217,0.0272750125691,7739,0.972724987431,5986,0.752388134741,G6,Cumberland,37051G6
Cumberland,2735,2104,0.76928702011,496,0.181352833638,48,0.017550274223,19,0.00694698354662,42,0.0153564899452,26,0.00950639853748,500,62,60,498,560,4,0.00146252285192,500,0.18281535649,103,0.0376599634369,2632,0.962340036563,2066,0.755393053016,G7,Cumberland,37051G7
Cumberland,13019,7681,0.589983869729,3787,0.290882556264,259,0.0198940010754,397,0.0304938935402,482,0.037022812812,413,0.0317228665796,3961,404,354,3911,4315,174,0.0133650818035,3961,0.304247638067,1311,0.100698978416,11708,0.899301021584,7082,0.543974191566,G8,Cumberland,37051G8
Cumberland,11325,7206,0.636291390728,2992,0.264194260486,388,0.0342604856512,196,0.0173068432671,256,0.0226048565121,287,0.0253421633554,3114,511,485,3088,3599,122,0.0107726269316,3114,0.274966887417,776,0.0685209713024,10549,0.931479028698,6789,0.599470198675,G9,Cumberland,37051G9
Cumberland,3514,2634,0.749573136027,670,0.190665907797,35,0.00996015936255,64,0.0182128628344,52,0.0147979510529,59,0.0167899829254,694,59,52,687,746,24,0.00682982356289,694,0.19749573136,143,0.0406943653956,3371,0.959305634604,2570,0.731360273193,LI65,Cumberland,37051LI65
Cumberland,4229,1532,0.362260581698,2158,0.51028611965,29,0.00685741310002,160,0.0378340033105,204,0.0482383542209,146,0.0345235280208,2249,76,43,2216,2292,91,0.0215180893828,2249,0.531804209033,533,0.126034523528,3696,0.873965476472,1300,0.307401276898,LR63,Cumberland,37051LR63
Cumberland,2900,1101,0.379655172414,1401,0.483103448276,24,0.00827586206897,84,0.0289655172414,174,0.06,116,0.04,1465,66,40,1439,1505,64,0.0220689655172,1465,0.505172413793,377,0.13,2523,0.87,968,0.333793103448,MB62,Cumberland,37051MB62
Cumberland,3545,1669,0.470803949224,1297,0.3658674189,43,0.0121297602257,251,0.0708039492243,145,0.0409026798307,140,0.0394922425952,1368,74,64,1358,1432,71,0.0200282087447,1368,0.385895627645,436,0.122990126939,3109,0.877009873061,1472,0.415232722144,MR02,Cumberland,37051MR02
Cumberland,2434,1701,0.698849630238,542,0.222678718159,80,0.0328677074774,12,0.00493015612161,71,0.0291700903862,28,0.0115036976171,550,91,90,549,640,8,0.00328677074774,550,0.225965488907,144,0.0591618734593,2290,0.940838126541,1643,0.675020542317,SH77,Cumberland,37051SH77
Currituck,85,85,1.0,0,0.0,0,0.0,0,0.0,0,0.0,0,0.0,0,0,0,0,0,0,0.0,0,0.0,0,0.0,85,1.0,85,1.0,CB,Currituck,37053CB
Currituck,3424,3214,0.938668224299,107,0.03125,16,0.00467289719626,21,0.00613317757009,22,0.00642523364486,44,0.0128504672897,111,39,37,109,148,4,0.00116822429907,111,0.0324182242991,80,0.0233644859813,3344,0.976635514019,3165,0.924357476636,CH,Currituck,37053CH
Currituck,245,239,0.975510204082,1,0.00408163265306,3,0.0122448979592,0,0.0,0,0.0,2,0.00816326530612,1,4,4,1,5,0,0.0,1,0.00408163265306,2,0.00816326530612,243,0.991836734694,238,0.971428571429,CI,Currituck,37053CI
Currituck,977,799,0.81780962129,137,0.14022517912,5,0.00511770726714,6,0.00614124872057,17,0.0174002047083,13,0.0133060388946,143,15,11,139,154,6,0.00614124872057,143,0.14636642784,37,0.0378710337769,940,0.962128966223,783,0.801432958035,CJ,Currituck,37053CJ
Currituck,372,369,0.991935483871,0,0.0,0,0.0,2,0.00537634408602,0,0.0,1,0.00268817204301,0,0,0,0,0,0,0.0,0,0.0,3,0.00806451612903,369,0.991935483871,366,0.983870967742,GW,Currituck,37053GW
Currituck,1061,896,0.844486333648,126,0.118755890669,5,0.00471253534402,6,0.00565504241282,19,0.0179076343073,9,0.00848256361923,129,12,9,126,138,3,0.00282752120641,129,0.121583411876,32,0.0301602262017,1029,0.969839773798,884,0.833176248822,IR,Currituck,37053IR
Currituck,1217,1190,0.977814297453,4,0.00328677074774,3,0.00246507806081,10,0.00821692686935,0,0.0,10,0.00821692686935,4,7,7,4,11,0,0.0,4,0.00328677074774,13,0.0106820049302,1204,0.98931799507,1180,0.969597370583,KI,Currituck,37053KI
Currituck,4615,4086,0.885373781148,362,0.0784398699892,25,0.00541711809317,56,0.0121343445287,32,0.00693391115926,54,0.0117009750813,375,54,47,368,422,13,0.00281690140845,375,0.0812567713976,134,0.0290357529794,4481,0.970964247021,4008,0.868472372698,MY,Currituck,37053MY
Currituck,3800,3516,0.925263157895,175,0.0460526315789,25,0.00657894736842,14,0.00368421052632,31,0.00815789473684,39,0.0102631578947,184,47,39,176,223,9,0.00236842105263,184,0.0484210526316,84,0.0221052631579,3716,0.977894736842,3476,0.914736842105,PB,Currituck,37053PB
Currituck,1730,1565,0.904624277457,134,0.0774566473988,4,0.00231213872832,2,0.00115606936416,9,0.00520231213873,16,0.00924855491329,135,14,14,135,149,1,0.000578034682081,135,0.0780346820809,41,0.0236994219653,1689,0.976300578035,1535,0.887283236994,PP,Currituck,37053PP
Currituck,430,414,0.962790697674,9,0.0209302325581,1,0.00232558139535,3,0.00697674418605,1,0.00232558139535,2,0.0046511627907,9,3,3,9,12,0,0.0,9,0.0209302325581,8,0.0186046511628,422,0.981395348837,407,0.946511627907,WH,Currituck,37053WH
Dare,672,659,0.980654761905,1,0.0014880952381,1,0.0014880952381,0,0.0,5,0.00744047619048,6,0.00892857142857,2,4,4,2,6,1,0.0014880952381,2,0.00297619047619,37,0.0550595238095,635,0.94494047619,628,0.934523809524,AVON,Dare,37055AVON
Dare,1187,1126,0.948609941028,7,0.00589721988206,2,0.0016849199663,0,0.0,35,0.0294860994103,17,0.0143218197136,12,10,9,11,21,5,0.00421229991575,12,0.0101095197978,110,0.0926705981466,1077,0.907329401853,1054,0.887952822241,BUX,Dare,37055BUX
Dare,518,502,0.969111969112,5,0.00965250965251,2,0.003861003861,3,0.00579150579151,2,0.003861003861,4,0.00772200772201,5,6,6,5,11,0,0.0,5,0.00965250965251,11,0.0212355212355,507,0.978764478764,493,0.951737451737,CHCA,Dare,37055CHCA
Dare,3247,3124,0.962118878965,18,0.00554357868802,13,0.00400369571913,25,0.00769941484447,30,0.00923929781337,37,0.0113951339698,23,28,28,23,51,5,0.00153988296889,23,0.00708346165691,117,0.0360332614721,3130,0.963966738528,3049,0.939020634432,COL,Dare,37055COL
Dare,329,321,0.975683890578,0,0.0,1,0.00303951367781,3,0.00911854103343,3,0.00911854103343,1,0.00303951367781,0,1,1,0,1,0,0.0,0,0.0,6,0.0182370820669,323,0.981762917933,318,0.966565349544,DUCK,Dare,37055DUCK
Dare,125,107,0.856,1,0.008,0,0.0,0,0.0,16,0.128,1,0.008,1,1,1,1,2,0,0.0,1,0.008,17,0.136,108,0.864,106,0.848,EL,Dare,37055EL
Dare,742,733,0.987870619946,0,0.0,2,0.00269541778976,1,0.00134770889488,5,0.00673854447439,1,0.00134770889488,0,3,3,0,3,0,0.0,0,0.0,35,0.0471698113208,707,0.952830188679,703,0.9474393531,FRCO,Dare,37055FRCO
Dare,424,416,0.981132075472,1,0.00235849056604,0,0.0,0,0.0,0,0.0,7,0.0165094339623,1,0,0,1,1,0,0.0,1,0.00235849056604,10,0.0235849056604,414,0.97641509434,412,0.971698113208,HAT,Dare,37055HAT
Dare,5320,4829,0.907706766917,61,0.0114661654135,30,0.00563909774436,81,0.0152255639098,240,0.0451127819549,79,0.0148496240602,69,73,73,69,142,8,0.0015037593985,69,0.012969924812,438,0.0823308270677,4882,0.917669172932,4659,0.875751879699,KDH,Dare,37055KDH
Dare,2660,2568,0.965413533835,31,0.0116541353383,3,0.00112781954887,24,0.00902255639098,13,0.00488721804511,21,0.00789473684211,32,18,18,32,50,1,0.000375939849624,32,0.012030075188,74,0.0278195488722,2586,0.972180451128,2511,0.943984962406,KTHK,Dare,37055KTHK
Dare,4748,4066,0.856360572873,451,0.0949873631003,30,0.00631844987363,7,0.00147430497051,119,0.0250631844987,75,0.0157961246841,478,68,57,467,535,27,0.00568660488627,478,0.100673967987,425,0.0895113732098,4323,0.91048862679,3797,0.799705139006,MATO,Dare,37055MATO
Dare,675,619,0.917037037037,4,0.00592592592593,6,0.00888888888889,2,0.00296296296296,35,0.0518518518519,9,0.0133333333333,5,11,11,5,16,1,0.00148148148148,5,0.00740740740741,69,0.102222222222,606,0.897777777778,586,0.868148148148,MH,Dare,37055MH
Dare,2320,2210,0.952586206897,36,0.0155172413793,11,0.00474137931034,8,0.00344827586207,29,0.0125,26,0.0112068965517,43,31,25,37,68,7,0.00301724137931,43,0.0185344827586,65,0.0280172413793,2255,0.971982758621,2175,0.9375,NGHD,Dare,37055NGHD
Dare,2708,2659,0.981905465288,9,0.0033234859675,2,0.000738552437223,16,0.00590841949778,4,0.00147710487445,18,0.00664697193501,13,9,7,11,20,4,0.00147710487445,13,0.00480059084195,34,0.0125553914328,2674,0.987444608567,2632,0.971935007386,SOSH,Dare,37055SOSH
Dare,180,177,0.983333333333,0,0.0,0,0.0,0,0.0,0,0.0,3,0.0166666666667,0,3,3,0,3,0,0.0,0,0.0,0,0.0,180,1.0,177,0.983333333333,STPT,Dare,37055STPT
Dare,1273,1232,0.967792615868,3,0.00235663786332,4,0.00314218381775,2,0.00157109190888,20,0.0157109190888,12,0.00942655145326,7,10,9,6,16,4,0.00314218381775,7,0.00549882168107,43,0.0337784760408,1230,0.966221523959,1211,0.951296150825,WAN,Dare,37055WAN
Davidson,6131,5174,0.843908008481,598,0.0975371065079,26,0.00424074376121,138,0.0225085630403,132,0.0215299298646,63,0.0102756483445,612,55,52,609,664,14,0.00228347740988,612,0.0998205839178,292,0.047626814549,5839,0.952373185451,5036,0.821399445441,02,Davidson,3705702
Davidson,5138,4745,0.923511093811,250,0.0486570650058,22,0.00428182172051,46,0.00895289996107,40,0.00778513040093,35,0.00681198910082,262,34,33,261,295,12,0.00233553912028,262,0.0509926041261,102,0.0198520825224,5036,0.980147917478,4686,0.912028026469,04,Davidson,3705704
Davidson,3538,3334,0.942340305257,62,0.0175240248728,19,0.00537026568683,18,0.00508762012436,81,0.0228942905596,24,0.00678349349915,67,30,30,67,97,5,0.00141322781232,67,0.0189372526851,131,0.0370265686829,3407,0.962973431317,3286,0.928773318259,06,Davidson,3705706
Davidson,1279,1166,0.911649726349,57,0.04456606724,6,0.00469116497263,17,0.0132916340891,17,0.0132916340891,16,0.0125097732604,62,15,15,62,77,5,0.00390930414386,62,0.0484753713839,39,0.0304925723221,1240,0.969507427678,1150,0.899139953088,08,Davidson,3705708
Davidson,2932,2617,0.892564802183,168,0.0572987721692,9,0.00306957708049,61,0.0208049113233,49,0.0167121418827,28,0.00954979536153,170,26,26,170,196,2,0.000682128240109,170,0.0579809004093,88,0.0300136425648,2844,0.969986357435,2586,0.881991814461,10,Davidson,3705710
Davidson,1097,1084,0.988149498633,1,0.000911577028259,1,0.000911577028259,0,0.0,5,0.00455788514129,6,0.00546946216955,1,5,5,1,6,0,0.0,1,0.000911577028259,8,0.00729261622607,1089,0.992707383774,1079,0.983591613491,12,Davidson,3705712
Davidson,2257,2217,0.982277359327,5,0.00221533008418,9,0.00398759415153,8,0.00354452813469,7,0.00310146211786,11,0.0048737261852,7,16,16,7,23,2,0.000886132033673,7,0.00310146211786,25,0.0110766504209,2232,0.988923349579,2201,0.975188303057,14,Davidson,3705714
Davidson,3591,3408,0.949039264829,55,0.0153160679476,16,0.00445558340295,18,0.00501253132832,68,0.0189362294625,26,0.0072403230298,61,35,32,58,93,6,0.00167084377611,61,0.0169869117238,141,0.0392648287385,3450,0.960735171261,3349,0.93260930103,16,Davidson,3705716
Davidson,2108,2074,0.983870967742,7,0.00332068311195,6,0.00284629981025,7,0.00332068311195,8,0.00379506641366,6,0.00284629981025,7,10,10,7,17,0,0.0,7,0.00332068311195,17,0.00806451612903,2091,0.991935483871,2065,0.979601518027,18,Davidson,3705718
Davidson,3065,2992,0.976182707993,23,0.00750407830343,14,0.00456769983687,5,0.00163132137031,16,0.00522022838499,15,0.00489396411093,26,24,24,26,50,3,0.000978792822186,26,0.00848287112561,32,0.01044045677,3033,0.98955954323,2979,0.971941272431,20,Davidson,3705720
Davidson,1411,1266,0.897236002835,56,0.0396881644224,4,0.00283486888731,29,0.020552799433,41,0.029057406095,15,0.0106307583274,58,10,9,57,67,2,0.00141743444366,58,0.0411055988661,48,0.0340184266478,1363,0.965981573352,1260,0.892983699504,22,Davidson,3705722
Davidson,1688,1435,0.850118483412,64,0.0379146919431,12,0.00710900473934,110,0.0651658767773,52,0.0308056872038,15,0.00888625592417,66,17,17,66,83,2,0.00118483412322,66,0.0390995260664,86,0.0509478672986,1602,0.949052132701,1406,0.832938388626,24,Davidson,3705724
Davidson,920,833,0.905434782609,50,0.054347826087,7,0.00760869565217,10,0.0108695652174,17,0.0184782608696,3,0.00326086956522,52,8,8,52,60,2,0.00217391304348,52,0.0565217391304,26,0.0282608695652,894,0.971739130435,826,0.897826086957,26,Davidson,3705726
Davidson,2833,2541,0.896929050477,155,0.0547123190964,16,0.00564772326156,47,0.0165901870808,43,0.0151782562654,31,0.0109424638193,164,32,30,162,194,9,0.00317684433463,164,0.057889163431,90,0.0317684433463,2743,0.968231556654,2505,0.884221673138,28,Davidson,3705728
Davidson,2642,904,0.342165026495,1368,0.517789553369,14,0.00529901589705,54,0.0204390613172,256,0.0968962906889,46,0.0174110522332,1388,37,32,1383,1420,20,0.00757002271007,1388,0.525359576079,408,0.154428463285,2234,0.845571536715,782,0.295987887964,30,Davidson,3705730
Davidson,1955,1260,0.644501278772,409,0.209207161125,11,0.00562659846547,15,0.0076726342711,235,0.120204603581,25,0.0127877237852,414,20,20,414,434,5,0.00255754475703,414,0.211764705882,365,0.186700767263,1590,0.813299232737,1140,0.583120204604,32,Davidson,3705732
Davidson,2358,1577,0.668787107718,342,0.145038167939,20,0.00848176420696,195,0.0826972010178,184,0.078032230704,40,0.0169635284139,357,37,34,354,391,15,0.00636132315522,357,0.151399491094,246,0.104325699746,2112,0.895674300254,1507,0.639100932994,34,Davidson,3705734
Davidson,1777,1195,0.672481710748,370,0.208216094541,10,0.00562746201463,40,0.0225098480585,144,0.0810354530107,18,0.0101294316263,381,19,17,379,398,11,0.00619020821609,381,0.214406302757,181,0.101857062465,1596,0.898142937535,1162,0.6539110861,36,Davidson,3705736
Davidson,2150,852,0.396279069767,931,0.433023255814,16,0.00744186046512,29,0.013488372093,303,0.140930232558,19,0.00883720930233,942,22,18,938,960,11,0.00511627906977,942,0.438139534884,431,0.200465116279,1719,0.799534883721,742,0.34511627907,38,Davidson,3705738
Davidson,2564,1920,0.748829953198,513,0.20007800312,7,0.00273010920437,25,0.0097503900156,81,0.0315912636505,18,0.00702028081123,518,15,15,518,533,5,0.00195007800312,518,0.202028081123,147,0.0573322932917,2417,0.942667706708,1856,0.723868954758,40,Davidson,3705740
Davidson,3011,2925,0.971438060445,18,0.00597808037197,16,0.00531384921953,9,0.00298904018598,32,0.0106276984391,11,0.00365327133843,18,18,18,18,36,0,0.0,18,0.00597808037197,51,0.0169378943872,2960,0.983062105613,2907,0.965459980073,42,Davidson,3705742
Davidson,4007,3463,0.864237584228,467,0.116546044422,9,0.00224606937859,19,0.00474170202146,20,0.00499126528575,29,0.00723733466434,473,25,21,469,494,6,0.00149737958572,473,0.118043424008,54,0.0134764162715,3953,0.986523583728,3438,0.85799850262,44,Davidson,3705744
Davidson,2801,2604,0.929667975723,112,0.0399857193859,10,0.0035701535166,24,0.00856836843984,34,0.0121385219564,17,0.00606926097822,116,19,18,115,134,4,0.00142806140664,116,0.0414137807926,80,0.0285612281328,2721,0.971438771867,2563,0.915030346305,46,Davidson,3705746
Davidson,2925,2778,0.949743589744,71,0.0242735042735,15,0.00512820512821,13,0.00444444444444,29,0.00991452991453,19,0.00649572649573,71,25,25,71,96,0,0.0,71,0.0242735042735,50,0.017094017094,2875,0.982905982906,2756,0.942222222222,48,Davidson,3705748
Davidson,3872,3734,0.964359504132,41,0.0105888429752,18,0.00464876033058,20,0.0051652892562,28,0.00723140495868,31,0.00800619834711,42,36,36,42,78,1,0.00025826446281,42,0.010847107438,63,0.016270661157,3809,0.983729338843,3702,0.956095041322,50,Davidson,3705750
Davidson,4671,4521,0.967886962107,50,0.0107043459645,14,0.00299721687005,40,0.00856347677157,25,0.00535217298223,21,0.00449582530507,54,25,25,54,79,4,0.000856347677157,54,0.0115606936416,81,0.0173410404624,4590,0.982658959538,4474,0.9578248769,52,Davidson,3705752
Davidson,2274,2238,0.984168865435,4,0.00175901495163,4,0.00175901495163,8,0.00351802990325,7,0.00307827616535,13,0.00571679859279,8,10,8,6,16,4,0.00175901495163,8,0.00351802990325,18,0.00791556728232,2256,0.992084432718,2231,0.98109058927,54,Davidson,3705754
Davidson,1404,1373,0.97792022792,1,0.000712250712251,5,0.00356125356125,3,0.00213675213675,8,0.00569800569801,14,0.00997150997151,6,14,9,1,15,5,0.00356125356125,6,0.0042735042735,22,0.0156695156695,1382,0.98433048433,1362,0.970085470085,56,Davidson,3705756
Davidson,3577,3357,0.938495946324,152,0.0424937098127,8,0.00223651104277,21,0.00587084148728,20,0.00559127760693,19,0.00531171372659,153,21,20,152,173,1,0.000279563880347,153,0.042773273693,54,0.0150964495387,3523,0.984903550461,3324,0.929270338272,58,Davidson,3705758
Davidson,5202,4067,0.781814686659,665,0.127835447905,28,0.00538254517493,70,0.0134563629373,292,0.0561322568243,80,0.0153787004998,683,57,52,678,735,18,0.00346020761246,683,0.131295655517,567,0.108996539792,4635,0.891003460208,3833,0.736831987697,60,Davidson,3705760
Davidson,2307,1060,0.459471174686,888,0.384915474642,5,0.00216731686173,26,0.011270047681,287,0.124403987863,41,0.0177719982661,903,29,25,899,928,15,0.00650195058518,903,0.391417425228,429,0.185955786736,1878,0.814044213264,937,0.406155179887,62,Davidson,3705762
Davidson,2227,878,0.394252357432,1121,0.503367759317,12,0.00538841490795,10,0.00449034575662,182,0.0817242927705,24,0.0107768298159,1130,22,18,1126,1148,9,0.00404131118096,1130,0.507409070498,288,0.129321957791,1939,0.870678042209,792,0.355635383925,64,Davidson,3705764
Davidson,2581,1952,0.756296009299,345,0.133669120496,30,0.0116234017823,25,0.00968616815188,189,0.0732274312282,40,0.015497869043,362,48,45,359,407,17,0.00658659434328,362,0.140255714839,348,0.134831460674,2233,0.865168539326,1817,0.703990701279,66,Davidson,3705766
Davidson,3030,2137,0.705280528053,559,0.184488448845,26,0.00858085808581,24,0.00792079207921,243,0.080198019802,41,0.0135313531353,564,42,40,562,604,5,0.0016501650165,564,0.186138613861,432,0.142574257426,2598,0.857425742574,1982,0.654125412541,68,Davidson,3705768
Davidson,2539,2341,0.922016541946,94,0.0370224497834,11,0.00433241433635,29,0.011421819614,46,0.0181173690429,18,0.00708940527767,95,20,20,95,115,1,0.000393855848759,95,0.0374163056321,84,0.0330838912958,2455,0.966916108704,2312,0.910594722332,70,Davidson,3705770
Davidson,2661,2546,0.956783164224,46,0.0172867343104,12,0.00450958286359,15,0.00563697857948,25,0.00939496429914,17,0.00638857572341,51,22,19,48,70,5,0.00187899285983,51,0.0191657271702,78,0.0293122886133,2583,0.970687711387,2498,0.93874483277,72,Davidson,3705772
Davidson,4456,4244,0.952423698384,72,0.016157989228,27,0.0060592459605,17,0.00381508078995,67,0.0150359066427,29,0.00650807899461,75,48,48,75,123,3,0.000673249551167,75,0.0168312387792,119,0.0267055655296,4337,0.97329443447,4201,0.942773788151,74,Davidson,3705774
Davidson,3375,3216,0.952888888889,53,0.0157037037037,22,0.00651851851852,20,0.00592592592593,38,0.0112592592593,26,0.0077037037037,58,35,34,57,92,5,0.00148148148148,58,0.0171851851852,100,0.0296296296296,3275,0.97037037037,3166,0.938074074074,76,Davidson,3705776
Davidson,3794,3568,0.940432261465,103,0.0271481286241,20,0.00527148128624,22,0.00579862941487,52,0.0137058513442,29,0.00764364786505,109,38,35,106,144,6,0.00158144438587,109,0.02872957301,99,0.0260938323669,3695,0.973906167633,3526,0.929362150764,78,Davidson,3705778
Davidson,4234,4085,0.964808691545,32,0.00755786490316,16,0.00377893245158,33,0.00779404818139,42,0.0099196976854,26,0.00614076523382,40,32,30,38,70,8,0.00188946622579,40,0.00944733112896,67,0.015824279641,4167,0.984175720359,4060,0.958904109589,80,Davidson,3705780
Davidson,3023,2858,0.945418458485,53,0.0175322527291,9,0.00297717499173,69,0.0228250082699,19,0.00628514720476,15,0.00496195831955,55,18,18,55,73,2,0.000661594442607,55,0.0181938471717,46,0.01521667218,2977,0.98478332782,2833,0.937148527952,82,Davidson,3705782
Davidson,4601,4282,0.930667246251,193,0.0419474027385,17,0.00369484894588,29,0.00630297761356,43,0.00934579439252,37,0.00804173005868,206,30,28,204,234,13,0.00282547272332,206,0.0447728754619,89,0.019343620952,4512,0.980656379048,4246,0.922842860248,84,Davidson,3705784
Davie,1107,925,0.83559168925,147,0.132791327913,2,0.00180668473351,1,0.000903342366757,23,0.0207768744354,9,0.00813008130081,151,7,6,150,157,4,0.00361336946703,151,0.13640469738,38,0.0343270099368,1069,0.965672990063,915,0.826558265583,01,Davie,3705901
Davie,1335,1186,0.888389513109,69,0.0516853932584,4,0.00299625468165,3,0.00224719101124,58,0.0434456928839,15,0.0112359550562,74,12,11,73,85,5,0.00374531835206,74,0.0554307116105,97,0.07265917603,1238,0.92734082397,1149,0.860674157303,02,Davie,3705902
Davie,2859,2638,0.922700244841,107,0.0374256733123,10,0.00349772647779,2,0.000699545295558,82,0.0286813571179,20,0.00699545295558,113,23,21,111,134,6,0.00209863588667,113,0.039524309199,145,0.0507170339279,2714,0.949282966072,2578,0.901713885974,03,Davie,3705903
Davie,2520,2063,0.818650793651,239,0.0948412698413,8,0.0031746031746,10,0.00396825396825,170,0.0674603174603,30,0.0119047619048,241,24,24,241,265,2,0.000793650793651,241,0.0956349206349,224,0.0888888888889,2296,0.911111111111,2029,0.805158730159,04,Davie,3705904
Davie,2562,2366,0.92349726776,105,0.0409836065574,2,0.000780640124902,15,0.00585480093677,50,0.0195160031226,24,0.00936768149883,108,16,16,108,124,3,0.00117096018735,108,0.0421545667447,79,0.0308352849336,2483,0.969164715066,2345,0.915300546448,05,Davie,3705905
Davie,1783,1645,0.92260235558,95,0.0532809871004,6,0.00336511497476,9,0.00504767246214,13,0.00729108244532,15,0.0084127874369,97,10,10,97,107,2,0.00112170499159,97,0.054402692092,30,0.0168255748738,1753,0.983174425126,1633,0.915872125631,06,Davie,3705906
Davie,2020,1773,0.877722772277,176,0.0871287128713,2,0.000990099009901,5,0.00247524752475,55,0.0272277227723,9,0.00445544554455,178,6,6,178,184,2,0.000990099009901,178,0.0881188118812,83,0.0410891089109,1937,0.958910891089,1746,0.864356435644,07,Davie,3705907
Davie,2321,1656,0.713485566566,416,0.179233089186,14,0.00603188280913,24,0.0103403705299,168,0.0723825937096,43,0.0185264971995,434,39,33,428,467,18,0.00775527789746,434,0.186988367083,268,0.115467470918,2053,0.884532529082,1571,0.676863420939,08,Davie,3705908
Davie,2633,2198,0.834789213825,289,0.109760729206,2,0.000759589821496,10,0.00379794910748,103,0.0391188758071,31,0.0117736422332,301,18,13,296,314,12,0.00455753892898,301,0.114318268135,198,0.0751993923281,2435,0.924800607672,2117,0.804025826054,09,Davie,3705909
Davie,2179,2099,0.963285910968,40,0.0183570445158,14,0.00642496558054,5,0.00229463056448,6,0.00275355667737,15,0.00688389169344,44,23,23,44,67,4,0.00183570445158,44,0.0201927489674,20,0.00917852225792,2159,0.990821477742,2088,0.958237723726,10,Davie,3705910
Davie,1787,1723,0.964185786234,29,0.0162283156128,3,0.00167879127029,2,0.00111919418019,27,0.0151091214326,3,0.00167879127029,30,4,4,30,34,1,0.000559597090095,30,0.0167879127029,42,0.023503077784,1745,0.976496922216,1708,0.955791829882,11,Davie,3705911
Davie,3458,3247,0.938982070561,130,0.0375939849624,10,0.00289184499711,26,0.00751879699248,28,0.0080971659919,17,0.00491613649508,136,17,16,135,152,6,0.00173510699826,136,0.0393290919607,91,0.0263157894737,3367,0.973684210526,3195,0.923944476576,12,Davie,3705912
Davie,2837,2690,0.94818470215,79,0.0278463165315,1,0.000352485019387,47,0.0165667959112,6,0.00211491011632,14,0.00493479027141,80,7,7,80,87,1,0.000352485019387,80,0.0281988015509,44,0.015509340853,2793,0.984490659147,2658,0.93690518153,13,Davie,3705913
Davie,2088,1902,0.91091954023,102,0.0488505747126,11,0.00526819923372,9,0.00431034482759,53,0.0253831417625,11,0.00526819923372,106,16,16,106,122,4,0.00191570881226,106,0.0507662835249,93,0.0445402298851,1995,0.955459770115,1875,0.897988505747,14,Davie,3705914
Duplin,2570,1586,0.617120622568,150,0.0583657587549,15,0.00583657587549,6,0.00233463035019,778,0.302723735409,35,0.0136186770428,156,30,29,155,185,6,0.00233463035019,156,0.0607003891051,1086,0.422568093385,1484,0.577431906615,1334,0.51906614786,ALBE,Duplin,37061ALBE
Duplin,3596,3057,0.850111234705,364,0.101223581758,16,0.00444938820912,9,0.00250278086763,121,0.0336484983315,29,0.00806451612903,375,24,22,373,397,11,0.00305895439377,375,0.104282536151,170,0.0472747497219,3426,0.952725250278,3021,0.840100111235,BEUL,Duplin,37061BEUL
Duplin,1236,829,0.67071197411,224,0.181229773463,10,0.00809061488673,7,0.00566343042071,150,0.121359223301,16,0.0129449838188,235,16,15,234,250,11,0.0088996763754,235,0.190129449838,188,0.152103559871,1048,0.847896440129,804,0.650485436893,CALY,Duplin,37061CALY
Duplin,912,832,0.912280701754,28,0.030701754386,6,0.00657894736842,1,0.00109649122807,40,0.0438596491228,5,0.00548245614035,32,9,7,30,39,4,0.00438596491228,32,0.0350877192982,61,0.0668859649123,851,0.933114035088,815,0.893640350877,CFRK,Duplin,37061CFRK
Duplin,1701,695,0.408583186361,836,0.491475602587,5,0.00293944738389,6,0.00352733686067,147,0.0864197530864,12,0.00705467372134,842,11,7,838,849,6,0.00352733686067,842,0.495002939447,202,0.118753674309,1499,0.881246325691,651,0.382716049383,CHAR,Duplin,37061CHAR
Duplin,1093,860,0.786825251601,194,0.177493138152,2,0.00182982616651,2,0.00182982616651,30,0.0274473924977,5,0.00457456541629,197,4,3,196,200,3,0.00274473924977,197,0.180237877402,46,0.0420860018298,1047,0.95791399817,848,0.775846294602,CHIN,Duplin,37061CHIN
Duplin,1544,1347,0.872409326425,161,0.104274611399,2,0.00129533678756,1,0.000647668393782,26,0.0168393782383,7,0.00453367875648,162,9,8,161,170,1,0.000647668393782,162,0.104922279793,42,0.0272020725389,1502,0.972797927461,1330,0.861398963731,CYRK,Duplin,37061CYRK
Duplin,2298,1163,0.506092254134,702,0.305483028721,11,0.00478677110531,8,0.00348128807659,384,0.167101827676,30,0.0130548302872,713,20,16,709,729,11,0.00478677110531,713,0.310269799826,477,0.207571801567,1821,0.792428198433,1087,0.473020017406,FAIS,Duplin,37061FAIS
Duplin,1258,905,0.719395866455,71,0.0564387917329,4,0.00317965023847,5,0.00397456279809,254,0.201907790143,19,0.0151033386328,73,5,5,73,78,2,0.00158982511924,73,0.0580286168521,344,0.273449920509,914,0.726550079491,835,0.663751987281,GLIS,Duplin,37061GLIS
Duplin,1658,1100,0.663449939686,427,0.25753920386,4,0.00241254523522,5,0.00301568154403,105,0.0633293124246,17,0.0102533172497,428,15,15,428,443,1,0.000603136308806,428,0.258142340169,135,0.0814234016888,1523,0.918576598311,1085,0.654402895054,HALL,Duplin,37061HALL
Duplin,4303,2133,0.495700673948,1732,0.40250987683,34,0.00790146409482,11,0.00255635603068,366,0.0850569370207,27,0.0062746920753,1741,51,46,1736,1787,9,0.0020915640251,1741,0.404601440855,467,0.108528933302,3836,0.891471066698,2054,0.477341389728,KENA,Duplin,37061KENA
Duplin,651,523,0.803379416283,84,0.129032258065,4,0.00614439324117,0,0.0,29,0.0445468509985,11,0.0168970814132,85,12,12,85,97,1,0.00153609831029,85,0.130568356375,61,0.0937019969278,590,0.906298003072,500,0.768049155146,LOCK,Duplin,37061LOCK
Duplin,2179,890,0.408444240477,705,0.323542909592,10,0.00458926112896,4,0.00183570445158,543,0.249196879302,27,0.0123910050482,717,22,15,710,732,12,0.00550711335475,717,0.329050022946,691,0.317117944011,1488,0.682882055989,757,0.347407067462,MAGN,Duplin,37061MAGN
Duplin,1214,672,0.553542009885,424,0.349258649094,4,0.00329489291598,3,0.00247116968699,99,0.0815485996705,12,0.00988467874794,429,11,8,426,437,5,0.00411861614498,429,0.353377265239,127,0.104612850082,1087,0.895387149918,647,0.53294892916,ROCK,Duplin,37061ROCK
Duplin,2546,1346,0.528672427337,841,0.330322073841,12,0.00471327572663,12,0.00471327572663,311,0.122152395915,24,0.00942655145326,847,22,21,846,868,6,0.00235663786332,847,0.332678711705,426,0.167321288295,2120,0.832678711705,1252,0.491751767478,ROSE,Duplin,37061ROSE
Duplin,1538,1189,0.773081924577,227,0.147594278283,7,0.00455136540962,3,0.00195058517555,105,0.0682704811443,7,0.00455136540962,229,10,9,228,238,2,0.00130039011704,229,0.148894668401,142,0.0923276983095,1396,0.907672301691,1156,0.751625487646,SMCA,Duplin,37061SMCA
Duplin,5837,3300,0.565358917252,1784,0.305636457084,15,0.00256981326024,27,0.00462566386843,659,0.112900462566,52,0.00890868596882,1800,35,31,1796,1831,16,0.00274113414425,1800,0.308377591228,892,0.152818228542,4945,0.847181771458,3117,0.534007195477,WALL,Duplin,37061WALL
Duplin,4543,1799,0.395993836672,2192,0.482500550297,19,0.00418225841955,23,0.00506273387629,462,0.101694915254,48,0.010565705481,2216,41,29,2204,2245,24,0.00528285274048,2216,0.487783403038,626,0.137794408981,3917,0.862205591019,1666,0.366718027735,WARS,Duplin,37061WARS
Duplin,2958,2059,0.696078431373,175,0.0591615956728,16,0.00540906017579,34,0.0114942528736,625,0.211291413117,49,0.0165652467884,182,31,29,180,211,7,0.00236646382691,182,0.0615280594997,850,0.287356321839,2108,0.712643678161,1899,0.641987829615,WOLF,Duplin,37061WOLF
Durham,1808,827,0.457411504425,571,0.315818584071,22,0.0121681415929,28,0.0154867256637,334,0.184734513274,26,0.0143805309735,584,35,29,578,613,13,0.00719026548673,584,0.323008849558,607,0.335730088496,1201,0.664269911504,591,0.326880530973,01,Durham,3706301
Durham,4258,2346,0.550962893377,980,0.230155002349,10,0.00234852043213,504,0.118365429779,333,0.0782057303899,85,0.0199624236731,1014,28,18,1004,1032,34,0.00798496946923,1014,0.238139971818,562,0.131986848286,3696,0.868013151714,2133,0.500939408173,02,Durham,3706302
Durham,2030,1617,0.796551724138,142,0.0699507389163,4,0.00197044334975,112,0.0551724137931,104,0.0512315270936,51,0.0251231527094,158,15,9,152,167,16,0.00788177339901,158,0.0778325123153,205,0.100985221675,1825,0.899014778325,1529,0.753201970443,03,Durham,3706303
Durham,1425,1236,0.867368421053,87,0.0610526315789,5,0.00350877192982,48,0.0336842105263,32,0.0224561403509,17,0.0119298245614,93,8,7,92,100,6,0.00421052631579,93,0.0652631578947,52,0.0364912280702,1373,0.96350877193,1213,0.851228070175,04,Durham,3706304
Durham,8984,3805,0.423530721282,2158,0.240204808549,52,0.00578806767587,1980,0.220391807658,778,0.0865983971505,211,0.0234861976848,2214,79,67,2202,2281,56,0.00623330365093,2214,0.246438112199,1481,0.164848619768,7503,0.835151380232,3282,0.365316117542,05,Durham,3706305
Durham,2544,1315,0.516902515723,535,0.210298742138,17,0.00668238993711,69,0.0271226415094,561,0.220518867925,47,0.0184748427673,549,22,21,548,570,14,0.00550314465409,549,0.215801886792,936,0.367924528302,1608,0.632075471698,999,0.392688679245,06,Durham,3706306
Durham,2332,1702,0.729845626072,337,0.144511149228,3,0.00128644939966,113,0.0484562607204,106,0.0454545454545,71,0.0304459691252,368,23,13,358,381,31,0.0132933104631,368,0.157804459691,209,0.0896226415094,2123,0.910377358491,1625,0.696826758148,07,Durham,3706307
Durham,2156,736,0.341372912801,1195,0.55426716141,19,0.00881261595547,29,0.0134508348794,116,0.0538033395176,61,0.028293135436,1232,49,29,1212,1261,37,0.0171614100186,1232,0.571428571429,209,0.0969387755102,1947,0.90306122449,675,0.313079777365,08,Durham,3706308
Durham,2516,1475,0.586248012719,880,0.349761526232,6,0.00238473767886,57,0.0226550079491,68,0.027027027027,30,0.0119236883943,901,20,6,887,907,21,0.00834658187599,901,0.358108108108,129,0.0512718600954,2387,0.948728139905,1428,0.567567567568,09,Durham,3706309
Durham,1650,172,0.104242424242,1368,0.829090909091,7,0.00424242424242,4,0.00242424242424,78,0.0472727272727,21,0.0127272727273,1386,18,8,1376,1394,18,0.0109090909091,1386,0.84,141,0.0854545454545,1509,0.914545454545,126,0.0763636363636,10,Durham,3706310
Durham,670,39,0.0582089552239,594,0.886567164179,1,0.00149253731343,5,0.00746268656716,21,0.0313432835821,10,0.0149253731343,600,4,1,597,601,6,0.0089552238806,600,0.89552238806,43,0.0641791044776,627,0.935820895522,18,0.0268656716418,12,Durham,3706312
Durham,1343,38,0.0282948622487,1197,0.891288160834,7,0.00521221146687,3,0.00223380491437,79,0.0588235294118,19,0.0141474311243,1215,20,7,1202,1222,18,0.0134028294862,1215,0.90469099032,103,0.0766939687267,1240,0.923306031273,23,0.0171258376768,13,Durham,3706313
Durham,2483,439,0.176802255336,1547,0.623036649215,20,0.00805477245268,6,0.0024164317358,433,0.1743858236,38,0.0153040676601,1566,40,27,1553,1593,19,0.00765203383004,1566,0.630688683045,593,0.238824003222,1890,0.761175996778,326,0.131292790979,14,Durham,3706314
Durham,1900,385,0.202631578947,1168,0.614736842105,17,0.00894736842105,4,0.00210526315789,272,0.143157894737,54,0.0284210526316,1193,34,23,1182,1216,25,0.0131578947368,1193,0.627894736842,482,0.253684210526,1418,0.746315789474,227,0.119473684211,15,Durham,3706315
Durham,2303,1421,0.617021276596,652,0.283108988276,13,0.00564481111594,117,0.0508033000434,51,0.0221450282241,49,0.0212765957447,679,28,18,669,697,27,0.0117238384716,679,0.294832826748,103,0.0447242726878,2200,0.955275727312,1382,0.600086843248,16,Durham,3706316
Durham,3261,491,0.150567310641,2256,0.691812327507,21,0.0064397424103,15,0.00459981600736,409,0.125421649801,69,0.0211591536339,2296,47,34,2283,2330,40,0.0122661760196,2296,0.704078503527,617,0.189205765103,2644,0.810794234897,335,0.102729224164,17,Durham,3706317
Durham,3559,816,0.229277887047,1815,0.509974711998,38,0.0106771565046,18,0.00505760044956,791,0.222253441978,81,0.022759202023,1844,60,46,1830,1890,29,0.00814835627985,1844,0.518123068278,1426,0.400674346727,2133,0.599325653273,288,0.080921607193,18,Durham,3706318
Durham,3313,1018,0.307274373679,1838,0.554784183519,13,0.00392393600966,24,0.00724418955629,331,0.0999094476305,89,0.0268638696046,1886,44,25,1867,1911,48,0.0144883791126,1886,0.569272562632,551,0.166314518563,2762,0.833685481437,845,0.255055840628,19,Durham,3706319
Durham,2493,1446,0.580024067389,569,0.228239069394,20,0.00802246289611,42,0.0168471720818,364,0.146008824709,52,0.0208584035299,589,36,29,582,618,20,0.00802246289611,589,0.23626153229,574,0.230244685118,1919,0.769755314882,1263,0.506618531889,20,Durham,3706320
Durham,2054,1240,0.603700097371,514,0.250243427459,4,0.00194741966894,37,0.0180136319377,229,0.111489776047,30,0.014605647517,526,15,10,521,536,12,0.00584225900682,526,0.256085686465,301,0.146543330088,1753,0.853456669912,1179,0.57400194742,21,Durham,3706321
Durham,5377,1037,0.192858471267,3767,0.700576529663,19,0.00353356890459,52,0.00967082015994,406,0.0755067881718,96,0.0178538218337,3824,55,27,3796,3851,57,0.0106007067138,3824,0.711177236377,605,0.112516273015,4772,0.887483726985,900,0.167379579691,22,Durham,3706322
Durham,5788,1504,0.259847961299,3713,0.641499654457,27,0.00466482377332,150,0.0259156876296,280,0.0483759502419,114,0.0196959225985,3793,78,39,3754,3832,80,0.0138217000691,3793,0.655321354527,451,0.0779198341396,5337,0.92208016586,1402,0.242225293711,23,Durham,3706323
Durham,4037,2621,0.649244488482,1023,0.25340599455,17,0.00421104780778,108,0.0267525390141,213,0.0527619519445,55,0.0136239782016,1048,32,25,1041,1073,25,0.00619271736438,1048,0.259598711915,370,0.0916522169928,3667,0.908347783007,2506,0.620757988605,24,Durham,3706324
Durham,3282,2725,0.830286410725,396,0.120658135283,9,0.00274223034735,48,0.0146252285192,63,0.0191956124314,41,0.0124923826935,417,29,16,404,433,21,0.00639853747715,417,0.127056672761,130,0.0396099939062,3152,0.960390006094,2672,0.814137720902,25,Durham,3706325
Durham,1460,1189,0.814383561644,216,0.147945205479,5,0.00342465753425,6,0.0041095890411,18,0.0123287671233,26,0.0178082191781,222,9,7,220,229,6,0.0041095890411,222,0.152054794521,48,0.0328767123288,1412,0.967123287671,1174,0.804109589041,26,Durham,3706326
Durham,2948,2496,0.846675712347,241,0.081750339213,4,0.00135685210312,104,0.0352781546811,71,0.0240841248304,32,0.010854816825,252,13,9,248,261,11,0.00373134328358,252,0.0854816824966,129,0.0437584803256,2819,0.956241519674,2436,0.826322930801,27,Durham,3706327
Durham,3380,2764,0.81775147929,478,0.141420118343,11,0.00325443786982,48,0.014201183432,46,0.0136094674556,33,0.00976331360947,499,27,18,490,517,21,0.00621301775148,499,0.147633136095,73,0.0215976331361,3307,0.978402366864,2737,0.809763313609,28,Durham,3706328
Durham,4587,2463,0.536952256377,1627,0.354698059734,19,0.00414214083279,23,0.0050141704818,376,0.0819707870068,79,0.0172225855679,1667,41,27,1653,1694,40,0.00872029649008,1667,0.363418356224,596,0.129932417702,3991,0.870067582298,2280,0.497056899935,29,Durham,3706329
Durham,6122,2946,0.481215289121,2315,0.378144397256,49,0.00800392028749,181,0.0295655014701,542,0.0885331590983,89,0.0145377327671,2352,71,60,2341,2412,37,0.00604377654361,2352,0.384188173799,869,0.141947076119,5253,0.858052923881,2694,0.4400522705,30-1,Durham,3706330-1
Durham,6595,2028,0.307505686126,4062,0.615921152388,21,0.00318423047763,97,0.0147081122062,296,0.0448824867324,91,0.0137983320697,4119,63,36,4092,4155,57,0.00864291129644,4119,0.624564063685,508,0.0770280515542,6087,0.922971948446,1872,0.283851402578,30-2,Durham,3706330-2
Durham,4070,2147,0.527518427518,1414,0.34742014742,41,0.0100737100737,110,0.027027027027,275,0.0675675675676,83,0.0203931203931,1458,78,58,1438,1516,44,0.0108108108108,1458,0.358230958231,471,0.115724815725,3599,0.884275184275,2010,0.493857493857,31,Durham,3706331
Durham,2576,2184,0.847826086957,242,0.0939440993789,6,0.00232919254658,75,0.0291149068323,50,0.0194099378882,19,0.00737577639752,247,11,10,246,257,5,0.00194099378882,247,0.0958850931677,114,0.0442546583851,2462,0.955745341615,2126,0.825310559006,32,Durham,3706332
Durham,6814,3102,0.455239213384,2585,0.379366011154,30,0.00440270032286,723,0.106105077781,231,0.0339007924861,143,0.0209862048723,2660,72,42,2630,2702,75,0.0110067508072,2660,0.390372761961,532,0.0780745523921,6282,0.921925447608,2874,0.42177869093,33,Durham,3706333
Durham,8679,2515,0.289779928563,4934,0.568498674963,23,0.00265007489342,462,0.0532319391635,573,0.0660214310404,172,0.0198179513769,5035,85,34,4984,5069,101,0.0116372854015,5035,0.580135960364,991,0.114183661712,7688,0.885816338288,2182,0.251411452932,34,Durham,3706334
Durham,7323,4440,0.606308889799,1993,0.272156220128,40,0.00546224225044,575,0.0785197323501,162,0.0221220811143,113,0.0154308343575,2043,83,63,2023,2106,50,0.00682780281305,2043,0.278984022941,423,0.0577632117984,6900,0.942236788202,4207,0.57449132869,35,Durham,3706335
Durham,3928,1749,0.445264765784,1108,0.282077393075,23,0.00585539714868,189,0.048116089613,709,0.18049898167,150,0.0381873727088,1150,59,41,1132,1191,42,0.0106924643585,1150,0.292769857434,1128,0.28716904277,2800,0.71283095723,1434,0.365071283096,36,Durham,3706336
Durham,5086,3906,0.767990562328,722,0.141958316948,37,0.00727487219819,167,0.0328352339756,172,0.0338183248132,82,0.0161226897365,748,55,45,738,793,26,0.00511207235549,748,0.147070389304,401,0.078843885175,4685,0.921156114825,3745,0.736335037357,37,Durham,3706337
Durham,7430,3936,0.529744279946,1810,0.243606998654,45,0.00605652759085,728,0.0979811574697,684,0.0920592193809,227,0.0305518169583,1915,134,81,1862,1996,105,0.014131897712,1915,0.257738896366,1446,0.194616419919,5984,0.805383580081,3310,0.445491251682,38,Durham,3706338
Durham,2839,2175,0.766114829165,499,0.175766114829,10,0.00352236703064,91,0.0320535399789,37,0.0130327580134,27,0.00951039098274,514,24,13,503,527,15,0.00528355054597,514,0.181049665375,94,0.0331102500881,2745,0.966889749912,2120,0.746741810497,39,Durham,3706339
Durham,2016,1070,0.530753968254,663,0.328869047619,14,0.00694444444444,46,0.0228174603175,174,0.0863095238095,49,0.0243055555556,684,39,26,671,710,21,0.0104166666667,684,0.339285714286,301,0.149305555556,1715,0.850694444444,973,0.482638888889,40,Durham,3706340
Durham,1331,37,0.0277986476334,1226,0.921111945905,12,0.00901577761082,4,0.00300525920361,37,0.0277986476334,15,0.0112697220135,1240,19,12,1233,1252,14,0.0105184072126,1240,0.931630353118,52,0.0390683696469,1279,0.960931630353,28,0.0210368144252,41,Durham,3706341
Durham,1288,48,0.0372670807453,1136,0.88198757764,5,0.00388198757764,0,0.0,85,0.0659937888199,14,0.0108695652174,1149,16,6,1139,1155,13,0.0100931677019,1149,0.892080745342,113,0.0877329192547,1175,0.912267080745,22,0.0170807453416,42,Durham,3706342
Durham,5830,4687,0.803945111492,421,0.0722126929674,13,0.00222984562607,581,0.0996569468268,46,0.00789022298456,82,0.0140651801029,447,36,28,439,475,26,0.00445969125214,447,0.0766723842196,223,0.0382504288165,5607,0.961749571184,4524,0.775986277873,43,Durham,3706343
Durham,5760,4320,0.75,1075,0.186631944444,17,0.00295138888889,198,0.034375,82,0.0142361111111,68,0.0118055555556,1092,38,30,1084,1122,17,0.00295138888889,1092,0.189583333333,162,0.028125,5598,0.971875,4252,0.738194444444,44,Durham,3706344
Durham,5158,3750,0.727025979062,1047,0.202985653354,15,0.00290810391625,162,0.0314075222955,110,0.0213260953858,74,0.0143466459868,1077,38,32,1071,1109,30,0.00581620783249,1077,0.208801861187,217,0.0420705699884,4941,0.957929430012,3656,0.708801861187,45,Durham,3706345
Durham,4923,1895,0.384927889498,1914,0.388787324802,12,0.00243753808653,144,0.0292504570384,840,0.170627666057,118,0.0239691245176,1969,54,34,1949,2003,55,0.0111720495633,1969,0.399959374365,1166,0.236847450741,3757,0.763152549259,1654,0.335973999594,46,Durham,3706346
Durham,1952,114,0.0584016393443,1633,0.836577868852,19,0.00973360655738,2,0.00102459016393,154,0.078893442623,30,0.015368852459,1651,31,21,1641,1672,18,0.00922131147541,1651,0.845799180328,226,0.115778688525,1726,0.884221311475,76,0.0389344262295,47,Durham,3706347
Durham,1841,1159,0.629549158066,536,0.291146116241,4,0.00217273221076,84,0.0456273764259,25,0.0135795763172,33,0.0179250407387,560,18,9,551,569,24,0.0130363932645,560,0.304182509506,91,0.0494296577947,1750,0.950570342205,1104,0.599674090168,48,Durham,3706348
Durham,3912,2556,0.653374233129,821,0.209867075665,7,0.00178936605317,298,0.0761758691207,155,0.0396216768916,75,0.0191717791411,841,31,25,835,866,20,0.00511247443763,841,0.214979550102,281,0.0718302658487,3631,0.928169734151,2450,0.626278118609,50,Durham,3706350
Durham,4702,3362,0.715014887282,802,0.170565716716,16,0.00340280731604,369,0.0784772437261,78,0.0165886856657,75,0.0159506592939,835,44,30,821,865,33,0.00701829008932,835,0.177584006806,219,0.0465759251382,4483,0.953424074862,3232,0.687367077839,51,Durham,3706351
Durham,4069,686,0.168591791595,2667,0.655443597936,33,0.00811010076186,35,0.00860162202015,566,0.139100516097,82,0.0201523715901,2721,72,42,2691,2763,54,0.0132710739739,2721,0.66871467191,788,0.193659375768,3281,0.806340624232,526,0.129270090931,52,Durham,3706352
Durham,3488,2233,0.640194954128,715,0.20498853211,14,0.00401376146789,412,0.118119266055,49,0.0140481651376,65,0.0186353211009,738,35,22,725,760,23,0.00659403669725,738,0.211582568807,143,0.040997706422,3345,0.959002293578,2146,0.615252293578,53-1,Durham,3706353-1
Durham,3886,3039,0.782038085435,434,0.111682964488,7,0.0018013381369,281,0.0723108594956,58,0.0149253731343,67,0.0172413793103,461,23,17,455,478,27,0.00694801852805,461,0.118630983016,157,0.0404014410705,3729,0.959598558929,2945,0.757848687597,53-2,Durham,3706353-2
Durham,7495,3488,0.465376917945,2914,0.388792528352,18,0.00240160106738,680,0.0907271514343,231,0.0308205470314,164,0.0218812541694,3007,59,32,2980,3039,93,0.0124082721815,3007,0.401200800534,513,0.0684456304203,6982,0.93155436958,3271,0.436424282855,54,Durham,3706354
Durham,4212,118,0.0280151946819,3888,0.923076923077,20,0.00474833808167,9,0.00213675213675,140,0.0332383665717,37,0.00878442545109,3917,36,21,3902,3938,29,0.00688509021842,3917,0.929962013295,174,0.0413105413105,4038,0.958689458689,83,0.0197056030389,55,Durham,3706355
Edgecombe,2774,365,0.131578947368,2347,0.846070656092,2,0.000720980533526,2,0.000720980533526,49,0.0176640230714,9,0.00324441240087,2351,7,5,2349,2356,4,0.00144196106705,2351,0.847512617159,53,0.0191059841384,2721,0.980894015862,360,0.129776496035,0101,Edgecombe,370650101
Edgecombe,3689,1929,0.522905936568,1672,0.45323936026,9,0.00243968555164,8,0.00216860937924,33,0.00894551368935,38,0.0103008945514,1693,24,18,1687,1711,21,0.00569259962049,1693,0.458931959881,74,0.0200596367579,3615,0.979940363242,1904,0.516129032258,0102,Edgecombe,370650102
Edgecombe,2971,1643,0.553012453719,1131,0.380679905756,6,0.00201952204645,25,0.00841467519354,151,0.050824638169,15,0.00504880511612,1137,12,9,1134,1146,6,0.00201952204645,1137,0.382699427802,234,0.0787613598115,2737,0.921238640188,1574,0.529787950185,0103,Edgecombe,370650103
Edgecombe,2238,1263,0.564343163539,920,0.411081322609,2,0.000893655049151,13,0.00580875781948,31,0.0138516532618,9,0.00402144772118,924,3,2,923,926,4,0.0017873100983,924,0.412868632708,65,0.0290437890974,2173,0.970956210903,1244,0.555853440572,0104,Edgecombe,370650104
Edgecombe,1459,761,0.521590130226,655,0.448937628513,3,0.00205620287868,2,0.00137080191912,30,0.0205620287868,8,0.00548320767649,659,7,6,658,665,4,0.00274160383825,659,0.451679232351,47,0.0322138450994,1412,0.967786154901,746,0.511309115833,0201,Edgecombe,370650201
Edgecombe,573,312,0.544502617801,243,0.424083769634,0,0.0,0,0.0,12,0.020942408377,6,0.0104712041885,247,3,1,245,248,4,0.00698080279232,247,0.431064572426,20,0.0349040139616,553,0.965095986038,306,0.534031413613,0301,Edgecombe,370650301
Edgecombe,700,316,0.451428571429,366,0.522857142857,3,0.00428571428571,2,0.00285714285714,13,0.0185714285714,0,0.0,366,3,3,366,369,0,0.0,366,0.522857142857,19,0.0271428571429,681,0.972857142857,312,0.445714285714,0401,Edgecombe,370650401
Edgecombe,932,464,0.497854077253,326,0.349785407725,1,0.00107296137339,2,0.00214592274678,130,0.139484978541,9,0.00965665236052,329,4,3,328,332,3,0.00321888412017,329,0.353004291845,162,0.173819742489,770,0.826180257511,436,0.467811158798,0501,Edgecombe,370650501
Edgecombe,1207,379,0.314001657001,778,0.644573322287,7,0.00579950289975,1,0.00082850041425,21,0.0173985086993,21,0.0173985086993,792,20,12,784,804,14,0.0115990057995,792,0.656172328086,39,0.0323115161558,1168,0.967688483844,373,0.309030654515,0601,Edgecombe,370650601
Edgecombe,2753,899,0.326552851435,1731,0.628768616055,20,0.00726480203414,9,0.00326916091537,85,0.0308754086451,9,0.00326916091537,1735,22,22,1735,1757,4,0.00145296040683,1735,0.630221576462,110,0.0399564111878,2643,0.960043588812,879,0.319288049401,0701,Edgecombe,370650701
Edgecombe,1857,1187,0.639203015617,560,0.301561658589,10,0.00538502961766,1,0.000538502961766,81,0.0436187399031,18,0.00969305331179,566,20,17,563,583,6,0.0032310177706,566,0.30479267636,115,0.0619278406031,1742,0.938072159397,1166,0.627894453419,0801,Edgecombe,370650801
Edgecombe,1402,1106,0.788873038516,264,0.188302425107,0,0.0,10,0.00713266761769,12,0.00855920114123,10,0.00713266761769,272,4,2,270,274,8,0.00570613409415,272,0.194008559201,23,0.0164051355207,1379,0.983594864479,1095,0.781027104137,0901,Edgecombe,370650901
Edgecombe,2520,1351,0.536111111111,1139,0.451984126984,7,0.00277777777778,3,0.00119047619048,18,0.00714285714286,2,0.000793650793651,1139,7,7,1139,1146,0,0.0,1139,0.451984126984,40,0.015873015873,2480,0.984126984127,1334,0.529365079365,1001,Edgecombe,370651001
Edgecombe,1436,872,0.607242339833,487,0.339136490251,13,0.00905292479109,1,0.000696378830084,50,0.0348189415042,13,0.00905292479109,492,23,19,488,511,5,0.00348189415042,492,0.342618384401,89,0.0619777158774,1347,0.938022284123,838,0.58356545961,1101,Edgecombe,370651101
Edgecombe,4130,237,0.0573849878935,3830,0.927360774818,13,0.00314769975787,2,0.000484261501211,13,0.00314769975787,35,0.00847457627119,3861,36,16,3841,3877,31,0.00750605326877,3861,0.934866828087,33,0.00799031476998,4097,0.99200968523,229,0.0554479418886,1201,Edgecombe,370651201
Edgecombe,2405,172,0.0715176715177,2197,0.913513513514,11,0.0045738045738,2,0.000831600831601,2,0.000831600831601,21,0.00873180873181,2215,20,13,2208,2228,18,0.00748440748441,2215,0.920997920998,14,0.00582120582121,2391,0.994178794179,166,0.0690228690229,1202,Edgecombe,370651202
Edgecombe,3525,1940,0.550354609929,1511,0.42865248227,6,0.00170212765957,7,0.00198581560284,30,0.00851063829787,31,0.00879432624113,1528,21,15,1522,1543,17,0.00482269503546,1528,0.433475177305,63,0.0178723404255,3462,0.982127659574,1914,0.542978723404,1203,Edgecombe,370651203
Edgecombe,1750,89,0.0508571428571,1639,0.936571428571,5,0.00285714285714,1,0.000571428571429,2,0.00114285714286,14,0.008,1650,12,5,1643,1655,11,0.00628571428571,1650,0.942857142857,8,0.00457142857143,1742,0.995428571429,89,0.0508571428571,1204,Edgecombe,370651204
Edgecombe,1428,29,0.0203081232493,1376,0.963585434174,3,0.00210084033613,1,0.000700280112045,7,0.00490196078431,12,0.00840336134454,1387,10,4,1381,1391,11,0.00770308123249,1387,0.971288515406,8,0.00560224089636,1420,0.994397759104,29,0.0203081232493,1205,Edgecombe,370651205
Edgecombe,1595,1225,0.76802507837,347,0.217554858934,2,0.0012539184953,3,0.00188087774295,9,0.00564263322884,9,0.00564263322884,352,7,5,350,357,5,0.00313479623824,352,0.220689655172,17,0.01065830721,1578,0.98934169279,1219,0.764263322884,1301,Edgecombe,370651301
Edgecombe,1329,1089,0.819413092551,225,0.169300225734,1,0.000752445447705,1,0.000752445447705,4,0.00300978179082,9,0.00677200902935,225,8,8,225,233,0,0.0,225,0.169300225734,14,0.0105342362679,1315,0.989465763732,1079,0.811888638074,1401,Edgecombe,370651401
Forsyth,4526,3608,0.797171895714,618,0.136544410075,19,0.00419796730004,106,0.0234202386213,134,0.0296067167477,41,0.0090587715422,636,36,29,629,665,18,0.00397702165267,636,0.140521431728,283,0.0625276182059,4243,0.937472381794,3463,0.765134776845,011,Forsyth,37067011
Forsyth,3021,2728,0.9030122476,148,0.0489904005296,15,0.00496524329692,25,0.00827540549487,82,0.0271433300232,23,0.00761337305528,152,26,25,151,177,4,0.00132406487918,152,0.0503144654088,150,0.0496524329692,2871,0.950347567031,2677,0.886130420391,012,Forsyth,37067012
Forsyth,3896,3188,0.818275154004,538,0.138090349076,13,0.00333675564682,66,0.0169404517454,57,0.0146303901437,34,0.00872689938398,549,30,25,544,574,11,0.00282340862423,549,0.1409137577,145,0.0372176591376,3751,0.962782340862,3108,0.797741273101,013,Forsyth,37067013
Forsyth,2450,2151,0.877959183673,162,0.0661224489796,11,0.00448979591837,49,0.02,56,0.0228571428571,21,0.00857142857143,168,21,19,166,187,6,0.00244897959184,168,0.0685714285714,86,0.0351020408163,2364,0.964897959184,2122,0.86612244898,014,Forsyth,37067014
Forsyth,1886,1651,0.87539766702,163,0.0864262990456,3,0.00159066808059,29,0.0153764581124,28,0.0148462354189,12,0.00636267232238,166,8,5,163,171,3,0.00159066808059,166,0.0880169671262,70,0.0371155885472,1816,0.962884411453,1612,0.854718981972,015,Forsyth,37067015
Forsyth,3694,3429,0.928262046562,182,0.0492690850027,16,0.00433134813211,10,0.00270709258257,29,0.00785056848944,28,0.00757985923119,191,28,25,188,216,9,0.00243638332431,191,0.051705468327,80,0.0216567406605,3614,0.978343259339,3394,0.918787222523,021,Forsyth,37067021
Forsyth,2128,1618,0.760338345865,419,0.196898496241,7,0.00328947368421,7,0.00328947368421,63,0.0296052631579,14,0.00657894736842,425,14,12,423,437,6,0.00281954887218,425,0.199718045113,94,0.0441729323308,2034,0.955827067669,1591,0.74765037594,031,Forsyth,37067031
Forsyth,2560,2142,0.83671875,344,0.134375,6,0.00234375,22,0.00859375,33,0.012890625,13,0.005078125,347,12,10,345,357,3,0.001171875,347,0.135546875,76,0.0296875,2484,0.9703125,2100,0.8203125,032,Forsyth,37067032
Forsyth,3102,1797,0.579303675048,922,0.2972275951,26,0.00838168923275,31,0.00999355254674,287,0.0925209542231,39,0.0125725338491,944,41,33,936,977,22,0.00709219858156,944,0.304319793681,421,0.135718891038,2681,0.864281108962,1682,0.542230818827,033,Forsyth,37067033
Forsyth,2519,1990,0.789996030171,343,0.136165144899,8,0.00317586343787,15,0.00595474394601,134,0.0531957125844,29,0.0115125049623,360,18,13,355,373,17,0.00674870980548,360,0.142913854704,239,0.0948789202064,2280,0.905121079794,1905,0.756252481143,034,Forsyth,37067034
Forsyth,3404,2258,0.663337250294,711,0.208871915394,24,0.00705052878966,47,0.0138072855464,300,0.0881316098707,64,0.0188014101058,744,40,31,735,775,33,0.00969447708578,744,0.218566392479,509,0.149529964747,2895,0.850470035253,2110,0.619858989424,042,Forsyth,37067042
Forsyth,4129,2348,0.568660692662,858,0.207798498426,24,0.00581254541051,15,0.00363284088157,820,0.198595301526,64,0.0155001210947,884,36,34,882,918,26,0.00629692419472,884,0.21409542262,1217,0.294744490191,2912,0.705255509809,2045,0.495277306854,043,Forsyth,37067043
Forsyth,2992,2625,0.877339572193,201,0.067179144385,6,0.00200534759358,64,0.0213903743316,75,0.0250668449198,21,0.00701871657754,206,15,11,202,217,5,0.00167112299465,206,0.0688502673797,202,0.067513368984,2790,0.932486631016,2511,0.839237967914,051,Forsyth,37067051
Forsyth,1212,1137,0.938118811881,34,0.0280528052805,1,0.000825082508251,18,0.0148514851485,6,0.0049504950495,16,0.013201320132,40,8,6,38,46,6,0.0049504950495,40,0.03300330033,20,0.016501650165,1192,0.983498349835,1123,0.926567656766,052,Forsyth,37067052
Forsyth,1820,1644,0.903296703297,112,0.0615384615385,2,0.0010989010989,36,0.0197802197802,17,0.00934065934066,9,0.00494505494505,117,3,2,116,119,5,0.00274725274725,117,0.0642857142857,61,0.0335164835165,1759,0.966483516484,1601,0.87967032967,053,Forsyth,37067053
Forsyth,2429,2245,0.924248662001,122,0.0502264306299,1,0.000411692054343,42,0.0172910662824,9,0.00370522848909,10,0.00411692054343,125,4,3,124,128,3,0.00123507616303,125,0.0514615067929,48,0.0197612186085,2381,0.980238781392,2210,0.909839440099,054,Forsyth,37067054
Forsyth,2866,2496,0.870900209351,164,0.0572226099093,7,0.00244242847174,171,0.059665038381,14,0.00488485694348,14,0.00488485694348,175,14,10,171,185,11,0.00383810188416,175,0.0610607117934,94,0.0327983251919,2772,0.967201674808,2423,0.845429169574,055,Forsyth,37067055
Forsyth,2858,2180,0.762771168649,264,0.0923722883135,28,0.00979706088174,37,0.0129461161652,293,0.102519244227,56,0.0195941217635,276,49,45,272,321,12,0.00419874037789,276,0.0965710286914,522,0.182645206438,2336,0.817354793562,2007,0.702239328202,061,Forsyth,37067061
Forsyth,1845,1644,0.891056910569,149,0.0807588075881,4,0.00216802168022,18,0.00975609756098,18,0.00975609756098,12,0.00650406504065,152,7,7,152,159,3,0.00162601626016,152,0.0823848238482,56,0.030352303523,1789,0.969647696477,1611,0.873170731707,062,Forsyth,37067062
Forsyth,3937,3326,0.844805689611,437,0.110998221996,15,0.00381000762002,42,0.010668021336,74,0.0187960375921,43,0.010922021844,462,41,27,448,489,25,0.00635001270003,462,0.117348234696,139,0.0353060706121,3798,0.964693929388,3273,0.831343662687,063,Forsyth,37067063
Forsyth,1535,1254,0.816938110749,136,0.0885993485342,11,0.0071661237785,8,0.00521172638436,106,0.0690553745928,20,0.0130293159609,141,21,20,140,161,5,0.00325732899023,141,0.0918566775244,177,0.115309446254,1358,0.884690553746,1199,0.781107491857,064,Forsyth,37067064
Forsyth,3847,3241,0.842474655576,379,0.0985183259683,11,0.00285937093839,100,0.0259942812581,77,0.0200155965688,39,0.0101377696907,394,18,16,392,410,15,0.00389914218872,394,0.102417468157,151,0.0392513646998,3696,0.9607486353,3186,0.828177800884,065,Forsyth,37067065
Forsyth,3061,2516,0.821953609931,205,0.0669715779157,8,0.00261352499183,51,0.0166612218229,235,0.0767722966351,46,0.015027768703,220,29,24,215,244,15,0.00490035935969,220,0.0718719372754,466,0.152237830774,2595,0.847762169226,2322,0.758575628879,066,Forsyth,37067066
Forsyth,2515,1941,0.771769383698,385,0.153081510934,5,0.00198807157058,34,0.0135188866799,103,0.0409542743539,47,0.0186878727634,402,21,16,397,418,17,0.00675944333996,402,0.159840954274,202,0.0803180914513,2313,0.919681908549,1852,0.736381709742,067,Forsyth,37067067
Forsyth,2318,2100,0.90595340811,166,0.0716134598792,9,0.00388265746333,12,0.00517687661777,14,0.0060396893874,17,0.00733390854185,175,16,13,172,188,9,0.00388265746333,175,0.0754961173425,50,0.0215703192407,2268,0.978429680759,2065,0.890854184642,068,Forsyth,37067068
Forsyth,3413,3064,0.897743920305,195,0.0571344857896,4,0.00117198945209,88,0.0257837679461,27,0.00791092880164,35,0.0102549077058,213,14,11,210,224,18,0.00527395253443,213,0.0624084383241,102,0.0298857310284,3311,0.970114268972,2989,0.875769118078,071,Forsyth,37067071
Forsyth,5895,4795,0.813401187447,462,0.0783715012723,21,0.00356234096692,207,0.0351145038168,369,0.0625954198473,41,0.0069550466497,481,32,28,477,509,19,0.00322307039864,481,0.0815945716709,582,0.098727735369,5313,0.901272264631,4609,0.781849024597,072,Forsyth,37067072
Forsyth,2721,2579,0.947813303932,90,0.0330760749724,5,0.00183755972069,21,0.0077177508269,13,0.0047776552738,13,0.0047776552738,93,13,11,91,104,3,0.00110253583241,93,0.0341786108049,53,0.0194781330393,2668,0.980521866961,2540,0.933480338111,073,Forsyth,37067073
Forsyth,3161,2642,0.835811452072,305,0.0964884530212,8,0.00253084466941,136,0.0430243593799,31,0.00980702309396,39,0.0123378677634,318,26,18,310,336,13,0.00411262258779,318,0.100601075609,111,0.035115469788,3050,0.964884530212,2581,0.816513761468,074,Forsyth,37067074
Forsyth,691,651,0.942112879884,23,0.0332850940666,3,0.00434153400868,7,0.0101302460203,2,0.00289435600579,5,0.00723589001447,26,5,5,26,31,3,0.00434153400868,26,0.0376266280753,10,0.0144717800289,681,0.985528219971,646,0.93487698987,075,Forsyth,37067075
Forsyth,3959,2208,0.5577165951,1274,0.321798433948,25,0.00631472594089,61,0.0154079312958,328,0.0828492043445,63,0.0159131093711,1297,54,51,1294,1348,23,0.00580954786562,1297,0.327607981814,460,0.116190957312,3499,0.883809042688,2110,0.532962869411,081,Forsyth,37067081
Forsyth,4197,2587,0.616392661425,1451,0.345723135573,14,0.00333571598761,29,0.00690969740291,82,0.0195377650703,34,0.00810102454134,1467,25,19,1461,1486,16,0.00381224684298,1467,0.349535382416,167,0.0397903264236,4030,0.960209673576,2524,0.601381939481,082,Forsyth,37067082
Forsyth,2691,1305,0.484949832776,1162,0.431809736158,13,0.0048309178744,16,0.00594574507618,147,0.0546265328874,48,0.0178372352285,1192,34,20,1178,1212,30,0.0111482720178,1192,0.442958008175,204,0.0758082497213,2487,0.924191750279,1270,0.471943515422,083,Forsyth,37067083
Forsyth,2447,2167,0.885574172456,220,0.0899060073559,15,0.006129955047,9,0.0036779730282,21,0.00858193706579,15,0.006129955047,222,24,24,222,246,2,0.0008173273396,222,0.0907233346955,49,0.0200245198202,2398,0.97997548018,2144,0.876174908051,091,Forsyth,37067091
Forsyth,1890,1760,0.931216931217,86,0.0455026455026,6,0.0031746031746,10,0.00529100529101,15,0.00793650793651,13,0.00687830687831,88,13,13,88,101,2,0.0010582010582,88,0.0465608465608,32,0.0169312169312,1858,0.983068783069,1747,0.924338624339,092,Forsyth,37067092
Forsyth,2669,1655,0.620082427876,547,0.204945672537,12,0.0044960659423,19,0.00711877107531,382,0.14312476583,54,0.0202322967404,564,34,28,558,592,17,0.00636942675159,564,0.211315099288,513,0.192206819033,2156,0.807793180967,1554,0.582240539528,101,Forsyth,37067101
Forsyth,2046,1855,0.906647116325,126,0.0615835777126,15,0.00733137829912,1,0.000488758553275,31,0.0151515151515,18,0.00879765395894,131,23,23,131,154,5,0.00244379276637,131,0.064027370479,47,0.0229716520039,1999,0.977028347996,1844,0.901270772239,111,Forsyth,37067111
Forsyth,3353,2743,0.818073367134,500,0.149120190874,25,0.00745600954369,13,0.00387712496272,40,0.0119296152699,32,0.00954369221593,512,42,37,507,549,12,0.00357888458097,512,0.152699075455,108,0.0322099612288,3245,0.967790038771,2690,0.802266626901,112,Forsyth,37067112
Forsyth,5005,3339,0.667132867133,1258,0.251348651349,13,0.0025974025974,178,0.0355644355644,136,0.0271728271728,81,0.0161838161838,1280,34,29,1275,1309,22,0.0043956043956,1280,0.255744255744,348,0.0695304695305,4657,0.93046953047,3165,0.632367632368,122,Forsyth,37067122
Forsyth,3019,2295,0.760185491885,481,0.159324279563,8,0.00264988406757,105,0.0347797283869,68,0.0225240145744,62,0.0205366015237,502,29,19,492,521,21,0.00695594567738,502,0.16628022524,158,0.0523352103345,2861,0.947664789665,2230,0.738655183836,123,Forsyth,37067123
Forsyth,2920,2521,0.863356164384,293,0.100342465753,5,0.00171232876712,46,0.0157534246575,15,0.00513698630137,40,0.013698630137,305,23,20,302,325,12,0.0041095890411,305,0.104452054795,70,0.0239726027397,2850,0.97602739726,2472,0.846575342466,131,Forsyth,37067131
Forsyth,3261,2833,0.86875191659,310,0.0950628641521,14,0.00429316160687,51,0.015639374425,26,0.00797301441276,27,0.00827966881325,314,21,20,313,334,4,0.00122661760196,314,0.0962894817541,70,0.0214658080343,3191,0.978534191966,2796,0.857405703772,132,Forsyth,37067132
Forsyth,4673,4307,0.92167772309,185,0.0395891290392,15,0.00320992938155,78,0.0166916327841,54,0.0115557457736,34,0.00727583993152,190,34,31,187,221,5,0.00106997646052,190,0.0406591054997,123,0.0263214209287,4550,0.973678579071,4246,0.908624010272,133,Forsyth,37067133
Forsyth,5679,2123,0.373833421377,2872,0.505722838528,27,0.00475435816165,120,0.0211304807184,433,0.0762458179257,104,0.0183130832893,2940,71,39,2908,2979,68,0.0119739390738,2940,0.517696777602,739,0.130128543758,4940,0.869871456242,1884,0.331748547279,201,Forsyth,37067201
Forsyth,1684,46,0.0273159144893,1525,0.905581947743,6,0.00356294536817,7,0.0041567695962,70,0.041567695962,30,0.0178147268409,1542,20,11,1533,1553,17,0.0100950118765,1542,0.91567695962,128,0.0760095011876,1556,0.923990498812,20,0.0118764845606,203,Forsyth,37067203
Forsyth,1821,347,0.190554640308,1221,0.670510708402,15,0.00823723228995,38,0.0208676551345,165,0.0906095551895,35,0.0192202086766,1247,35,16,1228,1263,26,0.0142778693026,1247,0.684788577705,216,0.118616144975,1605,0.881383855025,317,0.174080175728,204,Forsyth,37067204
Forsyth,890,44,0.0494382022472,790,0.887640449438,2,0.00224719101124,0,0.0,33,0.0370786516854,21,0.023595505618,807,8,2,801,809,17,0.0191011235955,807,0.906741573034,55,0.061797752809,835,0.938202247191,30,0.0337078651685,205,Forsyth,37067205
Forsyth,2039,425,0.208435507602,1281,0.628249141736,10,0.00490436488475,6,0.00294261893085,283,0.138793526238,34,0.0166748406081,1303,25,15,1293,1318,22,0.0107896027464,1303,0.639038744483,418,0.205002452182,1621,0.794997547818,316,0.154977930358,206,Forsyth,37067206
Forsyth,3324,1176,0.353790613718,1412,0.424789410349,19,0.00571600481348,72,0.0216606498195,584,0.175691937425,61,0.0183513838748,1449,35,24,1438,1473,37,0.0111311672684,1449,0.435920577617,856,0.257521058965,2468,0.742478941035,956,0.287605294826,207,Forsyth,37067207
Forsyth,1168,35,0.0299657534247,1060,0.907534246575,4,0.00342465753425,2,0.00171232876712,53,0.0453767123288,14,0.0119863013699,1073,5,4,1072,1077,13,0.0111301369863,1073,0.918664383562,99,0.0847602739726,1069,0.915239726027,16,0.013698630137,301,Forsyth,37067301
Forsyth,1388,123,0.0886167146974,1042,0.750720461095,11,0.00792507204611,4,0.0028818443804,183,0.131844380403,25,0.0180115273775,1058,19,11,1050,1069,16,0.0115273775216,1058,0.762247838617,249,0.17939481268,1139,0.82060518732,91,0.0655619596542,302,Forsyth,37067302
Forsyth,946,28,0.0295983086681,839,0.88689217759,1,0.00105708245243,0,0.0,61,0.0644820295983,17,0.0179704016913,852,6,1,847,853,13,0.0137420718816,852,0.900634249471,77,0.0813953488372,869,0.918604651163,17,0.0179704016913,303,Forsyth,37067303
Forsyth,1972,53,0.0268762677485,1833,0.929513184584,5,0.0025354969574,6,0.00304259634888,41,0.0207910750507,34,0.0172413793103,1865,29,7,1843,1872,32,0.0162271805274,1865,0.945740365112,64,0.0324543610548,1908,0.967545638945,39,0.0197768762677,304,Forsyth,37067304
Forsyth,1411,80,0.0566973777463,1270,0.900070871722,1,0.000708717221828,4,0.00283486888731,32,0.0226789510985,24,0.0170092133239,1290,14,4,1280,1294,20,0.0141743444366,1290,0.914245216159,41,0.029057406095,1370,0.970942593905,77,0.0545712260808,305,Forsyth,37067305
Forsyth,2324,683,0.293889845095,1089,0.468588640275,25,0.0107573149742,8,0.00344234079174,470,0.202237521515,49,0.0210843373494,1119,41,34,1112,1153,30,0.012908777969,1119,0.481497418244,668,0.28743545611,1656,0.71256454389,538,0.231497418244,306,Forsyth,37067306
Forsyth,2453,425,0.173257236038,1583,0.645332246229,13,0.00529963310232,7,0.00285364859356,385,0.156950672646,40,0.0163065633918,1605,28,21,1598,1626,22,0.00896860986547,1605,0.654300856095,568,0.231553200163,1885,0.768446799837,309,0.125968202201,401,Forsyth,37067401
Forsyth,1489,50,0.0335795836132,1336,0.897246474144,3,0.00201477501679,0,0.0,84,0.0564137004701,16,0.0107454667562,1348,9,4,1343,1352,12,0.00805910006716,1348,0.905305574211,102,0.0685023505709,1387,0.931497649429,41,0.0275352585628,402,Forsyth,37067402
Forsyth,2235,256,0.114541387025,1809,0.809395973154,11,0.00492170022371,8,0.00357941834452,118,0.0527964205817,33,0.0147651006711,1837,27,14,1824,1851,28,0.0125279642058,1837,0.82192393736,182,0.0814317673378,2053,0.918568232662,228,0.102013422819,403,Forsyth,37067403
Forsyth,2928,768,0.262295081967,2028,0.69262295082,4,0.00136612021858,27,0.00922131147541,54,0.0184426229508,47,0.0160519125683,2064,33,9,2040,2073,36,0.0122950819672,2064,0.704918032787,182,0.0621584699454,2746,0.937841530055,657,0.224385245902,404,Forsyth,37067404
Forsyth,3194,124,0.0388227927364,2798,0.876017532874,9,0.00281778334377,4,0.00125234815279,179,0.0560425798372,80,0.0250469630557,2865,38,10,2837,2875,67,0.0209768315592,2865,0.896994364433,269,0.0842204132749,2925,0.915779586725,85,0.0266123982467,405,Forsyth,37067405
Forsyth,2279,422,0.185168933743,1610,0.706450197455,10,0.00438788942519,4,0.00175515577007,201,0.0881965774462,32,0.0140412461606,1634,17,13,1630,1647,24,0.0105309346204,1634,0.716981132075,290,0.12724879333,1989,0.87275120667,366,0.160596752962,501,Forsyth,37067501
Forsyth,1888,216,0.114406779661,1302,0.689618644068,9,0.00476694915254,17,0.00900423728814,319,0.168961864407,25,0.0132415254237,1321,17,11,1315,1332,19,0.010063559322,1321,0.69968220339,422,0.223516949153,1466,0.776483050847,151,0.0799788135593,502,Forsyth,37067502
Forsyth,2203,1031,0.467998184294,771,0.349977303677,19,0.00862460281434,23,0.01044030867,295,0.133908306854,64,0.0290512936904,805,42,34,797,839,34,0.015433499773,805,0.36541080345,443,0.201089423513,1760,0.798910576487,940,0.426690876078,503,Forsyth,37067503
Forsyth,1974,644,0.326241134752,982,0.497467071935,27,0.0136778115502,3,0.00151975683891,268,0.135764944276,50,0.0253292806484,1007,48,44,1003,1051,25,0.0126646403242,1007,0.510131712259,498,0.252279635258,1476,0.747720364742,484,0.245187436677,504,Forsyth,37067504
Forsyth,2696,773,0.286721068249,1225,0.454376854599,4,0.00148367952522,12,0.00445103857567,620,0.229970326409,62,0.0229970326409,1257,22,12,1247,1269,32,0.0118694362018,1257,0.466246290801,811,0.300816023739,1885,0.699183976261,673,0.249629080119,505,Forsyth,37067505
Forsyth,1977,1242,0.628224582701,432,0.218512898331,11,0.00556398583713,12,0.00606980273141,250,0.126454223571,30,0.0151745068285,439,28,25,436,464,7,0.00354071825999,439,0.222053616591,390,0.197268588771,1587,0.802731411229,1134,0.573596358118,506,Forsyth,37067506
Forsyth,5528,2897,0.524059334298,1935,0.35003617945,35,0.00633140376266,54,0.00976845151954,506,0.0915340086831,101,0.0182706222865,1990,66,48,1972,2038,55,0.0099493487699,1990,0.35998552822,901,0.162988422576,4627,0.837011577424,2591,0.468704775687,507,Forsyth,37067507
Forsyth,2221,1439,0.647906348492,518,0.233228275552,15,0.006753714543,64,0.0288158487168,140,0.063034669068,45,0.020261143629,541,30,19,530,560,23,0.0103556956326,541,0.243583971184,219,0.0986042323278,2002,0.901395767672,1372,0.617739756866,601,Forsyth,37067601
Forsyth,4468,2795,0.625559534467,1265,0.283124440466,22,0.00492390331244,104,0.0232766338406,181,0.0405102954342,101,0.0226051924799,1304,51,40,1293,1344,39,0.00872873769024,1304,0.291853178156,390,0.0872873769024,4078,0.912712623098,2639,0.590644583706,602,Forsyth,37067602
Forsyth,2462,1509,0.612916328188,586,0.238017871649,9,0.00365556458164,41,0.0166531275386,274,0.111291632819,43,0.0174654752234,602,27,23,598,625,16,0.00649878147847,602,0.244516653128,400,0.162469536962,2062,0.837530463038,1419,0.576360682372,603,Forsyth,37067603
Forsyth,2819,1150,0.40794608017,687,0.243703440937,13,0.00461156438453,49,0.0173820503725,841,0.298332742107,79,0.0280241220291,713,28,24,709,737,26,0.00922312876907,713,0.252926569706,1225,0.434551259312,1594,0.565448740688,893,0.316778999645,604,Forsyth,37067604
Forsyth,4144,2100,0.506756756757,1538,0.371138996139,15,0.00361969111969,93,0.0224420849421,323,0.077944015444,75,0.0180984555985,1582,30,19,1571,1601,44,0.0106177606178,1582,0.381756756757,521,0.125723938224,3623,0.874276061776,1946,0.469594594595,605,Forsyth,37067605
Forsyth,2254,1240,0.550133096717,616,0.273291925466,6,0.00266193433895,24,0.0106477373558,335,0.148624667258,33,0.0146406388642,637,23,12,626,649,21,0.00931677018634,637,0.282608695652,432,0.191659272405,1822,0.808340727595,1162,0.515527950311,606,Forsyth,37067606
Forsyth,2519,1870,0.742358078603,482,0.191345772132,11,0.00436681222707,56,0.0222310440651,76,0.0301707026598,24,0.00952759031362,493,20,15,488,508,11,0.00436681222707,493,0.195712584359,145,0.0575625248114,2374,0.942437475189,1810,0.718539102819,607,Forsyth,37067607
Forsyth,1486,1131,0.761103633917,275,0.185060565276,5,0.00336473755047,30,0.0201884253028,24,0.0161507402423,21,0.014131897712,287,12,8,283,295,12,0.00807537012113,287,0.193135935397,55,0.0370121130552,1431,0.962987886945,1102,0.741588156124,701,Forsyth,37067701
Forsyth,1749,1417,0.81017724414,169,0.0966266437965,4,0.00228702115495,114,0.065180102916,27,0.0154373927959,18,0.0102915951973,173,7,5,171,178,4,0.00228702115495,173,0.0989136649514,62,0.0354488279017,1687,0.964551172098,1386,0.792452830189,702,Forsyth,37067702
Forsyth,1246,1112,0.892455858748,40,0.0321027287319,2,0.0016051364366,48,0.0385232744783,30,0.024077046549,14,0.0112359550562,45,7,5,43,50,5,0.00401284109149,45,0.0361155698234,79,0.0634028892456,1167,0.936597110754,1065,0.854735152488,703,Forsyth,37067703
Forsyth,1840,1522,0.827173913043,241,0.13097826087,8,0.00434782608696,30,0.0163043478261,23,0.0125,16,0.00869565217391,245,16,14,243,259,4,0.00217391304348,245,0.133152173913,53,0.0288043478261,1787,0.971195652174,1493,0.811413043478,704,Forsyth,37067704
Forsyth,2567,1737,0.676665368134,612,0.238410596026,5,0.00194779898714,90,0.0350603817686,92,0.0358395013635,31,0.0120763537203,632,16,7,623,639,20,0.00779119594858,632,0.246201791975,184,0.0716790027269,2383,0.928320997273,1658,0.645890144137,705,Forsyth,37067705
Forsyth,1492,1086,0.727882037534,321,0.215147453083,8,0.00536193029491,14,0.00938337801609,39,0.0261394101877,24,0.0160857908847,333,17,10,326,343,12,0.00804289544236,333,0.223190348525,100,0.0670241286863,1392,0.932975871314,1043,0.699061662198,706,Forsyth,37067706
Forsyth,1561,1100,0.70467648943,336,0.215246636771,4,0.00256245996156,29,0.0185778347213,59,0.0377962844331,33,0.0211402946829,348,19,13,342,361,12,0.00768737988469,348,0.222934016656,124,0.0794362588085,1437,0.920563741192,1054,0.675208199872,707,Forsyth,37067707
Forsyth,4178,2764,0.66156055529,1028,0.246050741982,12,0.00287218764959,134,0.0320727620871,171,0.0409286740067,69,0.0165150789852,1060,38,24,1046,1084,32,0.00765916706558,1060,0.253709909047,376,0.0899952130206,3802,0.910004786979,2597,0.621589277166,708,Forsyth,37067708
Forsyth,2868,1997,0.69630404463,624,0.217573221757,7,0.00244072524407,137,0.0477684797768,46,0.0160390516039,57,0.0198744769874,645,26,20,639,665,21,0.00732217573222,645,0.22489539749,152,0.0529986052999,2716,0.9470013947,1915,0.667712691771,709,Forsyth,37067709
Forsyth,1225,1088,0.888163265306,76,0.0620408163265,7,0.00571428571429,26,0.0212244897959,12,0.00979591836735,16,0.0130612244898,81,16,11,76,92,5,0.00408163265306,81,0.0661224489796,41,0.0334693877551,1184,0.966530612245,1063,0.867755102041,801,Forsyth,37067801
Forsyth,1375,1350,0.981818181818,12,0.00872727272727,0,0.0,8,0.00581818181818,1,0.000727272727273,4,0.00290909090909,15,0,0,15,15,3,0.00218181818182,15,0.0109090909091,28,0.0203636363636,1347,0.979636363636,1326,0.964363636364,802,Forsyth,37067802
Forsyth,1471,1446,0.983004758668,8,0.00543847722638,0,0.0,8,0.00543847722638,4,0.00271923861319,5,0.00339904826649,11,1,0,10,11,3,0.00203942895989,11,0.00747790618627,13,0.00883752549286,1458,0.991162474507,1434,0.974847042828,803,Forsyth,37067803
Forsyth,1092,1039,0.951465201465,37,0.0338827838828,5,0.00457875457875,7,0.00641025641026,1,0.000915750915751,3,0.00274725274725,37,6,6,37,43,0,0.0,37,0.0338827838828,16,0.014652014652,1076,0.985347985348,1024,0.937728937729,804,Forsyth,37067804
Forsyth,2102,2004,0.95337773549,43,0.0204567078972,1,0.000475737392959,31,0.0147478591817,3,0.00142721217888,20,0.00951474785918,56,6,3,53,59,13,0.00618458610847,56,0.0266412940057,33,0.0156993339676,2069,0.984300666032,1977,0.94053282588,805,Forsyth,37067805
Forsyth,1963,1761,0.897096281202,131,0.0667345899134,5,0.00254712175242,26,0.0132450331126,20,0.0101884870097,20,0.0101884870097,139,11,9,137,148,8,0.00407539480387,139,0.0708099847173,72,0.0366785532348,1891,0.963321446765,1720,0.876209882832,806,Forsyth,37067806
Forsyth,1877,1565,0.833777304209,148,0.0788492274907,1,0.000532765050613,126,0.0671283963772,15,0.00799147575919,22,0.0117208311135,155,9,7,153,162,7,0.00372935535429,155,0.082578582845,68,0.0362280234417,1809,0.963771976558,1514,0.806606286628,807,Forsyth,37067807
Forsyth,4400,2454,0.557727272727,1320,0.3,11,0.0025,288,0.0654545454545,244,0.0554545454545,83,0.0188636363636,1356,46,29,1339,1385,36,0.00818181818182,1356,0.308181818182,513,0.116590909091,3887,0.883409090909,2228,0.506363636364,808,Forsyth,37067808
Forsyth,2313,2158,0.93298746217,82,0.0354517942067,8,0.00345871162992,46,0.019887591872,4,0.00172935581496,15,0.0064850843061,88,11,8,85,96,6,0.00259403372244,88,0.0380458279291,47,0.0203199308258,2266,0.979680069174,2126,0.919152615651,809,Forsyth,37067809
Forsyth,1617,1500,0.927643784787,84,0.0519480519481,0,0.0,14,0.00865800865801,4,0.00247371675943,15,0.00927643784787,90,8,5,87,95,6,0.00371057513915,90,0.0556586270872,33,0.0204081632653,1584,0.979591836735,1471,0.909709338281,901,Forsyth,37067901
Forsyth,1909,1226,0.642221058146,521,0.272917757988,10,0.00523834468308,34,0.0178103719225,75,0.0392875851231,43,0.0225248821372,540,22,16,534,556,19,0.00995285489785,540,0.282870612886,127,0.0665269774751,1782,0.933473022525,1181,0.618648507072,902,Forsyth,37067902
Forsyth,3945,3089,0.783016476553,583,0.147782002535,5,0.00126742712294,162,0.0410646387833,27,0.00684410646388,79,0.0200253485425,614,18,13,609,627,31,0.00785804816223,614,0.155640050697,126,0.0319391634981,3819,0.968060836502,3000,0.760456273764,903,Forsyth,37067903
Forsyth,3050,1114,0.365245901639,1343,0.440327868852,13,0.00426229508197,23,0.00754098360656,497,0.162950819672,60,0.0196721311475,1373,29,19,1363,1392,30,0.00983606557377,1373,0.450163934426,725,0.237704918033,2325,0.762295081967,939,0.307868852459,904,Forsyth,37067904
Forsyth,3956,2906,0.734580384226,695,0.175682507583,9,0.00227502527806,207,0.0523255813953,73,0.0184529828109,66,0.0166835187058,730,28,21,723,751,35,0.00884732052578,730,0.184529828109,151,0.0381698685541,3805,0.961830131446,2843,0.71865520728,905,Forsyth,37067905
Forsyth,3197,2479,0.775414451048,542,0.169533938067,4,0.00125117297466,62,0.0193931811073,64,0.0200187675946,46,0.0143884892086,569,16,12,565,581,27,0.00844541757898,569,0.177979355646,170,0.0531748514232,3027,0.946825148577,2381,0.744760713169,906,Forsyth,37067906
Forsyth,2050,1604,0.78243902439,300,0.146341463415,3,0.00146341463415,58,0.0282926829268,60,0.0292682926829,25,0.0121951219512,311,13,8,306,319,11,0.00536585365854,311,0.151707317073,135,0.0658536585366,1915,0.934146341463,1537,0.749756097561,907,Forsyth,37067907
Forsyth,2446,2138,0.874080130826,194,0.07931316435,4,0.00163532297629,75,0.0306623058054,16,0.00654129190515,19,0.00776778413737,201,8,7,200,208,7,0.0028618152085,201,0.0821749795585,53,0.0216680294358,2393,0.978331970564,2103,0.859771054783,908,Forsyth,37067908
Forsyth,1356,990,0.730088495575,290,0.213864306785,6,0.00442477876106,18,0.0132743362832,44,0.0324483775811,8,0.00589970501475,295,7,7,295,302,5,0.00368731563422,295,0.217551622419,87,0.0641592920354,1269,0.935840707965,956,0.705014749263,909,Forsyth,37067909
Franklin,2661,1315,0.494175122135,1233,0.463359639233,8,0.00300638857572,26,0.0097707628711,42,0.0157835400225,37,0.0139045471627,1258,25,13,1246,1271,25,0.00939496429914,1258,0.472754603533,93,0.0349492671928,2568,0.965050732807,1279,0.480646373544,01,Franklin,3706901
Franklin,1799,821,0.456364647026,829,0.460811561979,8,0.00444691495275,1,0.000555864369094,128,0.071150639244,12,0.00667037242913,839,14,9,834,848,10,0.00555864369094,839,0.46637020567,171,0.0950528071151,1628,0.904947192885,795,0.44191217343,02,Franklin,3706902
Franklin,3341,2289,0.685124214307,918,0.274768033523,21,0.00628554325052,16,0.00478898533373,55,0.0164621370847,42,0.012571086501,938,46,36,928,974,20,0.00598623166717,938,0.28075426519,159,0.047590541754,3182,0.952409458246,2211,0.661777910805,03,Franklin,3706903
Franklin,2621,1946,0.742464708127,499,0.190385349103,22,0.00839374284624,5,0.00190766882869,124,0.0473101869515,25,0.00953834414346,510,33,28,505,538,11,0.00419687142312,510,0.194582220527,197,0.0751621518504,2424,0.92483784815,1887,0.719954215948,05,Franklin,3706905
Franklin,2427,1243,0.512154923774,1063,0.437989287186,8,0.00329625051504,6,0.00247218788628,80,0.0329625051504,27,0.0111248454883,1075,24,16,1067,1091,12,0.00494437577256,1075,0.442933662958,150,0.061804697157,2277,0.938195302843,1187,0.489081170169,06,Franklin,3706906
Franklin,1885,1599,0.848275862069,165,0.0875331564987,9,0.00477453580902,5,0.0026525198939,84,0.0445623342175,23,0.0122015915119,168,19,18,167,186,3,0.00159151193634,168,0.089124668435,120,0.0636604774536,1765,0.936339522546,1574,0.835013262599,07,Franklin,3706907
Franklin,2940,2190,0.744897959184,611,0.207823129252,16,0.00544217687075,12,0.00408163265306,72,0.0244897959184,39,0.0132653061224,632,43,30,619,662,21,0.00714285714286,632,0.214965986395,156,0.0530612244898,2784,0.94693877551,2128,0.72380952381,08,Franklin,3706908
Franklin,1844,1320,0.715835140998,397,0.215292841649,12,0.00650759219089,4,0.00216919739696,79,0.04284164859,32,0.0173535791757,409,27,15,397,424,12,0.00650759219089,409,0.221800433839,133,0.072125813449,1711,0.927874186551,1280,0.694143167028,09,Franklin,3706909
Franklin,1280,878,0.6859375,352,0.275,25,0.01953125,4,0.003125,14,0.0109375,7,0.00546875,357,32,27,352,384,5,0.00390625,357,0.27890625,40,0.03125,1240,0.96875,863,0.67421875,10,Franklin,3706910
Franklin,2087,1110,0.531863919502,876,0.419741255391,15,0.00718735026354,1,0.000479156684236,56,0.0268327743172,29,0.0138955438428,888,31,26,883,914,12,0.00574988021083,888,0.425491135601,127,0.0608528988979,1960,0.939147101102,1058,0.506947771921,11,Franklin,3706911
Franklin,1606,1027,0.639476961395,548,0.341220423412,3,0.00186799501868,2,0.00124533001245,19,0.0118306351183,7,0.00435865504359,549,8,8,549,557,1,0.000622665006227,549,0.341843088418,35,0.0217932752179,1571,0.978206724782,1015,0.63200498132,12,Franklin,3706912
Franklin,2096,1633,0.779103053435,282,0.134541984733,9,0.00429389312977,8,0.00381679389313,144,0.0687022900763,20,0.00954198473282,285,16,16,285,301,3,0.00143129770992,285,0.135973282443,201,0.0958969465649,1895,0.904103053435,1595,0.760973282443,13,Franklin,3706913
Franklin,3781,3130,0.827823327162,467,0.123512298334,26,0.00687648770167,22,0.00581856651679,94,0.0248611478445,42,0.0111081724412,483,47,39,475,522,16,0.00423168473949,483,0.127743983073,190,0.0502512562814,3591,0.949748743719,3048,0.806135942872,14,Franklin,3706914
Franklin,2987,1269,0.424840977569,1533,0.513223970539,9,0.00301305657851,9,0.00301305657851,141,0.0472045530633,26,0.00870438567124,1546,22,15,1539,1561,13,0.00435219283562,1546,0.517576163375,225,0.0753264144627,2762,0.924673585537,1201,0.402075661199,15,Franklin,3706915
Franklin,2358,1191,0.505089058524,1059,0.449109414758,11,0.00466497031383,16,0.00678541136556,54,0.0229007633588,27,0.0114503816794,1069,24,21,1066,1090,10,0.00424088210348,1069,0.453350296862,122,0.0517387616624,2236,0.948261238338,1151,0.48812553011,16,Franklin,3706916
Franklin,3452,2773,0.803302433372,449,0.130069524913,18,0.00521436848204,18,0.00521436848204,147,0.04258400927,47,0.0136152954809,469,38,29,460,498,20,0.00579374275782,469,0.135863267671,226,0.0654692931634,3226,0.934530706837,2712,0.785631517961,17,Franklin,3706917
Franklin,2507,2082,0.830474670921,303,0.120861587555,16,0.0063821300359,20,0.00797766254487,57,0.0227363382529,29,0.0115676106901,312,27,22,307,334,9,0.00358994814519,312,0.1244515357,116,0.0462704427603,2391,0.95372955724,2041,0.814120462704,18,Franklin,3706918
Franklin,4085,3074,0.752509179927,727,0.177968176255,7,0.00171358629131,62,0.0151774785802,166,0.0406364749082,49,0.0119951040392,738,26,22,734,760,11,0.00269277845777,738,0.180660954712,333,0.081517747858,3752,0.918482252142,2943,0.720440636475,19,Franklin,3706919
Gaston,1361,1039,0.763409257899,265,0.194709772226,4,0.00293901542983,18,0.0132255694342,17,0.0124908155768,18,0.0132255694342,276,14,8,270,284,11,0.00808229243204,276,0.202792064658,28,0.0205731080088,1333,0.979426891991,1027,0.754592211609,01,Gaston,3707101
Gaston,3162,1893,0.598671726755,1040,0.328905755851,10,0.00316255534472,25,0.0079063883618,164,0.0518659076534,30,0.00948766603416,1051,23,19,1047,1070,11,0.00347881087919,1051,0.33238456673,300,0.0948766603416,2862,0.905123339658,1782,0.563567362429,02,Gaston,3707102
Gaston,2368,1275,0.538429054054,946,0.399493243243,8,0.00337837837838,6,0.00253378378378,93,0.0392736486486,40,0.0168918918919,968,21,16,963,984,22,0.00929054054054,968,0.408783783784,184,0.0777027027027,2184,0.922297297297,1210,0.51097972973,03,Gaston,3707103
Gaston,6206,4545,0.732355784724,1167,0.188043828553,19,0.00306155333548,56,0.00902352562037,344,0.0554302288108,75,0.0120850789558,1190,56,51,1185,1241,23,0.00370609087979,1190,0.191749919433,646,0.104092813406,5560,0.895907186594,4279,0.689494038028,04,Gaston,3707104
Gaston,3429,1826,0.532516768737,1451,0.423155438903,19,0.00554097404491,11,0.00320793234179,76,0.0221638961796,46,0.0134149897929,1473,42,39,1470,1512,22,0.00641586468358,1473,0.429571303587,121,0.0352872557597,3308,0.96471274424,1789,0.52172645086,05,Gaston,3707105
Gaston,2439,974,0.39934399344,1187,0.486674866749,17,0.0069700697007,10,0.00410004100041,217,0.0889708897089,34,0.0139401394014,1204,30,27,1201,1231,17,0.0069700697007,1204,0.493644936449,387,0.158671586716,2052,0.841328413284,841,0.344813448134,06,Gaston,3707106
Gaston,1787,479,0.268047006156,1285,0.719082260772,5,0.00279798545048,1,0.000559597090095,4,0.00223838836038,13,0.00727476217124,1295,15,8,1288,1303,10,0.00559597090095,1295,0.724678231673,31,0.0173475097929,1756,0.982652490207,458,0.256295467264,07,Gaston,3707107
Gaston,2290,1159,0.506113537118,924,0.403493449782,6,0.00262008733624,6,0.00262008733624,144,0.0628820960699,51,0.0222707423581,950,25,16,941,966,26,0.0113537117904,950,0.414847161572,226,0.0986899563319,2064,0.901310043668,1101,0.480786026201,08,Gaston,3707108
Gaston,2476,1555,0.62802907916,638,0.257673667205,23,0.00928917609047,18,0.00726978998384,188,0.075928917609,54,0.0218093699515,664,50,40,654,704,26,0.0105008077544,664,0.26817447496,299,0.120759289176,2177,0.879240710824,1470,0.593699515347,09,Gaston,3707109
Gaston,2998,2196,0.73248832555,633,0.211140760507,13,0.00433622414943,17,0.00567044696464,92,0.0306871247498,47,0.0156771180787,654,32,22,644,676,21,0.00700466977985,654,0.218145430287,205,0.0683789192795,2793,0.93162108072,2104,0.701801200801,10,Gaston,3707110
Gaston,2616,1684,0.64373088685,785,0.300076452599,20,0.00764525993884,14,0.00535168195719,76,0.0290519877676,37,0.0141437308869,804,33,30,801,834,19,0.0072629969419,804,0.307339449541,168,0.0642201834862,2448,0.935779816514,1608,0.614678899083,11,Gaston,3707111
Gaston,4136,3447,0.833413926499,432,0.104448742747,15,0.00362669245648,23,0.00556092843327,183,0.0442456479691,36,0.00870406189555,446,31,29,444,475,14,0.00338491295938,446,0.107833655706,314,0.075918762089,3822,0.924081237911,3330,0.805125725338,12,Gaston,3707112
Gaston,2880,2314,0.803472222222,372,0.129166666667,17,0.00590277777778,45,0.015625,94,0.0326388888889,38,0.0131944444444,383,30,25,378,408,11,0.00381944444444,383,0.132986111111,161,0.0559027777778,2719,0.944097222222,2255,0.782986111111,13,Gaston,3707113
Gaston,1115,993,0.890582959641,66,0.0591928251121,0,0.0,18,0.0161434977578,26,0.0233183856502,12,0.0107623318386,68,0,0,68,68,2,0.00179372197309,68,0.0609865470852,51,0.0457399103139,1064,0.954260089686,966,0.866367713004,14,Gaston,3707114
Gaston,5514,4220,0.765324628219,911,0.165215814291,26,0.00471527022125,145,0.0262966993108,134,0.0243017772942,78,0.0141458106638,938,55,42,925,980,27,0.00489662676823,938,0.170112441059,317,0.0574900253899,5197,0.94250997461,4084,0.740660137831,15,Gaston,3707115
Gaston,3510,3098,0.882621082621,283,0.0806267806268,5,0.0014245014245,72,0.0205128205128,21,0.00598290598291,31,0.00883190883191,286,15,14,285,300,3,0.000854700854701,286,0.0814814814815,72,0.0205128205128,3438,0.979487179487,3058,0.871225071225,16,Gaston,3707116
Gaston,4072,3063,0.75221021611,734,0.18025540275,14,0.00343811394892,106,0.0260314341847,123,0.0302062868369,32,0.00785854616896,743,26,22,739,765,9,0.00221021611002,743,0.182465618861,261,0.0640962671906,3811,0.935903732809,2944,0.722986247544,17,Gaston,3707117
Gaston,6431,4651,0.723215674079,1065,0.165604105116,29,0.00450940755715,146,0.022702534598,452,0.0702845591665,88,0.0136837194838,1090,59,55,1086,1145,25,0.00388742030788,1090,0.169491525424,778,0.120976519981,5653,0.879023480019,4363,0.678432592132,18,Gaston,3707118
Gaston,6099,4936,0.809313002131,776,0.127233972782,30,0.00491883915396,29,0.00475487784883,238,0.0390227906214,90,0.0147565174619,805,76,64,793,869,29,0.00475487784883,805,0.131988850631,423,0.0693556320708,5676,0.930644367929,4783,0.784226922446,19,Gaston,3707119
Gaston,4326,3789,0.875866851595,359,0.0829865926953,15,0.00346740638003,20,0.0046232085067,88,0.0203421174295,55,0.0127138233934,377,37,33,373,410,18,0.00416088765603,377,0.0871474803514,161,0.037216828479,4165,0.962783171521,3734,0.863153028202,20,Gaston,3707120
Gaston,2849,2123,0.745173745174,627,0.220077220077,17,0.00596700596701,20,0.00702000702001,38,0.013338013338,24,0.00842400842401,639,32,27,634,666,12,0.004212004212,639,0.224289224289,69,0.024219024219,2780,0.975780975781,2098,0.736398736399,21,Gaston,3707121
Gaston,4557,3928,0.861970594689,479,0.105113012947,19,0.00416940969936,22,0.00482773754663,66,0.0144832126399,43,0.00943603247751,496,42,30,484,526,17,0.00373052446785,496,0.108843537415,169,0.0370858020628,4388,0.962914197937,3839,0.842440201887,22,Gaston,3707122
Gaston,2937,2564,0.872999659517,245,0.083418454205,7,0.00238338440586,47,0.0160027238679,40,0.013619339462,34,0.0115764385427,259,20,18,257,277,14,0.00476676881171,259,0.0881852230167,92,0.0313244807627,2845,0.968675519237,2524,0.859380320054,23,Gaston,3707123
Gaston,3033,2500,0.824266402901,305,0.100560501154,13,0.00428618529509,138,0.0454995054402,41,0.0135179690076,36,0.0118694362018,311,32,29,308,340,6,0.00197823936696,311,0.102538740521,77,0.0253874052094,2956,0.974612594791,2472,0.815034619189,24,Gaston,3707124
Gaston,2736,2442,0.892543859649,148,0.0540935672515,7,0.00255847953216,81,0.0296052631579,40,0.0146198830409,18,0.00657894736842,157,13,10,154,167,9,0.00328947368421,157,0.0573830409357,103,0.0376461988304,2633,0.96235380117,2380,0.869883040936,25,Gaston,3707125
Gaston,3335,2860,0.857571214393,230,0.0689655172414,18,0.00539730134933,74,0.0221889055472,133,0.03988005997,20,0.00599700149925,236,25,25,236,261,6,0.00179910044978,236,0.0707646176912,251,0.0752623688156,3084,0.924737631184,2747,0.823688155922,26,Gaston,3707126
Gaston,3293,2972,0.902520498026,168,0.0510173094443,8,0.00242939568782,119,0.0361372608564,11,0.00334041907076,15,0.00455511691467,173,13,12,172,185,5,0.00151837230489,173,0.0525356817492,56,0.0170057698148,3237,0.982994230185,2930,0.889766170665,27,Gaston,3707127
Gaston,3120,2904,0.930769230769,114,0.0365384615385,17,0.00544871794872,55,0.0176282051282,7,0.00224358974359,23,0.00737179487179,115,30,30,115,145,1,0.000320512820513,115,0.036858974359,39,0.0125,3081,0.9875,2873,0.920833333333,28,Gaston,3707128
Gaston,3575,3295,0.921678321678,174,0.0486713286713,8,0.00223776223776,55,0.0153846153846,20,0.00559440559441,23,0.00643356643357,179,19,18,178,197,5,0.0013986013986,179,0.0500699300699,59,0.0165034965035,3516,0.983496503497,3258,0.911328671329,29,Gaston,3707129
Gaston,2910,2596,0.892096219931,138,0.0474226804124,20,0.00687285223368,41,0.014089347079,89,0.0305841924399,26,0.00893470790378,138,30,30,138,168,0,0.0,138,0.0474226804124,127,0.0436426116838,2783,0.956357388316,2569,0.882817869416,30,Gaston,3707130
Gaston,3290,3003,0.912765957447,222,0.0674772036474,13,0.00395136778116,16,0.0048632218845,13,0.00395136778116,23,0.00699088145897,229,29,27,227,256,7,0.00212765957447,229,0.0696048632219,49,0.0148936170213,3241,0.985106382979,2969,0.902431610942,31,Gaston,3707131
Gaston,2681,2344,0.874300634092,216,0.0805669526296,14,0.00522193211488,30,0.0111898545319,54,0.0201417381574,23,0.00857888847445,219,25,23,217,242,3,0.00111898545319,219,0.0816859380828,133,0.0496083550914,2548,0.950391644909,2278,0.849682954122,32,Gaston,3707132
Gaston,2649,2439,0.920724801812,135,0.0509626274066,19,0.00717251793129,6,0.00226500566251,18,0.00679501698754,32,0.0120800302001,144,38,37,143,181,9,0.00339750849377,144,0.0543601359003,40,0.0151000377501,2609,0.98489996225,2424,0.915062287656,33,Gaston,3707133
Gaston,2882,2715,0.942054129077,95,0.0329632199861,10,0.00346981263012,3,0.00104094378904,39,0.0135322692575,20,0.00693962526024,96,27,27,96,123,1,0.000346981263012,96,0.0333102012491,57,0.0197779319917,2825,0.980222068008,2697,0.935808466343,34,Gaston,3707134
Gaston,1921,1702,0.885996876627,167,0.0869338885997,5,0.00260281103592,11,0.00572618427902,17,0.00884955752212,19,0.00989068193649,175,11,10,174,185,8,0.00416449765747,175,0.0910983862572,44,0.0229047371161,1877,0.977095262884,1674,0.871421134826,35,Gaston,3707135
Gaston,3625,3316,0.91475862069,168,0.0463448275862,4,0.00110344827586,27,0.00744827586207,78,0.0215172413793,32,0.0088275862069,169,18,18,169,187,1,0.000275862068966,169,0.0466206896552,135,0.0372413793103,3490,0.96275862069,3270,0.902068965517,36,Gaston,3707136
Gaston,1667,1472,0.883023395321,163,0.0977804439112,7,0.00419916016797,4,0.00239952009598,13,0.00779844031194,8,0.00479904019196,167,12,10,165,177,4,0.00239952009598,167,0.100179964007,26,0.0155968806239,1641,0.984403119376,1459,0.875224955009,37,Gaston,3707137
Gaston,3183,3031,0.952246308514,77,0.0241910147659,21,0.00659754948162,9,0.00282752120641,15,0.00471253534402,30,0.00942507068803,83,42,40,81,123,6,0.00188501413761,83,0.0260760289036,42,0.0131950989632,3141,0.986804901037,3008,0.945020420986,38,Gaston,3707138
Gaston,4107,3918,0.953981008035,93,0.0226442658875,18,0.00438276113952,12,0.00292184075968,27,0.00657414170928,39,0.00949598246896,98,39,39,98,137,5,0.00121743364987,98,0.0238616995374,51,0.0124178232286,4056,0.987582176771,3898,0.949111273436,39,Gaston,3707139
Gaston,5142,4116,0.800466744457,836,0.162582652664,24,0.0046674445741,36,0.00700116686114,77,0.0149747180086,53,0.0103072734345,863,42,36,857,899,27,0.00525087514586,863,0.16783352781,158,0.0307273434461,4984,0.969272656554,4054,0.788409179308,40,Gaston,3707140
Gaston,3546,3247,0.91567963903,151,0.0425831923294,11,0.00310208685843,19,0.0053581500282,91,0.0256627185561,27,0.00761421319797,156,29,29,156,185,5,0.00141003948111,156,0.0439932318105,160,0.0451212633954,3386,0.954878736605,3184,0.897913141568,41,Gaston,3707141
Gaston,2328,2109,0.905927835052,138,0.0592783505155,12,0.00515463917526,35,0.0150343642612,17,0.00730240549828,17,0.00730240549828,142,22,22,142,164,4,0.00171821305842,142,0.0609965635739,40,0.0171821305842,2288,0.982817869416,2088,0.896907216495,42,Gaston,3707142
Gaston,4526,3945,0.871630578878,449,0.0992045956695,23,0.00508174988953,25,0.00552364118427,45,0.00994255413168,39,0.00861688024746,459,40,38,457,497,10,0.00220945647371,459,0.101414052143,137,0.0302695536898,4389,0.96973044631,3863,0.853513035793,43,Gaston,3707143
Gaston,4937,4321,0.875227871177,471,0.095402066032,19,0.00384849098643,26,0.00526635608669,60,0.0121531294308,40,0.00810208628722,480,38,32,474,512,9,0.00182296941462,480,0.0972250354466,112,0.0226858416042,4825,0.977314158396,4284,0.867733441361,44,Gaston,3707144
Gaston,3527,2761,0.782818259144,564,0.159909271335,13,0.00368585199887,107,0.0303373972214,28,0.0079387581514,54,0.0153104621491,583,34,27,576,610,19,0.00538701445988,583,0.165296285795,106,0.0300538701446,3421,0.969946129855,2685,0.761270201304,45,Gaston,3707145
Gaston,5274,4812,0.912400455063,291,0.0551763367463,16,0.00303375047402,54,0.0102389078498,73,0.0138414865377,28,0.00530906332954,296,31,29,294,325,5,0.000948047023132,296,0.0561243837694,108,0.0204778156997,5166,0.9795221843,4782,0.906712172924,46,Gaston,3707146
Gates,1689,796,0.471284783896,850,0.503256364713,9,0.00532859680284,5,0.00296033155713,3,0.00177619893428,26,0.0153937240971,870,23,10,857,880,20,0.0118413262285,870,0.515097690941,11,0.0065127294257,1678,0.993487270574,792,0.46891651865,1,Gates,370731
Gates,1106,955,0.863471971067,142,0.128390596745,2,0.00180831826401,2,0.00180831826401,0,0.0,5,0.00452079566004,145,5,3,143,148,3,0.00271247739602,145,0.131103074141,9,0.00813743218807,1097,0.991862567812,946,0.855334538879,2,Gates,370732
Gates,2266,1288,0.568402471315,895,0.394969108561,26,0.0114739629303,4,0.0017652250662,28,0.0123565754634,25,0.0110326566637,908,44,33,897,941,13,0.00573698146514,908,0.400706090026,45,0.0198587819947,2221,0.980141218005,1274,0.562224183583,3,Gates,370733
Gates,1965,1503,0.764885496183,415,0.211195928753,11,0.00559796437659,4,0.00203562340967,15,0.00763358778626,17,0.00865139949109,428,21,13,420,441,13,0.00661577608142,428,0.217811704835,31,0.0157760814249,1934,0.984223918575,1489,0.757760814249,4N,Gates,370734N
Gates,1064,544,0.511278195489,497,0.467105263158,4,0.00375939849624,2,0.00187969924812,3,0.00281954887218,14,0.0131578947368,505,11,8,502,513,8,0.00751879699248,505,0.47462406015,12,0.0112781954887,1052,0.988721804511,537,0.50469924812,4S,Gates,370734S
Gates,1204,883,0.733388704319,297,0.246677740864,4,0.00332225913621,5,0.00415282392027,1,0.000830564784053,14,0.0116279069767,300,15,12,297,312,3,0.00249169435216,300,0.249169435216,7,0.00581395348837,1197,0.994186046512,877,0.728405315615,5,Gates,370735
Graham,2781,2648,0.952175476447,2,0.000719165767709,64,0.0230133045667,11,0.0039554117224,24,0.00862998921251,32,0.0115066522834,4,92,91,3,95,2,0.000719165767709,4,0.00143833153542,28,0.0100683207479,2753,0.989931679252,2645,0.951096727796,EAST,Graham,37075EAST
Graham,1183,1167,0.986475063398,0,0.0,13,0.010989010989,0,0.0,0,0.0,3,0.00253592561285,0,16,16,0,16,0,0.0,0,0.0,8,0.00676246830093,1175,0.993237531699,1161,0.981403212172,STEC,Graham,37075STEC
Graham,500,486,0.972,0,0.0,2,0.004,3,0.006,3,0.006,6,0.012,1,7,7,1,8,1,0.002,1,0.002,6,0.012,494,0.988,483,0.966,TAPO,Graham,37075TAPO
Graham,2484,2131,0.857890499195,2,0.000805152979066,276,0.111111111111,11,0.00442834138486,31,0.0124798711755,33,0.0132850241546,5,305,304,4,309,3,0.0012077294686,5,0.00201288244767,71,0.0285829307568,2413,0.971417069243,2109,0.849033816425,WEST,Graham,37075WEST
Granville,1087,412,0.379024839006,646,0.594296228151,3,0.00275988960442,7,0.0064397424103,15,0.0137994480221,4,0.00367985280589,650,7,3,646,653,4,0.00367985280589,650,0.597976080957,23,0.0211591536339,1064,0.978840846366,405,0.372585096596,ANTI,Granville,37077ANTI
Granville,1818,1137,0.625412541254,614,0.337733773377,7,0.0038503850385,7,0.0038503850385,39,0.0214521452145,14,0.00770077007701,622,18,12,616,634,8,0.004400440044,622,0.342134213421,62,0.034103410341,1756,0.965896589659,1127,0.619911991199,BERE,Granville,37077BERE
Granville,9895,4762,0.481253158161,4259,0.430419403739,129,0.0130368873168,42,0.00424456796362,522,0.0527539161193,181,0.0182920667004,4338,193,162,4307,4500,79,0.00798383021728,4338,0.438403233957,1220,0.123294593229,8675,0.876705406771,4222,0.426680141486,BTNR,Granville,37077BTNR
Granville,2668,1555,0.582833583208,813,0.304722638681,10,0.00374812593703,8,0.00299850074963,265,0.0993253373313,17,0.00637181409295,816,13,13,816,829,3,0.00112443778111,816,0.305847076462,327,0.122563718141,2341,0.877436281859,1500,0.562218890555,CORI,Granville,37077CORI
Granville,2054,984,0.479065238559,986,0.480038948393,5,0.00243427458617,12,0.00584225900682,46,0.0223953261928,21,0.0102239532619,1001,16,10,995,1011,15,0.00730282375852,1001,0.487341772152,68,0.033106134372,1986,0.966893865628,964,0.469328140214,CRDL,Granville,37077CRDL
Granville,4794,3156,0.65832290363,1372,0.286191072174,25,0.00521485189821,66,0.0137672090113,130,0.0271172298707,45,0.00938673341677,1397,57,39,1379,1436,25,0.00521485189821,1397,0.291405924072,252,0.0525657071339,4542,0.947434292866,3064,0.639132248644,CRDM,Granville,37077CRDM
Granville,2162,923,0.426919518964,1171,0.541628122109,13,0.00601295097132,12,0.00555041628122,21,0.00971322849214,22,0.0101757631822,1181,20,15,1176,1196,10,0.00462534690102,1181,0.54625346901,49,0.022664199815,2113,0.977335800185,911,0.421369102683,EAOX,Granville,37077EAOX
Granville,4042,3122,0.772389905987,768,0.190004948046,19,0.00470064324592,27,0.00667986145473,70,0.0173181593271,36,0.00890648193963,776,40,37,773,813,8,0.00197921820881,776,0.191984166254,184,0.0455220188026,3858,0.954477981197,3028,0.749134092034,MTEN,Granville,37077MTEN
Granville,1426,814,0.570827489481,584,0.4095371669,7,0.00490883590463,0,0.0,11,0.00771388499299,10,0.0070126227209,589,10,8,587,597,5,0.00350631136045,589,0.413043478261,26,0.0182328190743,1400,0.981767180926,806,0.565217391304,OKHL,Granville,37077OKHL
Granville,2009,1274,0.634146341463,645,0.321055251369,2,0.000995520159283,31,0.0154305624689,41,0.0204081632653,16,0.00796416127427,651,8,6,649,657,6,0.00298656047785,651,0.324041811847,82,0.0408163265306,1927,0.959183673469,1245,0.619711299154,SALM,Granville,37077SALM
Granville,2159,1446,0.66975451598,651,0.30152848541,2,0.000926354793886,5,0.00231588698472,39,0.0180639184808,16,0.00741083835109,658,7,6,657,664,7,0.0032422417786,658,0.304770727189,70,0.032422417786,2089,0.967577582214,1421,0.658175081056,SASS,Granville,37077SASS
Granville,1706,541,0.317116060961,1084,0.635404454865,6,0.00351699882767,13,0.00762016412661,38,0.0222743259086,24,0.0140679953107,1104,14,9,1099,1113,20,0.0117233294256,1104,0.647127784291,105,0.0615474794842,1601,0.938452520516,495,0.290152403283,SOOX,Granville,37077SOOX
Granville,4219,3430,0.812988859919,649,0.153827921308,13,0.00308129888599,12,0.00284427589476,83,0.0196729082721,32,0.00758473571936,660,36,30,654,690,11,0.00260725290353,660,0.156435174212,151,0.0357904716758,4068,0.964209528324,3368,0.798293434463,TYHO,Granville,37077TYHO
Granville,4845,4169,0.860474716202,484,0.0998968008256,17,0.00350877192982,31,0.00639834881321,91,0.018782249742,53,0.0109391124871,499,41,35,493,534,15,0.0030959752322,499,0.102992776058,190,0.0392156862745,4655,0.960784313725,4093,0.844788441692,WILT,Granville,37077WILT
Granville,1699,751,0.442024720424,882,0.519128899353,1,0.00058858151854,3,0.00176574455562,58,0.0341377280753,4,0.00235432607416,884,2,2,884,886,2,0.00117716303708,884,0.52030606239,67,0.0394349617422,1632,0.960565038258,747,0.43967039435,WOEL,Granville,37077WOEL
Greene,1121,543,0.484388938448,492,0.438893844781,7,0.00624442462087,0,0.0,70,0.0624442462087,9,0.00802854594112,498,12,10,496,508,6,0.00535236396075,498,0.444246208742,101,0.0900981266726,1020,0.909901873327,525,0.468331846566,ARBA,Greene,37079ARBA
Greene,1060,685,0.646226415094,296,0.279245283019,0,0.0,6,0.00566037735849,51,0.0481132075472,22,0.0207547169811,304,8,7,303,311,8,0.00754716981132,304,0.28679245283,100,0.0943396226415,960,0.905660377358,648,0.611320754717,BEAR,Greene,37079BEAR
Greene,1249,672,0.538030424339,427,0.341873498799,9,0.00720576461169,0,0.0,136,0.108887109688,5,0.00400320256205,427,12,12,427,439,0,0.0,427,0.341873498799,199,0.15932746197,1050,0.84067253803,616,0.493194555645,BULL,Greene,37079BULL
Greene,1100,704,0.64,327,0.297272727273,7,0.00636363636364,2,0.00181818181818,55,0.05,5,0.00454545454545,329,8,7,328,336,2,0.00181818181818,329,0.299090909091,68,0.0618181818182,1032,0.938181818182,693,0.63,CAST,Greene,37079CAST
Greene,966,522,0.540372670807,283,0.292960662526,5,0.00517598343685,5,0.00517598343685,137,0.14182194617,14,0.0144927536232,286,7,7,286,293,3,0.00310559006211,286,0.296066252588,162,0.167701863354,804,0.832298136646,508,0.525879917184,HOOK,Greene,37079HOOK
Greene,4104,1839,0.448099415205,1977,0.481725146199,58,0.0141325536062,14,0.00341130604288,178,0.0433723196881,38,0.00925925925926,2000,76,65,1989,2065,23,0.00560428849903,2000,0.487329434698,356,0.0867446393762,3748,0.913255360624,1689,0.411549707602,MAUR,Greene,37079MAUR
Greene,2002,1088,0.543456543457,801,0.4000999001,1,0.0004995004995,8,0.003996003996,91,0.0454545454545,13,0.00649350649351,809,6,4,807,813,8,0.003996003996,809,0.404095904096,113,0.0564435564436,1889,0.943556443556,1071,0.534965034965,SH1,Greene,37079SH1
Greene,1989,1269,0.638009049774,540,0.27149321267,10,0.00502765208648,7,0.00351935646053,138,0.0693815987934,25,0.0125691302162,546,21,19,544,565,6,0.00301659125189,546,0.274509803922,254,0.127702362996,1735,0.872297637004,1176,0.59125188537,SHIN,Greene,37079SHIN
Greene,1269,651,0.513002364066,485,0.38219070134,7,0.00551615445232,7,0.00551615445232,109,0.0858944050433,10,0.00788022064618,488,11,9,486,497,3,0.00236406619385,488,0.384554767533,136,0.107171000788,1133,0.892828999212,629,0.495665878645,SUGG,Greene,37079SUGG
Greene,1550,843,0.543870967742,451,0.290967741935,13,0.00838709677419,8,0.00516129032258,219,0.141290322581,16,0.0103225806452,455,26,23,452,478,4,0.00258064516129,455,0.293548387097,338,0.218064516129,1212,0.781935483871,745,0.48064516129,WALS,Greene,37079WALS
Guilford,3006,2227,0.740851630073,563,0.187292082502,6,0.00199600798403,130,0.043246839654,35,0.0116433799069,45,0.0149700598802,589,16,11,584,600,26,0.00864936793081,589,0.195941450432,108,0.0359281437126,2898,0.964071856287,2165,0.720226214238,CG1,Guilford,37081CG1
Guilford,1818,1513,0.832233223322,208,0.114411441144,3,0.0016501650165,68,0.037403740374,12,0.00660066006601,14,0.00770077007701,214,6,5,213,219,6,0.003300330033,214,0.117711771177,48,0.026402640264,1770,0.973597359736,1485,0.816831683168,CG2,Guilford,37081CG2
Guilford,1807,1493,0.826231322634,214,0.118428334256,1,0.000553403431101,71,0.0392916436082,8,0.00442722744881,20,0.011068068622,221,6,4,219,225,7,0.00387382401771,221,0.122302158273,38,0.0210293303818,1769,0.978970669618,1462,0.80907581627,CG3A,Guilford,37081CG3A
Guilford,2182,1680,0.76993583868,386,0.17690192484,6,0.00274977085243,65,0.0297891842346,15,0.00687442713107,30,0.0137488542621,399,16,11,394,410,13,0.00595783684693,399,0.182859761687,61,0.0279560036664,2121,0.972043996334,1641,0.752062328139,CG3B,Guilford,37081CG3B
Guilford,3654,1561,0.427203065134,1865,0.510399562124,21,0.00574712643678,73,0.019978106185,79,0.0216201423098,55,0.0150519978106,1899,46,30,1883,1929,34,0.00930487137384,1899,0.519704433498,132,0.0361247947455,3522,0.963875205255,1521,0.416256157635,FEN1,Guilford,37081FEN1
Guilford,1748,1600,0.91533180778,117,0.0669336384439,7,0.00400457665904,10,0.00572082379863,3,0.00171624713959,11,0.00629290617849,124,12,8,120,132,7,0.00400457665904,124,0.070938215103,10,0.00572082379863,1738,0.994279176201,1594,0.911899313501,FEN2,Guilford,37081FEN2
Guilford,4151,2416,0.582028426885,1283,0.30908214888,15,0.00361358708745,281,0.0676945314382,89,0.0214406167189,67,0.0161406889906,1315,37,28,1306,1343,32,0.00770898578656,1315,0.316791134666,235,0.05661286437,3916,0.94338713563,2287,0.550951577933,FR1,Guilford,37081FR1
Guilford,2466,1864,0.755879967559,297,0.120437956204,9,0.0036496350365,255,0.103406326034,21,0.00851581508516,20,0.0081103000811,305,19,15,301,320,8,0.00324412003244,305,0.123682076237,67,0.0271695052717,2399,0.972830494728,1823,0.739253852393,FR2,Guilford,37081FR2
Guilford,1515,1191,0.786138613861,215,0.141914191419,2,0.0013201320132,70,0.046204620462,17,0.0112211221122,20,0.013201320132,221,9,7,219,228,6,0.0039603960396,221,0.145874587459,58,0.0382838283828,1457,0.961716171617,1150,0.759075907591,FR3,Guilford,37081FR3
Guilford,1387,1222,0.881038211968,100,0.0720980533526,3,0.00216294160058,29,0.0209084354722,22,0.0158615717376,11,0.00793078586878,103,3,3,103,106,3,0.00216294160058,103,0.0742609949531,58,0.0418168709445,1329,0.958183129056,1187,0.855803893295,FR4,Guilford,37081FR4
Guilford,3455,2861,0.828075253256,356,0.103039073806,9,0.00260492040521,128,0.0370477568741,50,0.0144717800289,51,0.0147612156295,370,27,22,365,392,14,0.0040520984081,370,0.107091172214,178,0.051519536903,3277,0.948480463097,2746,0.79479015919,FR5,Guilford,37081FR5
Guilford,1248,464,0.371794871795,688,0.551282051282,4,0.00320512820513,52,0.0416666666667,14,0.0112179487179,26,0.0208333333333,706,15,7,698,713,18,0.0144230769231,706,0.565705128205,37,0.0296474358974,1211,0.970352564103,451,0.361378205128,G01,Guilford,37081G01
Guilford,1599,641,0.400875547217,555,0.347091932458,15,0.0093808630394,250,0.156347717323,100,0.0625390869293,38,0.0237648530331,574,35,22,561,596,19,0.0118824265166,574,0.358974358974,189,0.118198874296,1410,0.881801125704,575,0.359599749844,G02,Guilford,37081G02
Guilford,2294,222,0.0967741935484,1844,0.803836094159,11,0.00479511769834,75,0.0326939843069,86,0.0374891020052,56,0.0244115082825,1879,46,22,1855,1901,35,0.0152571926765,1879,0.819093286835,147,0.0640802092415,2147,0.935919790759,182,0.079337401918,G03,Guilford,37081G03
Guilford,2355,316,0.134182590234,1837,0.780042462845,22,0.00934182590234,4,0.00169851380042,138,0.0585987261146,38,0.016135881104,1866,41,25,1850,1891,29,0.0123142250531,1866,0.792356687898,198,0.084076433121,2157,0.915923566879,278,0.11804670913,G04,Guilford,37081G04
Guilford,1465,48,0.0327645051195,1372,0.936518771331,7,0.00477815699659,4,0.00273037542662,16,0.0109215017065,18,0.0122866894198,1388,17,9,1380,1397,16,0.0109215017065,1388,0.947440273038,27,0.0184300341297,1438,0.98156996587,46,0.0313993174061,G05,Guilford,37081G05
Guilford,1575,77,0.0488888888889,1371,0.870476190476,11,0.00698412698413,35,0.0222222222222,59,0.0374603174603,22,0.0139682539683,1389,23,13,1379,1402,18,0.0114285714286,1389,0.881904761905,83,0.0526984126984,1492,0.947301587302,65,0.0412698412698,G06,Guilford,37081G06
Guilford,2714,978,0.360353721444,1355,0.499263080324,17,0.00626381724392,208,0.0766396462786,86,0.0316875460575,70,0.0257921886514,1398,56,33,1375,1431,43,0.0158437730287,1398,0.515106853353,165,0.0607958732498,2549,0.93920412675,919,0.33861459101,G07,Guilford,37081G07
Guilford,2993,924,0.308720347477,1484,0.495823588373,11,0.00367524223187,322,0.107584363515,192,0.0641496825927,60,0.0200467758102,1513,27,18,1504,1531,29,0.00968927497494,1513,0.505512863348,295,0.0985633144003,2698,0.9014366856,846,0.282659538924,G08,Guilford,37081G08
Guilford,3145,967,0.30747217806,1894,0.602225755167,18,0.00572337042925,66,0.0209856915739,145,0.0461049284579,55,0.0174880763116,1930,40,24,1914,1954,36,0.0114467408585,1930,0.613672496025,268,0.0852146263911,2877,0.914785373609,883,0.280763116057,G09,Guilford,37081G09
Guilford,3471,1049,0.30221838087,1982,0.571016997983,21,0.00605012964564,129,0.0371650821089,213,0.0613656006914,77,0.0221838087007,2012,47,37,2002,2049,30,0.00864304235091,2012,0.579660040334,370,0.106597522328,3101,0.893402477672,944,0.271967732642,G10,Guilford,37081G10
Guilford,1493,1231,0.824514400536,196,0.131279303416,10,0.00669792364367,30,0.020093770931,7,0.00468854655057,19,0.012726054923,206,17,15,204,221,10,0.00669792364367,206,0.13797722706,28,0.0187541862023,1465,0.981245813798,1212,0.811788345613,G11,Guilford,37081G11
Guilford,1176,999,0.849489795918,84,0.0714285714286,11,0.0093537414966,57,0.0484693877551,8,0.00680272108844,17,0.0144557823129,90,19,17,88,107,6,0.00510204081633,90,0.0765306122449,34,0.0289115646259,1142,0.971088435374,975,0.829081632653,G12,Guilford,37081G12
Guilford,1444,1311,0.907894736842,81,0.0560941828255,5,0.00346260387812,15,0.0103878116343,15,0.0103878116343,17,0.0117728531856,90,8,7,89,97,9,0.00623268698061,90,0.0623268698061,32,0.0221606648199,1412,0.97783933518,1297,0.898199445983,G13,Guilford,37081G13
Guilford,1138,1075,0.944639718805,31,0.0272407732865,2,0.00175746924429,17,0.0149384885764,3,0.00263620386643,10,0.00878734622144,32,11,10,31,42,1,0.000878734622144,32,0.0281195079086,24,0.0210896309315,1114,0.978910369069,1056,0.927943760984,G14,Guilford,37081G14
Guilford,1405,1296,0.922419928826,73,0.0519572953737,1,0.000711743772242,14,0.00996441281139,3,0.00213523131673,18,0.0128113879004,80,1,1,80,81,7,0.00498220640569,80,0.0569395017794,20,0.0142348754448,1385,0.985765124555,1287,0.916014234875,G15,Guilford,37081G15
Guilford,1327,1283,0.966842501884,28,0.0211002260739,1,0.000753579502638,7,0.00527505651846,2,0.00150715900528,6,0.00452147701583,29,3,2,28,31,1,0.000753579502638,29,0.0218538055765,10,0.00753579502638,1317,0.992464204974,1276,0.961567445365,G16,Guilford,37081G16
Guilford,1680,1509,0.898214285714,100,0.0595238095238,3,0.00178571428571,42,0.025,8,0.0047619047619,18,0.0107142857143,104,11,11,104,115,4,0.00238095238095,104,0.0619047619048,24,0.0142857142857,1656,0.985714285714,1495,0.889880952381,G17,Guilford,37081G17
Guilford,1184,1151,0.972128378378,20,0.0168918918919,0,0.0,6,0.00506756756757,4,0.00337837837838,3,0.00253378378378,21,1,1,21,22,1,0.000844594594595,21,0.0177364864865,11,0.00929054054054,1173,0.990709459459,1144,0.966216216216,G18,Guilford,37081G18
Guilford,1661,1444,0.869355809753,181,0.108970499699,3,0.00180614087899,18,0.0108368452739,6,0.00361228175798,9,0.00541842263697,186,7,5,184,191,5,0.00301023479831,186,0.111980734497,13,0.00782661047562,1648,0.992173389524,1436,0.864539434076,G19,Guilford,37081G19
Guilford,2471,2088,0.845002023472,301,0.121813031161,4,0.00161877782274,36,0.0145690004047,16,0.00647511129098,26,0.0105220558478,316,16,7,307,323,15,0.00607041683529,316,0.127883447997,58,0.0234722784298,2413,0.97652772157,2062,0.834479967624,G20,Guilford,37081G20
Guilford,3953,2424,0.613205160637,958,0.242347584113,21,0.00531242094612,325,0.0822160384518,152,0.0384518087528,73,0.0184669870984,1001,51,36,986,1037,43,0.0108778143182,1001,0.253225398432,240,0.0607133822413,3713,0.939286617759,2356,0.596003035669,G21,Guilford,37081G21
Guilford,1556,1366,0.877892030848,132,0.0848329048843,2,0.0012853470437,25,0.0160668380463,18,0.0115681233933,13,0.00835475578406,138,7,4,135,142,6,0.00385604113111,138,0.0886889460154,26,0.0167095115681,1530,0.983290488432,1356,0.87146529563,G22,Guilford,37081G22
Guilford,1609,1190,0.739589807334,308,0.191423244251,3,0.00186451211933,51,0.0316967060286,24,0.0149160969546,33,0.0205096333126,329,18,8,319,337,21,0.0130515848353,329,0.204474829086,71,0.0441267868241,1538,0.955873213176,1154,0.717215661902,G23,Guilford,37081G23
Guilford,1463,1011,0.691045796309,372,0.254272043746,3,0.00205058099795,38,0.025974025974,12,0.0082023239918,27,0.0184552289815,392,17,5,380,397,20,0.0136705399863,392,0.267942583732,32,0.0218728639781,1431,0.978127136022,996,0.680792891319,G24,Guilford,37081G24
Guilford,1948,1449,0.743839835729,433,0.22227926078,5,0.00256673511294,27,0.0138603696099,16,0.0082135523614,18,0.00924024640657,441,8,6,439,447,8,0.0041067761807,441,0.226386036961,58,0.0297741273101,1890,0.97022587269,1413,0.725359342916,G25,Guilford,37081G25
Guilford,2826,1352,0.478414720453,1268,0.448690728946,9,0.0031847133758,88,0.0311394196745,55,0.0194621372965,54,0.0191082802548,1292,28,18,1282,1310,24,0.00849256900212,1292,0.457183297948,136,0.0481245576787,2690,0.951875442321,1287,0.455414012739,G26,Guilford,37081G26
Guilford,3025,2475,0.818181818182,428,0.141487603306,7,0.00231404958678,63,0.020826446281,19,0.00628099173554,33,0.0109090909091,448,23,11,436,459,20,0.00661157024793,448,0.148099173554,80,0.0264462809917,2945,0.973553719008,2419,0.799669421488,G27,Guilford,37081G27
Guilford,1401,1103,0.787294789436,249,0.177730192719,4,0.0028551034975,11,0.00785153461813,15,0.0107066381156,19,0.0135617416131,257,11,8,254,265,8,0.005710206995,257,0.183440399714,58,0.0413990007138,1343,0.958600999286,1069,0.763026409707,G28,Guilford,37081G28
Guilford,2246,1687,0.751113089938,408,0.181656277827,10,0.00445235975067,69,0.0307212822796,32,0.0142475512021,40,0.0178094390027,431,29,20,422,451,23,0.0102404274265,431,0.191896705254,93,0.0414069456812,2153,0.958593054319,1635,0.727960819234,G29,Guilford,37081G29
Guilford,1567,1450,0.925335035099,73,0.0465858328015,4,0.00255264837269,17,0.0108487555839,4,0.00255264837269,19,0.0121250797703,79,8,5,76,84,6,0.00382897255903,79,0.0504148053606,19,0.0121250797703,1548,0.98787492023,1434,0.915124441608,G30,Guilford,37081G30
Guilford,1490,1377,0.924161073826,75,0.0503355704698,6,0.00402684563758,18,0.0120805369128,9,0.00604026845638,5,0.00335570469799,75,8,8,75,83,0,0.0,75,0.0503355704698,30,0.0201342281879,1460,0.979865771812,1358,0.911409395973,G31,Guilford,37081G31
Guilford,2235,1998,0.893959731544,128,0.0572706935123,4,0.00178970917226,85,0.0380313199105,6,0.00268456375839,14,0.00626398210291,134,7,6,133,140,6,0.00268456375839,134,0.0599552572707,29,0.0129753914989,2206,0.987024608501,1977,0.884563758389,G32,Guilford,37081G32
Guilford,1547,1489,0.962508080155,25,0.016160310278,2,0.00129282482224,20,0.0129282482224,3,0.00193923723335,8,0.00517129928895,28,8,6,26,34,3,0.00193923723335,28,0.0180995475113,14,0.00904977375566,1533,0.990950226244,1481,0.957336780866,G33,Guilford,37081G33
Guilford,1611,1498,0.929857231533,68,0.0422098075729,4,0.00248292985723,27,0.0167597765363,6,0.00372439478585,8,0.00496585971446,68,7,7,68,75,0,0.0,68,0.0422098075729,29,0.0180012414649,1582,0.981998758535,1478,0.917442582247,G34,Guilford,37081G34
Guilford,1072,1030,0.960820895522,24,0.0223880597015,3,0.00279850746269,7,0.00652985074627,1,0.000932835820896,7,0.00652985074627,27,7,6,26,33,3,0.00279850746269,27,0.0251865671642,10,0.00932835820896,1062,0.990671641791,1021,0.952425373134,G35,Guilford,37081G35
Guilford,2066,1377,0.666505324298,457,0.221200387222,10,0.00484027105518,63,0.0304937076476,99,0.0479186834463,60,0.0290416263311,496,22,17,491,513,39,0.0188770571152,496,0.240077444337,142,0.0687318489835,1924,0.931268151016,1334,0.645692158761,G36,Guilford,37081G36
Guilford,3445,1843,0.534978229318,1249,0.362554426705,23,0.0066763425254,124,0.0359941944848,135,0.0391872278665,71,0.0206095791001,1300,49,28,1279,1328,51,0.0148040638607,1300,0.377358490566,343,0.099564586357,3102,0.900435413643,1672,0.48534107402,G37,Guilford,37081G37
Guilford,2508,1920,0.765550239234,415,0.165470494418,8,0.00318979266348,96,0.0382775119617,32,0.0127591706539,37,0.0147527910686,429,19,15,425,444,14,0.00558213716108,429,0.171052631579,107,0.042663476874,2401,0.957336523126,1858,0.740829346093,G38,Guilford,37081G38
Guilford,2147,1831,0.852817885422,191,0.0889613414066,3,0.00139729855612,37,0.0172333488589,25,0.0116441546344,60,0.0279459711225,220,22,14,212,234,29,0.0135072193759,220,0.102468560782,88,0.040987424313,2059,0.959012575687,1780,0.829063809967,G39,Guilford,37081G39
Guilford,1670,1457,0.87245508982,124,0.074251497006,1,0.00059880239521,56,0.0335329341317,15,0.00898203592814,17,0.0101796407186,129,5,5,129,134,5,0.00299401197605,129,0.077245508982,37,0.0221556886228,1633,0.977844311377,1434,0.858682634731,G40A1,Guilford,37081G40A1
Guilford,1341,1085,0.809097688292,184,0.13721103654,3,0.00223713646532,43,0.0320656226696,9,0.00671140939597,17,0.0126771066368,193,10,6,189,199,9,0.00671140939597,193,0.143922445936,35,0.0260999254288,1306,0.973900074571,1065,0.79418344519,G40A2,Guilford,37081G40A2
Guilford,1608,1277,0.794154228856,198,0.123134328358,1,0.000621890547264,96,0.0597014925373,14,0.00870646766169,22,0.0136815920398,204,12,9,201,213,6,0.00373134328358,204,0.126865671642,47,0.0292288557214,1561,0.970771144279,1248,0.776119402985,G40B,Guilford,37081G40B
Guilford,3761,2810,0.747141717628,600,0.159532039351,11,0.00292475405477,161,0.0428077638926,126,0.0335017282638,53,0.0140919968094,628,22,17,623,645,28,0.00744482850306,628,0.166976867854,227,0.0603562882212,3534,0.939643711779,2723,0.724009571922,G41,Guilford,37081G41
Guilford,2790,2444,0.875985663082,252,0.0903225806452,2,0.000716845878136,38,0.0136200716846,32,0.0114695340502,22,0.0078853046595,259,6,4,257,263,7,0.00250896057348,259,0.0928315412186,66,0.0236559139785,2724,0.976344086022,2414,0.86523297491,G42,Guilford,37081G42
Guilford,3986,2057,0.516056196688,1472,0.369292523833,12,0.00301053687908,132,0.0331159056698,190,0.0476668339187,123,0.0308580030105,1546,53,22,1515,1568,74,0.018564977421,1546,0.387857501254,398,0.099849473156,3588,0.900150526844,1903,0.477420973407,G43,Guilford,37081G43
Guilford,2919,1990,0.681740322028,761,0.260705721137,14,0.00479616306954,60,0.0205549845838,35,0.0119904076739,59,0.0202124015074,792,37,24,779,816,31,0.0106200753683,792,0.271325796506,113,0.0387118876328,2806,0.961288112367,1920,0.65775950668,G44,Guilford,37081G44
Guilford,3797,2481,0.653410587306,988,0.260205425336,12,0.00316038978141,130,0.0342375559652,52,0.0136950223861,134,0.0352910192257,1070,53,23,1040,1093,82,0.0215959968396,1070,0.281801422175,173,0.0455622860153,3624,0.954437713985,2398,0.631551224651,G45,Guilford,37081G45
Guilford,3529,353,0.100028336639,2998,0.849532445452,24,0.0068007934259,23,0.00651742703315,61,0.0172853499575,70,0.0198356474922,3062,57,29,3034,3091,64,0.0181354491357,3062,0.867667894588,125,0.0354207990932,3404,0.964579200907,326,0.0923774440351,G46,Guilford,37081G46
Guilford,2846,1323,0.464862965566,1155,0.405832747716,32,0.011243851019,93,0.0326774420239,167,0.0586788475053,76,0.0267041461701,1199,59,42,1182,1241,44,0.0154602951511,1199,0.421293042867,278,0.0976809557273,2568,0.902319044273,1231,0.432536893886,G47,Guilford,37081G47
Guilford,4072,2989,0.734037328094,712,0.174852652259,15,0.0036836935167,187,0.0459233791749,79,0.0194007858546,90,0.0221021611002,756,36,25,745,781,44,0.0108055009823,756,0.185658153242,176,0.0432220039293,3896,0.956777996071,2914,0.715618860511,G48,Guilford,37081G48
Guilford,1658,774,0.466827503016,700,0.422195416164,7,0.00422195416164,34,0.0205066344994,110,0.0663449939686,33,0.0199034981906,718,20,15,713,733,18,0.0108564535585,718,0.433051869723,215,0.129674306393,1443,0.870325693607,683,0.411942098914,G49,Guilford,37081G49
Guilford,4182,1459,0.34887613582,1814,0.433763749402,79,0.0188904830225,169,0.0404112864658,574,0.137254901961,87,0.0208034433286,1858,109,89,1838,1947,44,0.0105212816834,1858,0.444285031086,911,0.217838354854,3271,0.782161645146,1199,0.286704925873,G50,Guilford,37081G50
Guilford,2391,1016,0.424926808867,813,0.340025094103,26,0.0108741112505,325,0.135926390632,158,0.0660811375993,53,0.0221664575491,841,51,40,830,881,28,0.0117105813467,841,0.35173567545,257,0.107486407361,2134,0.892513592639,933,0.390213299875,G51,Guilford,37081G51
Guilford,2715,513,0.188950276243,1893,0.697237569061,21,0.00773480662983,97,0.0357274401473,141,0.0519337016575,50,0.0184162062615,1934,46,23,1911,1957,41,0.0151012891344,1934,0.712338858195,234,0.0861878453039,2481,0.913812154696,450,0.165745856354,G52,Guilford,37081G52
Guilford,3258,492,0.151012891344,2442,0.749539594843,30,0.00920810313076,69,0.0211786372007,178,0.0546347452425,47,0.0144260282382,2475,48,35,2462,2510,33,0.0101289134438,2475,0.759668508287,330,0.101289134438,2928,0.898710865562,374,0.114794352363,G53,Guilford,37081G53
Guilford,3276,741,0.22619047619,2087,0.637057387057,40,0.01221001221,53,0.0161782661783,290,0.0885225885226,65,0.0198412698413,2141,65,47,2123,2188,54,0.0164835164835,2141,0.653540903541,526,0.160561660562,2750,0.839438339438,543,0.165750915751,G54,Guilford,37081G54
Guilford,2400,570,0.2375,1642,0.684166666667,17,0.00708333333333,82,0.0341666666667,49,0.0204166666667,40,0.0166666666667,1669,35,20,1654,1689,27,0.01125,1669,0.695416666667,111,0.04625,2289,0.95375,528,0.22,G55,Guilford,37081G55
Guilford,2101,633,0.301285102332,866,0.412184673965,14,0.00666349357449,401,0.190861494526,137,0.0652070442646,50,0.0237981913375,883,27,18,874,901,17,0.00809138505474,883,0.42027605902,207,0.0985245121371,1894,0.901475487863,571,0.271775345074,G56,Guilford,37081G56
Guilford,2068,674,0.325918762089,1199,0.579787234043,16,0.00773694390716,93,0.0449709864603,44,0.0212765957447,42,0.0203094777563,1226,33,20,1213,1246,27,0.0130560928433,1226,0.592843326886,129,0.0623791102515,1939,0.937620889749,610,0.29497098646,G57,Guilford,37081G57
Guilford,2191,735,0.335463258786,1039,0.47421268827,14,0.00638977635783,187,0.0853491556367,158,0.0721131903241,58,0.0264719306253,1078,35,21,1064,1099,39,0.0178000912825,1078,0.492012779553,280,0.127795527157,1911,0.872204472843,639,0.291647649475,G58,Guilford,37081G58
Guilford,1860,617,0.331720430108,874,0.469892473118,15,0.00806451612903,135,0.0725806451613,181,0.097311827957,38,0.0204301075269,894,36,24,882,918,20,0.010752688172,894,0.48064516129,250,0.134408602151,1610,0.865591397849,554,0.297849462366,G59,Guilford,37081G59
Guilford,3114,1140,0.366088631985,1148,0.368657675016,16,0.00513808606294,349,0.112074502248,387,0.124277456647,74,0.0237636480411,1181,33,27,1175,1208,33,0.0105973025048,1181,0.379254977521,697,0.223827874117,2417,0.776172125883,893,0.286769428388,G60,Guilford,37081G60
Guilford,2645,896,0.338752362949,1182,0.446880907372,31,0.0117202268431,168,0.0635160680529,316,0.119470699433,52,0.0196597353497,1209,41,36,1204,1245,27,0.0102079395085,1209,0.457088846881,490,0.185255198488,2155,0.814744801512,765,0.289224952741,G61,Guilford,37081G61
Guilford,1688,1095,0.648696682464,391,0.23163507109,3,0.00177725118483,90,0.053317535545,85,0.050355450237,24,0.0142180094787,406,8,3,401,409,15,0.00888625592417,406,0.240521327014,169,0.100118483412,1519,0.899881516588,1024,0.60663507109,G62,Guilford,37081G62
Guilford,1877,1294,0.689397975493,446,0.237613212573,7,0.00372935535429,68,0.0362280234417,29,0.0154501864678,33,0.0175812466702,466,22,14,458,480,20,0.0106553010123,466,0.248268513586,83,0.0442194992009,1794,0.955780500799,1253,0.667554608418,G63,Guilford,37081G63
Guilford,3587,1699,0.47365486479,1464,0.408140507388,17,0.00473933649289,176,0.0490660719264,131,0.0365207694452,100,0.0278784499582,1523,50,27,1500,1550,59,0.0164482854753,1523,0.424588792863,264,0.0735991078896,3323,0.92640089211,1599,0.445776414831,G64,Guilford,37081G64
Guilford,2858,1795,0.628061581526,703,0.245976207138,14,0.00489853044087,188,0.0657802659202,86,0.0300909727082,72,0.0251924422673,734,38,24,720,758,31,0.0108467459762,734,0.256822953114,194,0.0678796361092,2664,0.932120363891,1718,0.601119664101,G65,Guilford,37081G65
Guilford,2451,1699,0.693186454508,496,0.202366381069,13,0.00530395756834,176,0.0718074255406,33,0.0134638922889,34,0.0138718890249,514,28,19,505,533,18,0.00734394124847,514,0.209710322317,110,0.0448796409629,2341,0.955120359037,1631,0.665442676459,G66,Guilford,37081G66
Guilford,1607,47,0.0292470441817,1514,0.942128189172,6,0.00373366521469,5,0.0031113876789,9,0.00560049782203,26,0.0161792159303,1539,17,6,1528,1545,25,0.0155569383945,1539,0.957685127567,34,0.0211574362166,1573,0.978842563783,45,0.0280024891101,G67,Guilford,37081G67
Guilford,2845,42,0.014762741652,2678,0.941300527241,11,0.00386643233743,4,0.00140597539543,48,0.0168717047452,62,0.0217926186292,2734,34,12,2712,2746,56,0.019683655536,2734,0.960984182777,107,0.0376098418278,2738,0.962390158172,32,0.0112478031634,G68,Guilford,37081G68
Guilford,2505,528,0.210778443114,1855,0.740518962076,8,0.00319361277445,12,0.00479041916168,51,0.0203592814371,51,0.0203592814371,1891,29,10,1872,1901,36,0.014371257485,1891,0.754890219561,109,0.0435129740519,2396,0.956487025948,501,0.2,G69,Guilford,37081G69
Guilford,2493,55,0.0220617729643,2339,0.9382270357,12,0.00481347773767,6,0.00240673886883,26,0.0104292017649,55,0.0220617729643,2388,35,16,2369,2404,49,0.0196550340955,2388,0.957882069795,80,0.0320898515844,2413,0.967910148416,33,0.0132370637786,G70,Guilford,37081G70
Guilford,2879,133,0.0461965960403,2481,0.861757554706,25,0.00868357068427,93,0.0323028829455,112,0.0389023966655,35,0.012156998958,2506,39,29,2496,2535,25,0.00868357068427,2506,0.870441125391,194,0.0673845085099,2685,0.93261549149,87,0.0302188259812,G71,Guilford,37081G71
Guilford,2686,332,0.123603871929,2094,0.779597915115,12,0.00446760982874,32,0.01191362621,155,0.0577066269546,61,0.0227103499628,2142,41,19,2120,2161,48,0.017870439315,2142,0.79746835443,233,0.0867460908414,2453,0.913253909159,275,0.102382725242,G72,Guilford,37081G72
Guilford,1694,73,0.043093270366,1573,0.928571428571,5,0.00295159386068,4,0.00236127508855,18,0.0106257378985,21,0.0123966942149,1594,18,5,1581,1599,21,0.0123966942149,1594,0.940968122786,42,0.0247933884298,1652,0.97520661157,60,0.0354191263282,G73,Guilford,37081G73
Guilford,2089,25,0.01196744854,1980,0.947821924366,10,0.00478697941599,5,0.00239348970799,32,0.0153183341312,37,0.0177118238392,2012,37,14,1989,2026,32,0.0153183341312,2012,0.963140258497,41,0.0196266156056,2048,0.980373384394,22,0.0105313547152,G74,Guilford,37081G74
Guilford,1852,192,0.103671706263,1583,0.85475161987,8,0.00431965442765,28,0.0151187904968,13,0.00701943844492,28,0.0151187904968,1604,23,9,1590,1613,21,0.0113390928726,1604,0.866090712743,48,0.0259179265659,1804,0.974082073434,169,0.091252699784,G75,Guilford,37081G75
Guilford,2510,1915,0.762948207171,467,0.186055776892,7,0.00278884462151,16,0.00637450199203,81,0.0322709163347,24,0.00956175298805,473,18,18,473,491,6,0.00239043824701,473,0.188446215139,131,0.0521912350598,2379,0.94780876494,1869,0.744621513944,GIB,Guilford,37081GIB
Guilford,2665,2507,0.940712945591,94,0.0352720450281,12,0.00450281425891,8,0.00300187617261,23,0.00863039399625,21,0.0078799249531,98,24,24,98,122,4,0.0015009380863,98,0.0367729831144,39,0.0146341463415,2626,0.985365853659,2490,0.934333958724,GR,Guilford,37081GR
Guilford,3013,1447,0.480252240292,878,0.291403916362,34,0.0112844341188,150,0.0497842681713,448,0.148689014271,56,0.0185861267839,898,69,53,882,951,20,0.00663790242283,898,0.298041818785,669,0.222037836044,2344,0.777962163956,1269,0.421174908729,H01,Guilford,37081H01
Guilford,1979,1286,0.649823143002,411,0.207680646791,25,0.0126326427489,76,0.0384032339565,158,0.0798383021728,23,0.011622031329,419,28,28,419,447,8,0.00404244567964,419,0.211723092471,244,0.123294593229,1735,0.876705406771,1219,0.615967660435,H02,Guilford,37081H02
Guilford,2901,941,0.324370906584,1217,0.419510513616,22,0.00758359186487,356,0.122716304723,323,0.111340916925,42,0.0144777662875,1234,38,33,1229,1267,17,0.00586004825922,1234,0.425370561875,436,0.150293002413,2465,0.849706997587,840,0.28955532575,H03,Guilford,37081H03
Guilford,3404,1700,0.499412455934,902,0.264982373678,36,0.0105757931845,469,0.137779083431,240,0.0705052878966,57,0.0167450058754,923,52,48,919,971,21,0.00616921269095,923,0.271151586369,398,0.116921269095,3006,0.883078730905,1580,0.464159811986,H04,Guilford,37081H04
Guilford,2779,699,0.251529327096,1653,0.594818279957,22,0.00791651673264,258,0.0928391507737,95,0.0341849586182,52,0.0187117668226,1691,49,29,1671,1720,38,0.0136739834473,1691,0.608492263404,183,0.0658510255488,2596,0.934148974451,622,0.223821518532,H05,Guilford,37081H05
Guilford,3135,1840,0.58692185008,868,0.27687400319,14,0.00446570972887,233,0.074322169059,130,0.0414673046252,50,0.0159489633174,883,37,29,875,912,15,0.00478468899522,883,0.281658692185,249,0.0794258373206,2886,0.920574162679,1758,0.560765550239,H06,Guilford,37081H06
Guilford,1971,263,0.133434804668,1501,0.761542364282,15,0.0076103500761,68,0.0345002536783,98,0.0497209538305,26,0.0131912734652,1517,23,18,1512,1535,16,0.00811770674784,1517,0.76966007103,136,0.0690005073567,1835,0.930999492643,232,0.117706747844,H07,Guilford,37081H07
Guilford,1565,266,0.169968051118,1132,0.723322683706,23,0.014696485623,29,0.0185303514377,88,0.0562300319489,27,0.0172523961661,1154,35,27,1146,1181,22,0.0140575079872,1154,0.737380191693,126,0.0805111821086,1439,0.919488817891,239,0.152715654952,H08,Guilford,37081H08
Guilford,2522,217,0.0860428231562,2074,0.822363203807,13,0.00515463917526,49,0.0194290245837,99,0.0392545598731,70,0.0277557494052,2119,34,15,2100,2134,45,0.0178429817605,2119,0.840206185567,176,0.0697858842189,2346,0.930214115781,170,0.0674068199841,H09,Guilford,37081H09
Guilford,2280,388,0.170175438596,1711,0.750438596491,9,0.00394736842105,67,0.0293859649123,73,0.0320175438596,32,0.0140350877193,1730,21,12,1721,1742,19,0.00833333333333,1730,0.758771929825,109,0.0478070175439,2171,0.952192982456,362,0.158771929825,H10,Guilford,37081H10
Guilford,3542,1917,0.541219649915,1447,0.408526256352,15,0.00423489553924,45,0.0127046866177,63,0.0177865612648,55,0.0155279503106,1483,34,22,1471,1505,36,0.0101637492942,1483,0.418690005647,138,0.038961038961,3404,0.961038961039,1866,0.526821005082,H11,Guilford,37081H11
Guilford,1876,938,0.5,701,0.373667377399,16,0.00852878464819,98,0.0522388059701,91,0.0485074626866,32,0.0170575692964,719,32,23,710,742,18,0.00959488272921,719,0.383262260128,169,0.0900852878465,1707,0.909914712154,882,0.470149253731,H12,Guilford,37081H12
Guilford,2015,1659,0.823325062035,243,0.120595533499,7,0.00347394540943,50,0.0248138957816,28,0.0138957816377,28,0.0138957816377,257,17,17,257,274,14,0.00694789081886,257,0.127543424318,67,0.0332506203474,1948,0.966749379653,1631,0.809429280397,H13,Guilford,37081H13
Guilford,1306,1213,0.928790199081,50,0.0382848392037,7,0.00535987748851,24,0.0183767228178,6,0.00459418070444,6,0.00459418070444,52,10,9,51,61,2,0.00153139356815,52,0.0398162327718,21,0.0160796324655,1285,0.983920367534,1199,0.918070444104,H14,Guilford,37081H14
Guilford,2200,1526,0.693636363636,479,0.217727272727,11,0.005,90,0.0409090909091,58,0.0263636363636,36,0.0163636363636,498,27,22,493,520,19,0.00863636363636,498,0.226363636364,185,0.0840909090909,2015,0.915909090909,1407,0.639545454545,H15,Guilford,37081H15
Guilford,1491,1131,0.758551307847,207,0.138832997988,11,0.00737759892689,48,0.0321931589537,61,0.0409121395037,33,0.0221327967807,226,30,18,214,244,19,0.0127431254192,226,0.151576123407,99,0.0663983903421,1392,0.933601609658,1104,0.740442655936,H16,Guilford,37081H16
Guilford,1607,809,0.503422526447,618,0.384567517113,21,0.0130678282514,62,0.0385812072184,73,0.045426260112,24,0.0149346608587,629,32,27,624,656,11,0.00684505289359,629,0.391412570006,131,0.0815183571873,1476,0.918481642813,768,0.47790914748,H17,Guilford,37081H17
Guilford,2510,1163,0.463346613546,1186,0.472509960159,3,0.00119521912351,81,0.0322709163347,37,0.0147410358566,40,0.0159362549801,1199,13,8,1194,1207,13,0.00517928286853,1199,0.477689243028,145,0.0577689243028,2365,0.942231075697,1085,0.432270916335,H18,Guilford,37081H18
Guilford,1398,341,0.243919885551,998,0.713876967096,8,0.00572246065808,11,0.00786838340486,21,0.0150214592275,19,0.0135908440629,1015,19,9,1005,1024,17,0.0121602288984,1015,0.726037195994,45,0.0321888412017,1353,0.967811158798,329,0.235336194564,H19A,Guilford,37081H19A
Guilford,1108,860,0.776173285199,188,0.169675090253,3,0.00270758122744,36,0.0324909747292,13,0.0117328519856,8,0.0072202166065,189,5,5,189,194,1,0.000902527075812,189,0.170577617329,35,0.0315884476534,1073,0.968411552347,842,0.759927797834,H19B,Guilford,37081H19B
Guilford,1591,1118,0.702702702703,340,0.213702074167,16,0.0100565681961,49,0.0307982401006,37,0.0232558139535,31,0.0194846008799,358,33,21,346,379,18,0.0113136392206,358,0.225015713388,90,0.0565681961031,1501,0.943431803897,1082,0.680075424261,H20A,Guilford,37081H20A
Guilford,1162,942,0.810671256454,152,0.130808950086,3,0.0025817555938,35,0.0301204819277,20,0.0172117039587,10,0.00860585197935,157,7,6,156,163,5,0.00430292598967,157,0.135111876076,40,0.0344234079174,1122,0.965576592083,928,0.798623063683,H20B,Guilford,37081H20B
Guilford,1624,1290,0.794334975369,244,0.150246305419,8,0.00492610837438,47,0.0289408866995,24,0.0147783251232,11,0.00677339901478,246,13,12,245,258,2,0.0012315270936,246,0.151477832512,72,0.0443349753695,1552,0.955665024631,1255,0.772783251232,H21,Guilford,37081H21
Guilford,1737,1213,0.698330454807,408,0.234887737478,13,0.00748416810593,19,0.0109383995394,58,0.0333909038572,26,0.0149683362119,422,23,18,417,440,14,0.00805987334485,422,0.242947610823,125,0.0719631548647,1612,0.928036845135,1155,0.66493955095,H22,Guilford,37081H22
Guilford,1601,1360,0.849469081824,186,0.116177389132,4,0.00249843847595,18,0.0112429731418,16,0.00999375390381,17,0.0106183635228,188,10,10,188,198,2,0.00124921923798,188,0.11742660837,58,0.0362273579013,1543,0.963772642099,1325,0.827607745159,H23,Guilford,37081H23
Guilford,2300,1761,0.765652173913,345,0.15,3,0.00130434782609,126,0.0547826086957,45,0.0195652173913,20,0.00869565217391,357,6,5,356,362,12,0.00521739130435,357,0.155217391304,100,0.0434782608696,2200,0.95652173913,1699,0.738695652174,H24,Guilford,37081H24
Guilford,3201,2518,0.786629178382,435,0.135895032802,8,0.00249921899406,177,0.0552952202437,36,0.0112464854733,27,0.00843486410497,444,17,13,440,457,9,0.00281162136832,444,0.138706654171,105,0.0328022492971,3096,0.967197750703,2452,0.766010621681,H25,Guilford,37081H25
Guilford,1863,1453,0.779924852389,261,0.140096618357,6,0.00322061191626,102,0.0547504025765,20,0.0107353730542,21,0.0112721417069,267,10,7,264,274,6,0.00322061191626,267,0.143317230274,67,0.0359634997316,1796,0.964036500268,1413,0.75845410628,H26,Guilford,37081H26
Guilford,4195,3049,0.726817640048,546,0.130154946365,16,0.00381406436234,464,0.110607866508,66,0.0157330154946,54,0.0128724672229,566,26,24,564,590,20,0.00476758045292,566,0.134922526818,220,0.0524433849821,3975,0.947556615018,2922,0.696543504172,H27,Guilford,37081H27
Guilford,7725,4843,0.626925566343,2071,0.268090614887,23,0.00297734627832,556,0.0719741100324,128,0.016569579288,104,0.0134627831715,2115,58,44,2101,2159,44,0.00569579288026,2115,0.273786407767,383,0.0495792880259,7342,0.950420711974,4630,0.599352750809,HP,Guilford,37081HP
Guilford,2656,2196,0.826807228916,336,0.126506024096,13,0.00489457831325,66,0.0248493975904,25,0.00941265060241,20,0.00753012048193,344,16,16,344,360,8,0.00301204819277,344,0.129518072289,74,0.0278614457831,2582,0.972138554217,2156,0.811746987952,JAM1,Guilford,37081JAM1
Guilford,1626,1296,0.79704797048,218,0.134071340713,4,0.00246002460025,74,0.0455104551046,14,0.00861008610086,20,0.0123001230012,228,6,5,227,233,10,0.00615006150062,228,0.140221402214,49,0.030135301353,1577,0.969864698647,1269,0.780442804428,JAM2,Guilford,37081JAM2
Guilford,1858,1405,0.756189451023,276,0.148546824543,8,0.0043057050592,111,0.0597416576964,28,0.0150699677072,30,0.016146393972,286,24,21,283,307,10,0.005382131324,286,0.153928955867,71,0.0382131324004,1787,0.9617868676,1373,0.738966630786,JAM3,Guilford,37081JAM3
Guilford,2063,1835,0.889481337857,128,0.0620455647116,6,0.00290838584586,58,0.0281143965099,28,0.0135724672807,8,0.00387784779447,129,9,9,129,138,1,0.000484730974309,129,0.0625302956859,48,0.0232670867668,2015,0.976732913233,1814,0.879301987397,JAM4,Guilford,37081JAM4
Guilford,1857,1612,0.868066774367,53,0.0285406569736,5,0.00269251480883,107,0.057619816909,55,0.0296176628971,25,0.0134625740442,56,19,18,55,74,3,0.0016155088853,56,0.0301561658589,90,0.048465266559,1767,0.951534733441,1581,0.851373182553,JAM5,Guilford,37081JAM5
Guilford,2740,2040,0.744525547445,496,0.18102189781,23,0.00839416058394,23,0.00839416058394,121,0.0441605839416,37,0.013503649635,516,40,32,508,548,20,0.00729927007299,516,0.188321167883,200,0.0729927007299,2540,0.92700729927,1975,0.720802919708,JEF1,Guilford,37081JEF1
Guilford,2395,1470,0.613778705637,761,0.317745302714,18,0.00751565762004,28,0.0116910229645,69,0.0288100208768,49,0.0204592901879,789,40,28,777,817,28,0.0116910229645,789,0.329436325678,184,0.0768267223382,2211,0.923173277662,1376,0.574530271399,JEF2,Guilford,37081JEF2
Guilford,3217,1045,0.324836804476,2006,0.623562325148,23,0.00714951818464,40,0.0124339446689,53,0.0164749766864,50,0.0155424308362,2039,39,26,2026,2065,33,0.0102580043519,2039,0.6338203295,122,0.0379235312403,3095,0.96207646876,994,0.308983525023,JEF3,Guilford,37081JEF3
Guilford,1814,1355,0.746968026461,350,0.192943770673,12,0.00661521499449,35,0.0192943770673,32,0.0176405733186,30,0.0165380374862,362,23,23,362,385,12,0.00661521499449,362,0.199558985667,68,0.0374862183021,1746,0.962513781698,1327,0.731532524807,JEF4,Guilford,37081JEF4
Guilford,2796,1486,0.531473533619,905,0.323676680973,26,0.00929899856938,26,0.00929899856938,311,0.111230329041,42,0.0150214592275,922,38,32,916,954,17,0.00608011444921,922,0.329756795422,509,0.182045779685,2287,0.817954220315,1322,0.472818311874,MON1,Guilford,37081MON1
Guilford,4905,2228,0.454230377166,2383,0.485830784913,20,0.00407747196738,55,0.0112130479103,149,0.030377166157,70,0.0142711518858,2425,51,31,2405,2456,42,0.0085626911315,2425,0.494393476045,298,0.060754332314,4607,0.939245667686,2109,0.42996941896,MON2,Guilford,37081MON2
Guilford,3748,3001,0.800693703308,531,0.141675560299,13,0.00346851654216,39,0.0104055496265,117,0.0312166488794,47,0.0125400213447,547,36,28,539,575,16,0.0042689434365,547,0.145944503735,203,0.0541622198506,3545,0.945837780149,2928,0.781216648879,MON3,Guilford,37081MON3
Guilford,2728,2446,0.896627565982,178,0.0652492668622,5,0.00183284457478,59,0.0216275659824,24,0.00879765395894,16,0.0058651026393,183,8,8,183,191,5,0.00183284457478,183,0.067082111437,69,0.025293255132,2659,0.974706744868,2400,0.879765395894,NCGR1,Guilford,37081NCGR1
Guilford,1756,1643,0.935649202733,60,0.0341685649203,1,0.000569476082005,24,0.0136674259681,8,0.00455580865604,20,0.0113895216401,69,14,7,62,76,9,0.00512528473804,69,0.0392938496583,33,0.0187927107062,1723,0.981207289294,1618,0.921412300683,NCGR2,Guilford,37081NCGR2
Guilford,2286,1853,0.810586176728,363,0.158792650919,6,0.00262467191601,22,0.00962379702537,23,0.0100612423447,19,0.00831146106737,369,14,13,368,382,6,0.00262467191601,369,0.161417322835,44,0.0192475940507,2242,0.980752405949,1836,0.803149606299,NCLAY1,Guilford,37081NCLAY1
Guilford,1360,1257,0.924264705882,55,0.0404411764706,17,0.0125,13,0.00955882352941,5,0.00367647058824,13,0.00955882352941,57,25,25,57,82,2,0.00147058823529,57,0.0419117647059,15,0.0110294117647,1345,0.988970588235,1248,0.917647058824,NCLAY2,Guilford,37081NCLAY2
Guilford,2148,1981,0.922253258845,50,0.0232774674115,11,0.00512104283054,68,0.0316573556797,12,0.00558659217877,26,0.012104283054,56,26,22,52,78,6,0.00279329608939,56,0.0260707635009,59,0.0274674115456,2089,0.972532588454,1934,0.900372439479,NDRI,Guilford,37081NDRI
Guilford,2091,1446,0.691535150646,536,0.256336681014,15,0.00717360114778,10,0.00478240076518,68,0.0325203252033,16,0.00765184122429,543,21,18,540,561,7,0.00334768053563,543,0.259684361549,112,0.0535628885701,1979,0.94643711143,1410,0.674318507891,NMAD,Guilford,37081NMAD
Guilford,1263,1195,0.946159936659,51,0.0403800475059,4,0.00316706254949,1,0.000791765637371,7,0.0055423594616,5,0.00395882818686,52,7,6,51,58,1,0.000791765637371,52,0.0411718131433,14,0.0110847189232,1249,0.988915281077,1189,0.941409342835,NWASH,Guilford,37081NWASH
Guilford,2892,2658,0.919087136929,133,0.0459889349931,8,0.00276625172891,49,0.0169432918396,24,0.00829875518672,20,0.00691562932227,137,16,15,136,152,4,0.00138312586445,137,0.0473720608575,58,0.0200553250346,2834,0.979944674965,2625,0.907676348548,OR1,Guilford,37081OR1
Guilford,2199,1925,0.87539790814,134,0.0609367894497,10,0.00454752160073,98,0.0445657116871,16,0.00727603456116,16,0.00727603456116,134,13,13,134,147,0,0.0,134,0.0609367894497,58,0.0263756252842,2141,0.973624374716,1885,0.857207821737,OR2,Guilford,37081OR2
Guilford,1771,1364,0.770186335404,284,0.160361377753,14,0.00790513833992,10,0.00564652738566,76,0.042913608131,23,0.012987012987,300,26,19,293,319,16,0.00903444381705,300,0.16939582157,98,0.0553359683794,1673,0.944664031621,1350,0.762281197064,PG1,Guilford,37081PG1
Guilford,2775,2500,0.900900900901,191,0.0688288288288,18,0.00648648648649,18,0.00648648648649,22,0.00792792792793,26,0.00936936936937,198,38,35,195,233,7,0.00252252252252,198,0.0713513513514,53,0.0190990990991,2722,0.980900900901,2478,0.892972972973,PG2,Guilford,37081PG2
Guilford,3065,2131,0.695269168026,806,0.262969004894,10,0.00326264274062,55,0.0179445350734,20,0.00652528548124,43,0.0140293637847,829,34,22,817,851,23,0.00750407830343,829,0.270473083197,60,0.0195758564437,3005,0.980424143556,2097,0.684176182708,RC1,Guilford,37081RC1
Guilford,3710,2866,0.772506738544,714,0.192452830189,9,0.00242587601078,40,0.010781671159,44,0.0118598382749,37,0.0099730458221,737,27,15,725,752,23,0.00619946091644,737,0.198652291105,131,0.0353099730458,3579,0.964690026954,2789,0.751752021563,RC2,Guilford,37081RC2
Guilford,2104,1972,0.937262357414,79,0.0375475285171,10,0.00475285171103,17,0.00807984790875,5,0.00237642585551,21,0.00998098859316,84,23,21,82,105,5,0.00237642585551,84,0.0399239543726,38,0.0180608365019,2066,0.981939163498,1948,0.925855513308,SCLAY,Guilford,37081SCLAY
Guilford,3746,3165,0.844901227977,304,0.0811532301121,14,0.00373731980779,211,0.0563267485318,24,0.00640683395622,28,0.00747463961559,312,21,20,311,332,8,0.00213561131874,312,0.0832888414309,129,0.0344367325147,3617,0.965563267485,3071,0.819807794981,SDRI,Guilford,37081SDRI
Guilford,2961,2619,0.884498480243,153,0.0516717325228,9,0.00303951367781,86,0.0290442418102,61,0.0206011482607,33,0.0111448834853,165,27,21,159,186,12,0.00405268490375,165,0.0557244174265,143,0.048294495103,2818,0.951705504897,2547,0.860182370821,SF1,Guilford,37081SF1
Guilford,1574,1459,0.926937738247,63,0.0400254129606,9,0.00571791613723,19,0.0120711562897,7,0.00444726810673,17,0.0108005082592,67,21,20,66,87,4,0.00254129606099,67,0.0425667090216,27,0.0171537484117,1547,0.982846251588,1442,0.916137229987,SF2,Guilford,37081SF2
Guilford,2355,2063,0.876008492569,152,0.0645435244161,10,0.00424628450106,87,0.0369426751592,23,0.00976645435244,20,0.00849256900212,158,15,10,153,168,6,0.00254777070064,158,0.0670912951168,70,0.0297239915074,2285,0.970276008493,2021,0.858174097665,SF3,Guilford,37081SF3
Guilford,3280,2854,0.87012195122,217,0.0661585365854,4,0.00121951219512,159,0.0484756097561,19,0.00579268292683,27,0.00823170731707,228,11,9,226,237,11,0.00335365853659,228,0.069512195122,113,0.0344512195122,3167,0.965548780488,2764,0.842682926829,SF4,Guilford,37081SF4
Guilford,2877,2076,0.721584984359,688,0.239137990963,25,0.00868960722975,14,0.00486618004866,41,0.0142509558568,33,0.0114702815433,702,33,31,700,733,14,0.00486618004866,702,0.244004171011,81,0.0281543274244,2796,0.971845672576,2047,0.711505039972,SMAD,Guilford,37081SMAD
Guilford,3666,3351,0.914075286416,189,0.0515548281506,12,0.00327332242226,47,0.0128205128205,39,0.0106382978723,28,0.0076377523186,200,27,20,193,220,11,0.00300054555374,200,0.0545553737043,113,0.0308237861429,3553,0.969176213857,3280,0.894708128751,STOK,Guilford,37081STOK
Guilford,2318,1125,0.485332182916,931,0.401639344262,12,0.00517687661777,137,0.0591026747196,75,0.0323554788611,38,0.016393442623,961,30,16,947,977,30,0.0129421915444,961,0.414581535807,133,0.0573770491803,2185,0.94262295082,1070,0.461604831752,SUM1,Guilford,37081SUM1
Guilford,1901,1095,0.576012624934,703,0.369805365597,19,0.00999473961073,20,0.0105207785376,51,0.0268279852709,13,0.00683850604945,712,25,21,708,733,9,0.00473435034193,712,0.374539715939,83,0.0436612309311,1818,0.956338769069,1074,0.56496580747,SUM2,Guilford,37081SUM2
Guilford,1368,1219,0.891081871345,65,0.047514619883,13,0.00950292397661,14,0.0102339181287,49,0.0358187134503,8,0.00584795321637,66,17,17,66,83,1,0.000730994152047,66,0.0482456140351,110,0.0804093567251,1258,0.919590643275,1164,0.850877192982,SUM3,Guilford,37081SUM3
Guilford,2182,2055,0.941796516957,54,0.0247479376719,24,0.0109990834097,15,0.00687442713107,17,0.00779101741522,17,0.00779101741522,56,33,32,55,88,2,0.000916590284143,56,0.025664527956,38,0.0174152153987,2144,0.982584784601,2040,0.934922089826,SUM4,Guilford,37081SUM4
Guilford,1065,888,0.833802816901,157,0.147417840376,1,0.00093896713615,0,0.0,16,0.0150234741784,3,0.00281690140845,157,3,3,157,160,0,0.0,157,0.147417840376,34,0.0319248826291,1031,0.968075117371,872,0.818779342723,SWASH,Guilford,37081SWASH
Halifax,456,180,0.394736842105,265,0.581140350877,7,0.015350877193,0,0.0,2,0.00438596491228,2,0.00438596491228,265,9,9,265,274,0,0.0,265,0.581140350877,2,0.00438596491228,454,0.995614035088,180,0.394736842105,BUTWD,Halifax,37083BUTWD
Halifax,404,104,0.257425742574,272,0.673267326733,1,0.00247524752475,1,0.00247524752475,25,0.0618811881188,1,0.00247524752475,272,2,2,272,274,0,0.0,272,0.673267326733,30,0.0742574257426,374,0.925742574257,99,0.24504950495,CONC,Halifax,37083CONC
Halifax,1388,203,0.146253602305,1159,0.835014409222,5,0.0036023054755,5,0.0036023054755,4,0.0028818443804,12,0.00864553314121,1169,13,7,1163,1176,10,0.00720461095101,1169,0.842219020173,9,0.00648414985591,1379,0.993515850144,201,0.144812680115,ENF-1,Halifax,37083ENF-1
Halifax,1821,230,0.126304228446,1574,0.864360241625,4,0.00219659527732,0,0.0,5,0.00274574409665,8,0.00439319055464,1579,9,6,1576,1585,5,0.00274574409665,1579,0.867105985722,15,0.00823723228995,1806,0.99176276771,224,0.12300933553,ENF-2,Halifax,37083ENF-2
Halifax,1251,287,0.229416466827,937,0.749000799361,7,0.00559552358114,5,0.00399680255795,6,0.00479616306954,9,0.00719424460432,945,12,8,941,953,8,0.00639488409273,945,0.755395683453,13,0.0103916866507,1238,0.989608313349,285,0.227817745803,ENF-3,Halifax,37083ENF-3
Halifax,1416,861,0.608050847458,532,0.375706214689,4,0.00282485875706,4,0.00282485875706,3,0.0021186440678,12,0.00847457627119,540,9,5,536,545,8,0.00564971751412,540,0.381355932203,11,0.00776836158192,1405,0.992231638418,854,0.603107344633,FAUCT,Halifax,37083FAUCT
Halifax,2413,647,0.268130957315,1698,0.703688354745,32,0.0132615002072,4,0.0016576875259,12,0.0049730625777,20,0.00828843762951,1716,44,32,1704,1748,18,0.00745959386656,1716,0.711147948612,35,0.0145047658516,2378,0.985495234148,624,0.258599254041,HAL,Halifax,37083HAL
Halifax,539,231,0.428571428571,300,0.556586270872,0,0.0,0,0.0,6,0.0111317254174,2,0.00371057513915,302,0,0,302,302,2,0.00371057513915,302,0.560296846011,14,0.025974025974,525,0.974025974026,224,0.415584415584,HOB,Halifax,37083HOB
Halifax,2515,146,0.0580516898608,1101,0.437773359841,1223,0.486282306163,2,0.000795228628231,3,0.00119284294235,40,0.0159045725646,1129,1250,1233,1112,2362,28,0.0111332007952,1129,0.448906560636,30,0.0119284294235,2485,0.988071570577,146,0.0580516898608,HOL,Halifax,37083HOL
Halifax,1724,528,0.30626450116,1147,0.665313225058,21,0.012180974478,3,0.00174013921114,15,0.00870069605568,10,0.00580046403712,1154,26,24,1152,1178,7,0.00406032482599,1154,0.669373549884,21,0.012180974478,1703,0.987819025522,525,0.304524361949,LIT-1,Halifax,37083LIT-1
Halifax,1591,1133,0.712130735387,415,0.260842237586,15,0.00942803268385,7,0.0043997485858,7,0.0043997485858,14,0.00879949717159,419,23,19,415,438,4,0.00251414204903,419,0.263356379635,12,0.00754242614708,1579,0.992457573853,1132,0.711502199874,LIT-2,Halifax,37083LIT-2
Halifax,324,56,0.172839506173,255,0.787037037037,0,0.0,2,0.00617283950617,8,0.0246913580247,3,0.00925925925926,256,1,1,256,257,1,0.00308641975309,256,0.79012345679,9,0.0277777777778,315,0.972222222222,55,0.16975308642,PAL,Halifax,37083PAL
Halifax,1369,181,0.132213294375,1112,0.812271731191,50,0.036523009496,1,0.00073046018992,8,0.00584368151936,17,0.0124178232286,1121,61,54,1114,1175,9,0.00657414170928,1121,0.8188458729,11,0.00803506208912,1358,0.991964937911,180,0.131482834186,RINGW,Halifax,37083RINGW
Halifax,467,232,0.496788008565,230,0.492505353319,0,0.0,1,0.00214132762313,4,0.00856531049251,0,0.0,230,0,0,230,230,0,0.0,230,0.492505353319,7,0.0149892933619,460,0.985010706638,229,0.490364025696,ROSEN,Halifax,37083ROSEN
Halifax,1071,677,0.632119514472,350,0.326797385621,8,0.00746965452848,9,0.00840336134454,19,0.0177404295051,8,0.00746965452848,357,9,8,356,365,7,0.00653594771242,357,0.333333333333,41,0.0382819794585,1030,0.961718020542,664,0.619981325864,RR-1,Halifax,37083RR-1
Halifax,2804,1816,0.647646219686,791,0.28209700428,18,0.00641940085592,101,0.0360199714693,56,0.0199714693295,22,0.00784593437946,801,25,21,797,822,10,0.00356633380884,801,0.285663338088,102,0.0363766048502,2702,0.96362339515,1781,0.635164051355,RR-10,Halifax,37083RR-10
Halifax,2725,1756,0.644403669725,871,0.319633027523,31,0.011376146789,25,0.00917431192661,22,0.00807339449541,20,0.00733944954128,876,40,36,872,912,5,0.00183486238532,876,0.321467889908,58,0.0212844036697,2667,0.97871559633,1739,0.638165137615,RR-11,Halifax,37083RR-11
Halifax,503,375,0.745526838966,108,0.214711729622,8,0.0159045725646,3,0.00596421471173,0,0.0,9,0.0178926441352,114,12,10,112,124,6,0.0119284294235,114,0.226640159046,1,0.00198807157058,502,0.998011928429,374,0.743538767396,RR-2,Halifax,37083RR-2
Halifax,1211,1050,0.867052023121,139,0.114781172585,2,0.00165152766309,11,0.00908340214699,4,0.00330305532618,5,0.00412881915772,141,6,5,140,146,2,0.00165152766309,141,0.116432700248,17,0.0140379851363,1194,0.985962014864,1041,0.859620148637,RR-3,Halifax,37083RR-3
Halifax,1008,886,0.878968253968,77,0.0763888888889,4,0.00396825396825,20,0.0198412698413,16,0.015873015873,5,0.00496031746032,77,6,6,77,83,0,0.0,77,0.0763888888889,26,0.0257936507937,982,0.974206349206,876,0.869047619048,RR-4,Halifax,37083RR-4
Halifax,1134,812,0.716049382716,272,0.239858906526,9,0.00793650793651,6,0.00529100529101,24,0.021164021164,11,0.00970017636684,278,13,12,277,290,6,0.00529100529101,278,0.245149911817,30,0.026455026455,1104,0.973544973545,807,0.71164021164,RR-5,Halifax,37083RR-5
Halifax,1076,883,0.82063197026,145,0.134758364312,4,0.00371747211896,22,0.0204460966543,13,0.0120817843866,9,0.00836431226766,151,8,4,147,155,6,0.00557620817844,151,0.140334572491,30,0.0278810408922,1046,0.972118959108,870,0.808550185874,RR-6,Halifax,37083RR-6
Halifax,1403,491,0.349964362081,867,0.617961511048,2,0.00142551674982,5,0.00356379187455,29,0.0206699928724,9,0.0064148253742,871,5,4,870,875,4,0.00285103349964,871,0.620812544547,32,0.0228082679971,1371,0.977191732003,487,0.347113328582,RR-7,Halifax,37083RR-7
Halifax,1349,743,0.550778354337,560,0.415122312824,4,0.00296515937732,9,0.00667160859896,16,0.0118606375093,17,0.0126019273536,564,10,9,563,573,4,0.00296515937732,564,0.418087472202,38,0.0281690140845,1311,0.971830985915,731,0.541882876205,RR-8,Halifax,37083RR-8
Halifax,3076,1178,0.382964889467,1823,0.592652795839,34,0.0110533159948,6,0.00195058517555,8,0.00260078023407,27,0.00877763328999,1834,50,45,1829,1879,11,0.00357607282185,1834,0.596228868661,41,0.0133289986996,3035,0.9866710013,1166,0.379063719116,RR-9,Halifax,37083RR-9
Halifax,1650,127,0.0769696969697,1517,0.919393939394,2,0.00121212121212,0,0.0,0,0.0,4,0.00242424242424,1519,5,4,1518,1523,2,0.00121212121212,1519,0.920606060606,9,0.00545454545455,1641,0.994545454545,122,0.0739393939394,SN-1,Halifax,37083SN-1
Halifax,1256,680,0.541401273885,561,0.446656050955,4,0.0031847133758,3,0.00238853503185,6,0.00477707006369,2,0.0015923566879,563,5,4,562,567,2,0.0015923566879,563,0.448248407643,13,0.0103503184713,1243,0.989649681529,673,0.535828025478,SN-2,Halifax,37083SN-2
Halifax,1098,224,0.204007285974,828,0.754098360656,7,0.0063752276867,3,0.00273224043716,17,0.0154826958106,19,0.0173041894353,839,16,11,834,850,11,0.0100182149362,839,0.764116575592,27,0.0245901639344,1071,0.975409836066,220,0.200364298725,WEL-1,Halifax,37083WEL-1
Halifax,629,256,0.406995230525,359,0.570747217806,1,0.00158982511924,6,0.00953895071542,2,0.00317965023847,5,0.00794912559618,364,6,1,359,365,5,0.00794912559618,364,0.578696343402,2,0.00317965023847,627,0.996820349762,256,0.406995230525,WEL-2,Halifax,37083WEL-2
Halifax,2402,770,0.320566194838,1558,0.648626144879,28,0.0116569525396,15,0.00624479600333,14,0.00582847626978,17,0.00707743547044,1569,31,29,1567,1598,11,0.00457951706911,1569,0.653205661948,31,0.0129059117402,2371,0.98709408826,766,0.318900915903,WEL-3,Halifax,37083WEL-3
Harnett,8885,6242,0.702532357907,1783,0.200675295442,127,0.0142937535172,207,0.0232976927406,282,0.0317388857625,244,0.0274620146314,1862,224,199,1837,2061,79,0.00889138998312,1862,0.209566685425,764,0.0859876195836,8121,0.914012380416,5871,0.660776589758,PR01,Harnett,37085PR01
Harnett,11860,8455,0.712900505902,2252,0.189881956155,134,0.0112984822934,243,0.0204890387858,466,0.0392917369309,310,0.0261382799325,2379,254,206,2331,2585,127,0.0107082630691,2379,0.200590219224,1040,0.0876897133221,10820,0.912310286678,8010,0.675379426644,PR07,Harnett,37085PR07
Harnett,7594,5577,0.734395575454,1067,0.140505662365,82,0.0107979984198,61,0.00803265736107,720,0.0948116934422,87,0.0114564129576,1102,113,106,1095,1208,35,0.00460890176455,1102,0.14511456413,1137,0.149723465894,6457,0.850276534106,5262,0.692915459573,PR08,Harnett,37085PR08
Harnett,7010,4721,0.673466476462,1651,0.235520684736,55,0.00784593437946,83,0.0118402282454,287,0.0409415121255,213,0.0303851640514,1749,162,127,1714,1876,98,0.0139800285307,1749,0.249500713267,579,0.0825962910128,6431,0.917403708987,4481,0.639229671897,PR16,Harnett,37085PR16
Harnett,3944,2203,0.558569979716,1550,0.393002028398,34,0.00862068965517,25,0.00633874239351,99,0.0251014198783,33,0.00836713995943,1563,52,46,1557,1609,13,0.00329614604462,1563,0.396298174442,294,0.0745436105477,3650,0.925456389452,2023,0.512931034483,PR17,Harnett,37085PR17
Harnett,2829,1288,0.455284552846,1391,0.491693177801,56,0.0197949805585,12,0.00424178154825,32,0.011311417462,50,0.0176740897844,1419,88,69,1400,1488,28,0.00989749027925,1419,0.501590668081,79,0.0279250618593,2750,0.972074938141,1255,0.443619653588,PR20,Harnett,37085PR20
Harnett,6429,4891,0.760771504122,1025,0.159433815523,79,0.0122880696842,25,0.00388862964691,352,0.0547519054285,57,0.00886607559496,1053,102,90,1041,1143,28,0.00435526520454,1053,0.163789080728,627,0.0975268315446,5802,0.902473168455,4678,0.72764037953,PR23,Harnett,37085PR23
Harnett,7938,6179,0.77840765936,916,0.11539430587,81,0.0102040816327,25,0.00314940791131,620,0.0781053162006,117,0.0147392290249,941,143,140,938,1081,25,0.00314940791131,941,0.118543713782,1068,0.134542705971,6870,0.865457294029,5801,0.730788611741,PR24,Harnett,37085PR24
Harnett,4317,2256,0.522585128562,1752,0.405837387074,57,0.0132036136206,18,0.00416956219597,163,0.0377577021079,71,0.0164466064397,1792,94,70,1768,1862,40,0.00926569376882,1792,0.415103080843,244,0.0565207319898,4073,0.94347926801,2208,0.511466296039,PR25,Harnett,37085PR25
Harnett,4620,3699,0.800649350649,634,0.137229437229,65,0.0140692640693,18,0.0038961038961,151,0.032683982684,53,0.0114718614719,650,97,90,643,740,16,0.0034632034632,650,0.140692640693,225,0.0487012987013,4395,0.951298701299,3646,0.789177489177,PR26,Harnett,37085PR26
Harnett,6218,4885,0.785622386619,850,0.136699903506,38,0.0061112898038,99,0.015921518173,252,0.0405275008041,94,0.0151174010936,891,81,63,873,954,41,0.00659376005146,891,0.143293663557,397,0.0638468961081,5821,0.936153103892,4762,0.765841106465,PR27,Harnett,37085PR27
Harnett,5559,4684,0.842597589495,566,0.101816873538,46,0.00827486958086,15,0.00269832703724,186,0.0334592552617,62,0.0111530850872,592,78,66,580,658,26,0.00467710019788,592,0.106493973736,354,0.0636805180788,5205,0.936319481921,4540,0.816693649937,PR28,Harnett,37085PR28
Harnett,5648,3956,0.700424929178,1393,0.246635977337,65,0.0115084985836,50,0.00885269121813,128,0.0226628895184,56,0.00991501416431,1414,89,80,1405,1494,21,0.00371813031161,1414,0.250354107649,226,0.0400141643059,5422,0.959985835694,3878,0.686614730878,PR29,Harnett,37085PR29
Haywood,2151,2091,0.972105997211,4,0.00185960018596,10,0.0046490004649,7,0.00325430032543,21,0.00976290097629,18,0.00836820083682,7,22,22,7,29,3,0.00139470013947,7,0.00325430032543,67,0.0311483031148,2084,0.968851696885,2046,0.951185495119,AC,Haywood,37087AC
Haywood,29,28,0.965517241379,0,0.0,0,0.0,1,0.0344827586207,0,0.0,0,0.0,0,0,0,0,0,0,0.0,0,0.0,0,0.0,29,1.0,28,0.965517241379,BC,Haywood,37087BC
Haywood,1483,1444,0.973701955496,6,0.00404585300067,4,0.00269723533378,0,0.0,18,0.012137559002,11,0.0074173971679,6,12,12,6,18,0,0.0,6,0.00404585300067,25,0.0168577208361,1458,0.983142279164,1440,0.971004720162,BE-1,Haywood,37087BE-1
Haywood,1370,1312,0.957664233577,2,0.0014598540146,6,0.0043795620438,4,0.0029197080292,32,0.0233576642336,14,0.0102189781022,3,19,18,2,21,1,0.000729927007299,3,0.0021897810219,56,0.0408759124088,1314,0.959124087591,1290,0.941605839416,BE-2,Haywood,37087BE-2
Haywood,2150,2058,0.957209302326,19,0.00883720930233,5,0.00232558139535,7,0.00325581395349,33,0.0153488372093,28,0.013023255814,21,29,28,20,49,2,0.00093023255814,21,0.00976744186047,62,0.0288372093023,2088,0.971162790698,2032,0.94511627907,BE-3,Haywood,37087BE-3
Haywood,1765,1714,0.971104815864,8,0.00453257790368,7,0.00396600566572,3,0.00169971671388,21,0.0118980169972,12,0.00679886685552,9,14,14,9,23,1,0.00056657223796,9,0.00509915014164,58,0.0328611898017,1707,0.967138810198,1682,0.952974504249,BE-4,Haywood,37087BE-4
Haywood,1925,1734,0.900779220779,147,0.0763636363636,13,0.00675324675325,4,0.00207792207792,11,0.00571428571429,16,0.00831168831169,153,20,19,152,172,6,0.00311688311688,153,0.0794805194805,30,0.0155844155844,1895,0.984415584416,1715,0.890909090909,BE56,Haywood,37087BE56
Haywood,1265,1250,0.98814229249,1,0.000790513833992,2,0.00158102766798,1,0.000790513833992,4,0.00316205533597,7,0.00553359683794,2,5,5,2,7,1,0.000790513833992,2,0.00158102766798,16,0.0126482213439,1249,0.987351778656,1238,0.978656126482,BE-7,Haywood,37087BE-7
Haywood,411,404,0.98296836983,1,0.00243309002433,0,0.0,1,0.00243309002433,0,0.0,5,0.0121654501217,1,4,4,1,5,0,0.0,1,0.00243309002433,3,0.00729927007299,408,0.992700729927,401,0.975669099757,CE,Haywood,37087CE
Haywood,2411,2308,0.957279137287,22,0.00912484446288,5,0.00207382828702,10,0.00414765657404,38,0.0157610949813,28,0.0116134384073,28,23,21,26,49,6,0.00248859394442,28,0.0116134384073,71,0.0294483616757,2340,0.970551638324,2281,0.946080464538,CL-N,Haywood,37087CL-N
Haywood,2633,2530,0.960881124193,29,0.0110140524117,12,0.00455753892898,7,0.00265856437524,30,0.0113938473224,25,0.0094948727687,35,29,26,32,61,6,0.00227876946449,35,0.0132928218762,60,0.0227876946449,2573,0.977212305355,2505,0.951386251424,CL-S,Haywood,37087CL-S
Haywood,1389,1367,0.984161267099,1,0.000719942404608,1,0.000719942404608,6,0.00431965442765,5,0.00359971202304,9,0.00647948164147,1,5,5,1,6,0,0.0,1,0.000719942404608,19,0.0136789056875,1370,0.986321094312,1353,0.974082073434,CR,Haywood,37087CR
Haywood,1288,1256,0.975155279503,2,0.00155279503106,8,0.00621118012422,2,0.00155279503106,7,0.0054347826087,13,0.0100931677019,3,16,16,3,19,1,0.000776397515528,3,0.00232919254658,25,0.0194099378882,1263,0.980590062112,1241,0.96350931677,EF,Haywood,37087EF
Haywood,824,805,0.976941747573,1,0.00121359223301,2,0.00242718446602,2,0.00242718446602,5,0.00606796116505,9,0.0109223300971,2,8,7,1,9,1,0.00121359223301,2,0.00242718446602,6,0.00728155339806,818,0.992718446602,801,0.972087378641,FC-1,Haywood,37087FC-1
Haywood,201,197,0.980099502488,0,0.0,0,0.0,2,0.00995024875622,0,0.0,2,0.00995024875622,2,2,0,0,2,2,0.00995024875622,2,0.00995024875622,2,0.00995024875622,199,0.990049751244,195,0.970149253731,FC-2,Haywood,37087FC-2
Haywood,1417,1302,0.918842625265,37,0.0261115031757,11,0.00776287932251,7,0.00494001411433,43,0.030345800988,17,0.0119971771348,38,25,24,37,62,1,0.000705716302047,38,0.0268172194778,69,0.0486944248412,1348,0.951305575159,1276,0.900494001411,HA,Haywood,37087HA
Haywood,889,881,0.991001124859,1,0.00112485939258,3,0.00337457817773,0,0.0,4,0.0044994375703,0,0.0,1,3,3,1,4,0,0.0,1,0.00112485939258,10,0.0112485939258,879,0.988751406074,873,0.982002249719,ID,Haywood,37087ID
Haywood,3260,3124,0.958282208589,18,0.00552147239264,14,0.00429447852761,33,0.0101226993865,40,0.0122699386503,31,0.00950920245399,27,37,32,22,59,9,0.00276073619632,27,0.00828220858896,76,0.0233128834356,3184,0.976687116564,3094,0.949079754601,IH,Haywood,37087IH
Haywood,3319,3226,0.971979511901,11,0.00331425128051,14,0.00421813799337,12,0.00361554685146,30,0.00903886712865,26,0.00783368484483,13,30,30,13,43,2,0.00060259114191,13,0.00391684242242,108,0.0325399216632,3211,0.967460078337,3157,0.951190117505,JC,Haywood,37087JC
Haywood,1744,1721,0.986811926606,2,0.00114678899083,2,0.00114678899083,8,0.0045871559633,5,0.00286697247706,6,0.00344036697248,2,3,3,2,5,0,0.0,2,0.00114678899083,29,0.016628440367,1715,0.983371559633,1699,0.974197247706,LJ,Haywood,37087LJ
Haywood,2972,2910,0.979138627187,7,0.00235531628533,5,0.00168236877524,7,0.00235531628533,28,0.00942126514132,15,0.00504710632571,9,17,17,9,26,2,0.000672947510094,9,0.00302826379542,58,0.0195154777927,2914,0.980484522207,2882,0.969717362046,P,Haywood,37087P
Haywood,1358,1331,0.980117820324,4,0.00294550810015,4,0.00294550810015,1,0.000736377025037,8,0.00589101620029,10,0.00736377025037,7,12,11,6,18,3,0.00220913107511,7,0.00515463917526,20,0.0147275405007,1338,0.985272459499,1320,0.972017673049,PC,Haywood,37087PC
Haywood,2293,2218,0.967291757523,4,0.00174443959878,21,0.00915830789359,17,0.00741386829481,18,0.00784997819451,15,0.00654164849542,4,34,34,4,38,0,0.0,4,0.00174443959878,46,0.020061055386,2247,0.979938944614,2193,0.956389010031,SA,Haywood,37087SA
Haywood,989,904,0.914054600607,28,0.0283114256825,10,0.010111223458,7,0.00707785642063,22,0.0222446916077,18,0.0182002022245,32,23,19,28,51,4,0.00404448938322,32,0.0323559150657,58,0.0586450960566,931,0.941354903943,872,0.881698685541,WC,Haywood,37087WC
Haywood,1639,1586,0.967663209274,6,0.00366076876144,5,0.00305064063453,2,0.00122025625381,34,0.0207443563148,6,0.00366076876144,8,6,6,8,14,2,0.00122025625381,8,0.00488102501525,78,0.0475899938987,1561,0.952410006101,1542,0.94081757169,WE,Haywood,37087WE
Haywood,326,319,0.978527607362,0,0.0,2,0.00613496932515,1,0.00306748466258,0,0.0,4,0.0122699386503,0,4,4,0,4,0,0.0,0,0.0,3,0.00920245398773,323,0.990797546012,316,0.969325153374,WO,Haywood,37087WO
Haywood,2199,2082,0.946793997271,38,0.0172805820828,17,0.00773078672124,10,0.00454752160073,38,0.0172805820828,14,0.00636653024102,38,28,28,38,66,0,0.0,38,0.0172805820828,65,0.0295588904047,2134,0.970441109595,2059,0.93633469759,WS-1,Haywood,37087WS-1
Haywood,1962,1843,0.939347604485,75,0.0382262996942,7,0.00356778797146,9,0.0045871559633,18,0.00917431192661,10,0.00509683995923,75,15,15,75,90,0,0.0,75,0.0382262996942,55,0.0280326197757,1907,0.971967380224,1808,0.921508664628,WS-2,Haywood,37087WS-2
Haywood,1839,1768,0.961392060903,15,0.00815660685155,18,0.00978792822186,3,0.00163132137031,21,0.0114192495922,14,0.00761283306145,16,30,30,16,46,1,0.000543773790103,16,0.00870038064165,45,0.0244698205546,1794,0.975530179445,1747,0.94997281131,WW,Haywood,37087WW
Henderson,1741,1568,0.900631820793,31,0.0178058587019,7,0.0040206777714,11,0.00631820792648,96,0.055140723722,28,0.0160827110856,36,18,18,36,54,5,0.00287191269385,36,0.0206777713957,199,0.114302125215,1542,0.885697874785,1479,0.849511774842,AR,Henderson,37089AR
Henderson,2899,2844,0.981027940669,14,0.00482925146602,3,0.00103483959986,5,0.00172473266644,12,0.00413935839945,21,0.00724387719903,18,16,16,18,34,4,0.00137978613315,18,0.00620903759917,52,0.0179372197309,2847,0.982062780269,2804,0.967230079338,AT,Henderson,37089AT
Henderson,904,859,0.950221238938,9,0.00995575221239,3,0.0033185840708,2,0.00221238938053,18,0.0199115044248,13,0.0143805309735,17,16,8,9,25,8,0.00884955752212,17,0.0188053097345,25,0.0276548672566,879,0.972345132743,852,0.942477876106,BC,Henderson,37089BC
Henderson,925,671,0.725405405405,168,0.181621621622,5,0.00540540540541,19,0.0205405405405,45,0.0486486486486,17,0.0183783783784,177,14,10,173,187,9,0.00972972972973,177,0.191351351351,106,0.114594594595,819,0.885405405405,615,0.664864864865,BK,Henderson,37089BK
Henderson,1257,1212,0.964200477327,7,0.00556881463803,2,0.00159108989658,6,0.00477326968974,13,0.0103420843278,17,0.0135242641209,9,15,14,8,23,2,0.00159108989658,9,0.00715990453461,29,0.0230708035004,1228,0.9769291965,1199,0.953858392999,CB,Henderson,37089CB
Henderson,3755,3454,0.919840213049,50,0.0133155792277,22,0.00585885486019,47,0.012516644474,135,0.0359520639148,47,0.012516644474,57,42,40,55,97,7,0.00186418109188,57,0.0151797603196,328,0.0873501997337,3427,0.912649800266,3286,0.875099866844,CC,Henderson,37089CC
Henderson,2922,2583,0.883983572895,73,0.0249828884326,22,0.00752908966461,23,0.007871321013,188,0.0643394934976,33,0.0112936344969,80,47,45,78,125,7,0.00239561943874,80,0.0273785078713,343,0.117385352498,2579,0.882614647502,2441,0.835386721424,ED,Henderson,37089ED
Henderson,3097,2618,0.845334194382,126,0.0406845334194,14,0.00452050371327,34,0.0109783661608,239,0.077171456248,66,0.0213109460768,152,43,36,145,188,26,0.00839522118179,152,0.0490797546012,497,0.160477881821,2600,0.839522118179,2393,0.772683241847,EF,Henderson,37089EF
Henderson,2169,2049,0.944674965422,29,0.0133702166897,6,0.00276625172891,18,0.00829875518672,39,0.0179806362379,28,0.0129091747349,33,24,24,33,57,4,0.00184416781927,33,0.015214384509,87,0.0401106500692,2082,0.959889349931,2003,0.9234670355,ES,Henderson,37089ES
Henderson,2600,2481,0.954230769231,22,0.00846153846154,1,0.000384615384615,24,0.00923076923077,51,0.0196153846154,21,0.00807692307692,31,12,12,31,43,9,0.00346153846154,31,0.0119230769231,88,0.0338461538462,2512,0.966153846154,2446,0.940769230769,EV,Henderson,37089EV
Henderson,4413,3956,0.896442329481,166,0.0376161341491,22,0.00498527079085,124,0.0280987990029,83,0.0188080670746,62,0.0140493995015,183,51,50,182,233,17,0.00385225470202,183,0.0414683888511,195,0.0441876274643,4218,0.955812372536,3855,0.873555404487,FL,Henderson,37089FL
Henderson,2636,2606,0.988619119879,6,0.00227617602428,3,0.00113808801214,8,0.00303490136571,0,0.0,13,0.00493171471927,12,10,9,11,21,6,0.00227617602428,12,0.00455235204856,21,0.00796661608498,2615,0.992033383915,2587,0.981411229135,FR,Henderson,37089FR
Henderson,1479,1247,0.843137254902,62,0.0419202163624,5,0.00338066260987,40,0.027045300879,88,0.0594996619337,37,0.025016903313,67,18,18,67,85,5,0.00338066260987,67,0.0453008789723,167,0.11291413117,1312,0.88708586883,1180,0.79783637593,GM,Henderson,37089GM
Henderson,2630,2541,0.966159695817,6,0.00228136882129,11,0.0041825095057,7,0.00266159695817,42,0.015969581749,23,0.00874524714829,11,24,24,11,35,5,0.00190114068441,11,0.0041825095057,70,0.0266159695817,2560,0.973384030418,2516,0.956653992395,GR,Henderson,37089GR
Henderson,3189,2989,0.937284415177,77,0.0241455001568,16,0.00501724678583,49,0.0153653182816,23,0.00721229225463,35,0.010975227344,86,35,32,83,118,9,0.00282220131703,86,0.0269677014738,80,0.0250862339291,3109,0.974913766071,2939,0.921605518971,HC,Henderson,37089HC
Henderson,2327,2237,0.961323592609,14,0.00601633003868,5,0.00214868929953,14,0.00601633003868,32,0.013751611517,25,0.0107434464976,17,21,21,17,38,3,0.00128921357972,17,0.00730554361839,86,0.0369574559519,2241,0.963042544048,2186,0.939406961753,HS,Henderson,37089HS
Henderson,2514,2261,0.899363564041,116,0.0461416070008,3,0.00119331742243,29,0.0115354017502,78,0.0310262529833,27,0.0107398568019,123,10,8,121,131,7,0.00278440731901,123,0.0489260143198,175,0.0696101829753,2339,0.930389817025,2184,0.868735083532,HV-1,Henderson,37089HV-1
Henderson,3481,2657,0.763286411951,425,0.122091353059,23,0.00660729675381,51,0.0146509623671,279,0.0801493823614,46,0.0132145935076,435,34,32,433,467,10,0.00287273771905,435,0.124964090779,535,0.153691467969,2946,0.846308532031,2445,0.702384372307,HV-2,Henderson,37089HV-2
Henderson,3056,2578,0.843586387435,274,0.0896596858639,9,0.00294502617801,36,0.011780104712,128,0.0418848167539,31,0.0101439790576,284,13,13,284,297,10,0.0032722513089,284,0.0929319371728,221,0.0723167539267,2835,0.927683246073,2493,0.815772251309,HV-3,Henderson,37089HV-3
Henderson,1825,1768,0.968767123288,22,0.0120547945205,1,0.000547945205479,15,0.00821917808219,3,0.00164383561644,16,0.00876712328767,24,4,4,24,28,2,0.00109589041096,24,0.0131506849315,21,0.0115068493151,1804,0.988493150685,1753,0.960547945205,LJ,Henderson,37089LJ
Henderson,1821,1763,0.968149368479,28,0.0153761669412,3,0.00164744645799,8,0.00439319055464,9,0.00494233937397,10,0.0054914881933,31,9,9,31,40,3,0.00164744645799,31,0.0170236133992,31,0.0170236133992,1790,0.982976386601,1744,0.957715540912,LP,Henderson,37089LP
Henderson,1467,1227,0.836400817996,54,0.0368098159509,10,0.0068166325835,15,0.0102249488753,146,0.0995228357192,15,0.0102249488753,55,24,23,54,78,1,0.00068166325835,55,0.0374914792093,290,0.197682344922,1177,0.802317655078,1089,0.742331288344,MG,Henderson,37089MG
Henderson,4813,4114,0.854768335757,61,0.0126740078953,40,0.00831082484937,47,0.00976521919801,483,0.100353210056,68,0.0141284022439,69,87,86,68,155,8,0.00166216496987,69,0.0143361728652,871,0.180968211095,3942,0.819031788905,3764,0.782048618325,NB,Henderson,37089NB
Henderson,2180,1881,0.862844036697,129,0.0591743119266,8,0.00366972477064,36,0.0165137614679,97,0.044495412844,29,0.0133027522936,136,20,16,132,152,7,0.00321100917431,136,0.0623853211009,196,0.0899082568807,1984,0.910091743119,1790,0.821100917431,NE,Henderson,37089NE
Henderson,2972,2790,0.938761776581,64,0.021534320323,11,0.00370121130552,23,0.00773889636608,44,0.0148048452221,40,0.0134589502019,69,28,28,69,97,5,0.00168236877524,69,0.0232166890983,110,0.0370121130552,2862,0.962987886945,2743,0.922947510094,NM,Henderson,37089NM
Henderson,2234,2065,0.924350940018,68,0.0304386750224,8,0.00358102059087,29,0.0129811996419,52,0.0232766338406,12,0.0053715308863,71,14,14,71,85,3,0.00134288272158,71,0.031781557744,129,0.0577439570278,2105,0.942256042972,1995,0.893017009848,NW,Henderson,37089NW
Henderson,2750,2519,0.916,47,0.0170909090909,6,0.00218181818182,55,0.02,73,0.0265454545455,50,0.0181818181818,57,31,26,52,83,10,0.00363636363636,57,0.0207272727273,147,0.0534545454545,2603,0.946545454545,2456,0.893090909091,PR,Henderson,37089PR
Henderson,2046,1975,0.965298142717,20,0.00977517106549,6,0.00293255131965,16,0.00782013685239,15,0.00733137829912,14,0.00684261974585,23,11,10,22,33,3,0.00146627565982,23,0.0112414467253,73,0.0356793743891,1973,0.964320625611,1924,0.9403714565,PV,Henderson,37089PV
Henderson,2464,2300,0.933441558442,47,0.0190746753247,17,0.00689935064935,28,0.0113636363636,40,0.0162337662338,32,0.012987012987,52,39,38,51,90,5,0.00202922077922,52,0.0211038961039,150,0.0608766233766,2314,0.939123376623,2197,0.89163961039,RG,Henderson,37089RG
Henderson,991,982,0.990918264379,1,0.00100908173562,2,0.00201816347124,0,0.0,5,0.0050454086781,1,0.00100908173562,1,3,3,1,4,0,0.0,1,0.00100908173562,22,0.0221997981837,969,0.977800201816,963,0.971745711403,RR,Henderson,37089RR
Henderson,3073,2811,0.914741295151,18,0.00585746827205,12,0.00390497884803,6,0.00195248942402,185,0.0602017572405,41,0.0133420110641,23,34,34,23,57,5,0.00162707452001,23,0.00748454279206,379,0.123332248617,2694,0.876667751383,2641,0.859420761471,SB,Henderson,37089SB
Henderson,1860,1517,0.815591397849,54,0.0290322580645,14,0.00752688172043,14,0.00752688172043,228,0.122580645161,33,0.0177419354839,58,21,21,58,79,4,0.00215053763441,58,0.0311827956989,426,0.229032258065,1434,0.770967741935,1342,0.721505376344,SE,Henderson,37089SE
Henderson,3758,3647,0.970463012241,27,0.00718467269824,10,0.00266098988824,16,0.00425758382118,36,0.00957956359766,22,0.00585417775412,31,18,17,30,48,4,0.0010643959553,31,0.00824906865354,108,0.028738690793,3650,0.971261309207,3575,0.951303885045,SM,Henderson,37089SM
Henderson,2533,2392,0.944334780892,45,0.0177654954599,2,0.000789577575997,25,0.00986971969996,47,0.0185550730359,22,0.00868535333597,53,7,6,52,59,8,0.00315831030399,53,0.0209238057639,109,0.0430319778918,2424,0.956968022108,2334,0.921437031188,SW,Henderson,37089SW
Hertford,2412,1052,0.436152570481,1245,0.516169154229,40,0.016583747927,38,0.0157545605307,11,0.00456053067993,26,0.0107794361526,1261,53,47,1255,1308,16,0.00663349917081,1261,0.5228026534,31,0.0128524046434,2381,0.987147595357,1043,0.432421227197,A1,Hertford,37091A1
Hertford,2548,1226,0.481161695447,1232,0.483516483516,17,0.00667189952904,11,0.00431711145997,34,0.0133437990581,28,0.010989010989,1243,35,29,1237,1272,11,0.00431711145997,1243,0.487833594976,51,0.0200156985871,2497,0.979984301413,1217,0.477629513344,A2,Hertford,37091A2
Hertford,1442,107,0.0742024965326,1283,0.889736477115,36,0.0249653259362,5,0.00346740638003,5,0.00346740638003,6,0.00416088765603,1289,41,36,1284,1325,6,0.00416088765603,1289,0.893897364771,4,0.00277392510402,1438,0.997226074896,105,0.0728155339806,A3,Hertford,37091A3
Hertford,529,105,0.198487712665,415,0.78449905482,1,0.00189035916824,1,0.00189035916824,2,0.00378071833648,5,0.00945179584121,420,4,1,417,421,5,0.00945179584121,420,0.793950850662,4,0.00756143667297,525,0.992438563327,102,0.192816635161,BR,Hertford,37091BR
Hertford,517,307,0.593810444874,198,0.382978723404,0,0.0,1,0.00193423597679,2,0.00386847195358,9,0.0174081237911,203,6,4,201,207,5,0.00967117988395,203,0.392649903288,8,0.0154738878143,509,0.984526112186,303,0.586073500967,CM,Hertford,37091CM
Hertford,692,157,0.226878612717,475,0.686416184971,22,0.0317919075145,0,0.0,13,0.0187861271676,25,0.0361271676301,489,39,31,481,520,14,0.0202312138728,489,0.706647398844,15,0.021676300578,677,0.978323699422,155,0.223988439306,CO,Hertford,37091CO
Hertford,1036,476,0.459459459459,543,0.524131274131,2,0.0019305019305,0,0.0,8,0.00772200772201,7,0.00675675675676,546,9,6,543,552,3,0.00289575289575,546,0.527027027027,14,0.0135135135135,1022,0.986486486486,470,0.453667953668,HV,Hertford,37091HV
Hertford,3348,1204,0.359617682198,2054,0.613500597372,12,0.00358422939068,25,0.00746714456392,29,0.00866188769415,24,0.00716845878136,2067,17,14,2064,2081,13,0.00388291517324,2067,0.617383512545,71,0.0212066905615,3277,0.978793309438,1177,0.351553166069,M1,Hertford,37091M1
Hertford,1461,510,0.349075975359,901,0.616700889802,3,0.00205338809035,10,0.00684462696783,23,0.015742642026,14,0.00958247775496,911,14,6,903,917,10,0.00684462696783,911,0.623545516769,49,0.0335386721424,1412,0.966461327858,502,0.343600273785,M2,Hertford,37091M2
Hertford,705,560,0.794326241135,127,0.180141843972,0,0.0,4,0.00567375886525,2,0.00283687943262,12,0.0170212765957,133,8,4,129,137,6,0.00851063829787,133,0.18865248227,8,0.0113475177305,697,0.98865248227,554,0.785815602837,ML,Hertford,37091ML
Hertford,924,380,0.411255411255,533,0.57683982684,5,0.00541125541126,0,0.0,4,0.004329004329,2,0.0021645021645,534,7,6,533,540,1,0.00108225108225,534,0.577922077922,7,0.00757575757576,917,0.992424242424,376,0.406926406926,SJ,Hertford,37091SJ
Hertford,1163,460,0.395528804815,658,0.565778159931,14,0.01203783319,1,0.000859845227859,14,0.01203783319,16,0.0137575236457,668,25,18,661,686,10,0.00859845227859,668,0.57437661221,19,0.0163370593293,1144,0.983662940671,458,0.393809114359,UN,Hertford,37091UN
Hertford,2695,864,0.320593692022,1735,0.643784786642,68,0.0252319109462,7,0.0025974025974,4,0.00148423005566,17,0.00630797773655,1747,83,72,1736,1819,12,0.00445269016698,1747,0.648237476809,224,0.0831168831169,2471,0.916883116883,668,0.247866419295,WN,Hertford,37091WN
Hoke,518,50,0.0965250965251,125,0.241312741313,307,0.592664092664,1,0.0019305019305,29,0.0559845559846,6,0.011583011583,127,311,311,127,438,2,0.003861003861,127,0.245173745174,37,0.0714285714286,481,0.928571428571,47,0.0907335907336,01,Hoke,3709301
Hoke,2676,533,0.199177877429,655,0.244768310912,1278,0.477578475336,17,0.00635276532138,138,0.0515695067265,55,0.020553064275,671,1320,1309,660,1980,16,0.00597907324365,671,0.250747384155,211,0.0788490284006,2465,0.921150971599,486,0.181614349776,02,Hoke,3709302
Hoke,1147,282,0.245858761988,427,0.372275501308,323,0.28160418483,8,0.00697471665214,93,0.0810810810811,14,0.0122057541412,430,335,332,427,762,3,0.00261551874455,430,0.374891020052,129,0.112467306016,1018,0.887532693984,256,0.223190932868,03,Hoke,3709303
Hoke,1087,591,0.54369825207,360,0.33118675253,82,0.0754369825207,7,0.0064397424103,35,0.0321987120515,12,0.0110395584177,365,85,85,365,450,5,0.00459981600736,365,0.335786568537,54,0.0496780128795,1033,0.950321987121,578,0.531738730451,04,Hoke,3709304
Hoke,1986,1056,0.531722054381,698,0.351460221551,128,0.0644511581067,8,0.00402819738167,46,0.0231621349446,50,0.0251762336354,716,164,159,711,875,18,0.00906344410876,716,0.36052366566,113,0.0568982880161,1873,0.943101711984,1002,0.504531722054,05,Hoke,3709305
Hoke,10292,5747,0.558394869802,3212,0.312087057909,190,0.0184609405363,259,0.0251651768364,527,0.0512048192771,357,0.0346871356393,3364,318,261,3307,3625,152,0.0147687524291,3364,0.326855810338,1291,0.125437232802,9001,0.874562767198,5152,0.50058297707,06,Hoke,3709306
Hoke,4008,2747,0.685379241517,833,0.207834331337,123,0.0306886227545,68,0.0169660678643,125,0.0311876247505,112,0.0279441117764,880,171,155,864,1035,47,0.0117265469062,880,0.219560878244,366,0.0913173652695,3642,0.908682634731,2549,0.635978043912,12,Hoke,3709312
Hoke,1477,856,0.579553148274,329,0.222748815166,233,0.157752200406,10,0.00677048070413,29,0.019634394042,20,0.0135409614083,335,250,245,330,580,6,0.00406228842248,335,0.226811103588,53,0.0358835477319,1424,0.964116452268,838,0.567366283006,13,Hoke,3709313
Hoke,1761,691,0.39239068711,816,0.463373083475,82,0.0465644520159,13,0.00738216922203,133,0.0755252697331,26,0.0147643384441,821,97,95,819,916,5,0.00283929585463,821,0.46621237933,181,0.102782509938,1580,0.897217490062,665,0.377626348666,61,Hoke,3709361
Hoke,1151,558,0.484795829713,456,0.396177237185,46,0.0399652476108,16,0.0139009556907,39,0.0338835794961,36,0.0312771503041,475,54,47,468,522,19,0.0165073848827,475,0.412684622068,71,0.0616854908775,1080,0.938314509123,542,0.470894874023,62,Hoke,3709362
Hoke,3886,1440,0.370560988163,1690,0.434894493052,116,0.0298507462687,38,0.00977869274318,468,0.120432321153,134,0.0344827586207,1757,167,134,1724,1891,67,0.0172413793103,1757,0.452135872362,762,0.196088522903,3124,0.803911477097,1224,0.314976839938,63,Hoke,3709363
Hoke,2036,943,0.463163064833,895,0.439587426326,111,0.0545186640472,11,0.00540275049116,43,0.0211198428291,33,0.0162082514735,907,129,123,901,1030,12,0.00589390962672,907,0.445481335953,88,0.0432220039293,1948,0.956777996071,916,0.449901768173,64,Hoke,3709364
Hoke,742,31,0.0417789757412,685,0.923180592992,6,0.00808625336927,1,0.00134770889488,10,0.0134770889488,9,0.0121293800539,694,11,6,689,700,9,0.0121293800539,694,0.935309973046,11,0.0148247978437,731,0.985175202156,30,0.0404312668464,65,Hoke,3709365
Hyde,421,358,0.850356294537,20,0.0475059382423,5,0.0118764845606,2,0.00475059382423,31,0.0736342042755,5,0.0118764845606,21,7,7,21,28,1,0.00237529691211,21,0.0498812351544,38,0.0902612826603,383,0.90973871734,351,0.833729216152,BM,Hyde,37095BM
Hyde,761,463,0.608409986859,274,0.360052562418,1,0.00131406044678,1,0.00131406044678,12,0.0157687253614,10,0.0131406044678,281,1,1,281,282,7,0.00919842312746,281,0.369250985545,32,0.042049934297,729,0.957950065703,444,0.583442838371,ENG,Hyde,37095ENG
Hyde,1109,426,0.384129846709,635,0.572587917042,14,0.0126239855726,7,0.00631199278629,25,0.0225428313796,2,0.00180342651037,636,16,15,635,651,1,0.000901713255185,636,0.573489630298,9,0.00811541929666,1100,0.991884580703,424,0.382326420198,FF,Hyde,37095FF
Hyde,607,315,0.518945634267,283,0.466227347611,3,0.00494233937397,2,0.00329489291598,0,0.0,4,0.00658978583196,284,6,6,284,290,1,0.00164744645799,284,0.467874794069,30,0.0494233937397,577,0.95057660626,289,0.476112026359,LL,Hyde,37095LL
Hyde,751,720,0.958721704394,10,0.0133155792277,4,0.00532623169108,1,0.00133155792277,10,0.0133155792277,6,0.00798934753662,10,10,10,10,20,0,0.0,10,0.0133155792277,118,0.157123834887,633,0.842876165113,612,0.814913448735,OCK,Hyde,37095OCK
Hyde,445,277,0.622471910112,160,0.359550561798,0,0.0,0,0.0,4,0.00898876404494,4,0.00898876404494,162,2,1,161,163,2,0.00449438202247,162,0.36404494382,2,0.00449438202247,443,0.995505617978,277,0.622471910112,SLAD,Hyde,37095SLAD
Hyde,640,450,0.703125,174,0.271875,0,0.0,0,0.0,11,0.0171875,5,0.0078125,174,4,4,174,178,0,0.0,174,0.271875,32,0.05,608,0.95,431,0.6734375,SQ,Hyde,37095SQ
Iredell,4825,4233,0.877305699482,429,0.0889119170984,11,0.00227979274611,34,0.00704663212435,59,0.0122279792746,59,0.0122279792746,443,42,36,437,479,14,0.00290155440415,443,0.0918134715026,145,0.0300518134715,4680,0.969948186528,4161,0.862383419689,BA,Iredell,37097BA
Iredell,5249,4573,0.871213564488,367,0.0699180796342,21,0.00400076204991,58,0.0110497237569,181,0.0344827586207,49,0.0093351114498,375,32,32,375,407,8,0.00152409982854,375,0.0714421794628,375,0.0714421794628,4874,0.928557820537,4415,0.841112592875,BE,Iredell,37097BE
Iredell,5832,5087,0.872256515775,479,0.0821330589849,25,0.00428669410151,49,0.00840192043896,108,0.0185185185185,84,0.0144032921811,516,58,51,509,567,37,0.00634430727023,516,0.0884773662551,298,0.05109739369,5534,0.94890260631,4919,0.843449931413,CC1,Iredell,37097CC1
Iredell,6444,4904,0.761018001241,1108,0.171942892613,33,0.00512104283054,106,0.0164494103042,206,0.0319677219119,87,0.0135009310987,1149,65,54,1138,1203,41,0.00636250775916,1149,0.178305400372,440,0.0682805710739,6004,0.931719428926,4703,0.72982619491,CC2,Iredell,37097CC2
Iredell,7675,6473,0.84338762215,780,0.101628664495,41,0.00534201954397,100,0.0130293159609,181,0.0235830618893,100,0.0130293159609,798,88,84,794,882,18,0.00234527687296,798,0.103973941368,406,0.0528990228013,7269,0.947100977199,6284,0.818762214984,CC3,Iredell,37097CC3
Iredell,6582,5741,0.872227286539,314,0.0477058644789,25,0.00379823761775,345,0.0524156791249,87,0.0132178669098,70,0.0106350653297,332,53,50,329,382,18,0.00273473108478,332,0.0504405955637,274,0.0416286842905,6308,0.95837131571,5568,0.845943482224,CC4,Iredell,37097CC4
Iredell,5253,4551,0.866362078812,409,0.0778602703217,9,0.0017133066819,84,0.0159908623644,156,0.0296973158195,44,0.00837616600038,422,29,25,418,447,13,0.00247477631829,422,0.08033504664,322,0.0612983057301,4931,0.93870169427,4410,0.839520274129,CD,Iredell,37097CD
Iredell,2677,1993,0.744490100859,524,0.195741501681,15,0.00560328726186,41,0.0153156518491,85,0.0317519611505,19,0.00709749719836,530,29,25,526,555,6,0.00224131490474,530,0.197982816586,173,0.0646245797535,2504,0.935375420247,1927,0.719835636907,CH-A,Iredell,37097CH-A
Iredell,3566,2895,0.811833987661,336,0.0942232192933,10,0.00280426247897,37,0.0103757711722,244,0.0684240044868,44,0.0123387549075,357,31,25,351,382,21,0.00588895120583,357,0.100112170499,374,0.104879416713,3192,0.895120583287,2780,0.779584969153,CH-B,Iredell,37097CH-B
Iredell,2911,2383,0.818619031261,370,0.127104087942,4,0.00137409824802,50,0.0171762281003,86,0.0295431123325,18,0.00618344211611,377,11,10,376,387,7,0.00240467193404,377,0.129508759876,155,0.053246307111,2756,0.946753692889,2317,0.795946410168,CS,Iredell,37097CS
Iredell,5764,5318,0.922623178348,170,0.029493407356,14,0.00242886884108,162,0.028105482304,66,0.0114503816794,34,0.0058986814712,178,24,24,178,202,8,0.00138792505205,178,0.030881332408,199,0.0345246356697,5565,0.96547536433,5195,0.901283830673,DV1-A,Iredell,37097DV1-A
Iredell,7314,6927,0.947087776866,129,0.0176374077112,21,0.00287120590648,104,0.0142193054416,61,0.00834016953787,72,0.00984413453651,142,52,51,141,193,13,0.0017774131802,142,0.0194148208914,192,0.0262510254307,7122,0.973748974569,6810,0.931091058244,DV1-B,Iredell,37097DV1-B
Iredell,3806,3611,0.948765107725,52,0.0136626379401,12,0.00315291644771,84,0.022070415134,25,0.00656857593274,22,0.00578034682081,57,24,21,54,78,5,0.00131371518655,57,0.0149763531266,109,0.0286389910667,3697,0.971361008933,3528,0.926957435628,DV2-A,Iredell,37097DV2-A
Iredell,4102,3648,0.889322281814,125,0.0304729400293,11,0.00268161872257,230,0.0560702096538,43,0.0104826913701,45,0.0109702584105,136,32,28,132,164,11,0.00268161872257,136,0.0331545587518,140,0.0341296928328,3962,0.965870307167,3564,0.868844466114,DV2-B,Iredell,37097DV2-B
Iredell,1406,1214,0.863442389758,106,0.0753911806543,1,0.000711237553343,1,0.000711237553343,72,0.0512091038407,12,0.00853485064011,106,9,9,106,115,0,0.0,106,0.0753911806543,89,0.0633001422475,1317,0.936699857752,1198,0.852062588905,EM,Iredell,37097EM
Iredell,6855,6060,0.884026258206,625,0.09117432531,10,0.00145878920496,45,0.00656455142232,62,0.00904449307075,53,0.00773158278629,646,32,24,638,670,21,0.00306345733042,646,0.0942377826404,177,0.0258205689278,6678,0.974179431072,5960,0.869438366156,FT,Iredell,37097FT
Iredell,1295,1259,0.972200772201,4,0.0030888030888,3,0.0023166023166,1,0.000772200772201,17,0.0131274131274,11,0.00849420849421,7,9,9,7,16,3,0.0023166023166,7,0.00540540540541,30,0.023166023166,1265,0.976833976834,1251,0.966023166023,NH,Iredell,37097NH
Iredell,1402,1310,0.934379457917,30,0.0213980028531,6,0.00427960057061,1,0.000713266761769,50,0.0356633380884,5,0.00356633380884,32,9,9,32,41,2,0.00142653352354,32,0.0228245363766,65,0.046362339515,1337,0.953637660485,1295,0.923680456491,OL,Iredell,37097OL
Iredell,2006,1884,0.939182452642,84,0.0418743768694,2,0.000997008973081,1,0.00049850448654,22,0.0109670987039,13,0.00648055832502,86,13,12,85,98,2,0.000997008973081,86,0.0428713858425,45,0.0224327018943,1961,0.977567298106,1860,0.927218344965,SB,Iredell,37097SB
Iredell,3401,3058,0.899147309615,173,0.0508673919435,8,0.00235224933843,79,0.023228462217,50,0.0147015583652,33,0.00970302852102,180,20,20,180,200,7,0.00205821817113,180,0.0529256101147,98,0.0288150543958,3303,0.971184945604,3020,0.887974125257,SH-A,Iredell,37097SH-A
Iredell,3415,3122,0.91420204978,218,0.0638360175695,12,0.00351390922401,15,0.00439238653001,30,0.00878477306003,18,0.00527086383602,220,20,20,220,240,2,0.000585651537335,220,0.0644216691069,52,0.0152269399707,3363,0.984773060029,3105,0.909224011713,SH-B,Iredell,37097SH-B
Iredell,4273,3106,0.726889772993,682,0.159606833606,9,0.00210624853733,186,0.0435291364381,230,0.0538263515095,60,0.0140416569155,705,22,14,697,719,23,0.00538263515095,705,0.164989468757,482,0.112801310555,3791,0.887198689445,2891,0.676573835713,ST1,Iredell,37097ST1
Iredell,3447,2415,0.700609225413,719,0.208587177256,10,0.00290107339716,50,0.0145053669858,208,0.0603423266609,45,0.0130548302872,737,26,17,728,754,18,0.00522193211488,737,0.21380910937,356,0.103278212939,3091,0.896721787061,2304,0.668407310705,ST2,Iredell,37097ST2
Iredell,3695,1799,0.486874154263,1612,0.436265223275,12,0.00324763193505,22,0.00595399188092,195,0.0527740189445,55,0.0148849797023,1638,40,22,1620,1660,26,0.00703653585927,1638,0.443301759134,312,0.0844384303112,3383,0.915561569689,1717,0.464682002706,ST3,Iredell,37097ST3
Iredell,3470,2577,0.74265129683,677,0.195100864553,9,0.00259365994236,26,0.00749279538905,151,0.0435158501441,30,0.00864553314121,691,25,15,681,706,14,0.00403458213256,691,0.199135446686,241,0.0694524495677,3229,0.930547550432,2500,0.720461095101,ST4,Iredell,37097ST4
Iredell,3587,2431,0.677725118483,967,0.269584611096,9,0.00250906049624,33,0.0091998884862,107,0.0298299414553,40,0.0111513799833,986,28,19,977,1005,19,0.00529690549205,986,0.274881516588,239,0.0666294954001,3348,0.9333705046,2318,0.646222470031,ST5,Iredell,37097ST5
Iredell,4018,1912,0.475858636137,1773,0.441264310602,17,0.00423096067695,42,0.0104529616725,227,0.0564957690393,47,0.0116973618716,1796,37,30,1789,1826,23,0.00572424091588,1796,0.446988551518,402,0.100049776008,3616,0.899950223992,1760,0.438028870085,ST6,Iredell,37097ST6
Iredell,2911,2298,0.78941944349,381,0.130882858124,9,0.00309172105806,2,0.000687049124012,200,0.0687049124012,21,0.00721401580213,385,20,18,383,403,4,0.00137409824802,385,0.132256956372,248,0.0851940913775,2663,0.914805908622,2256,0.774991411886,TB,Iredell,37097TB
Iredell,1671,1504,0.900059844405,39,0.0233393177738,16,0.00957510472771,1,0.000598444045482,106,0.0634350688211,5,0.00299222022741,39,21,21,39,60,0,0.0,39,0.0233393177738,144,0.0861759425494,1527,0.913824057451,1473,0.881508078995,UG,Iredell,37097UG
Jackson,1702,1621,0.95240893067,10,0.00587544065805,40,0.0235017626322,3,0.00176263219741,13,0.00763807285546,15,0.00881316098707,10,52,52,10,62,0,0.0,10,0.00587544065805,24,0.0141010575793,1678,0.985898942421,1613,0.947708578143,ALLSC,Jackson,37099ALLSC
Jackson,1485,1409,0.948821548822,8,0.00538720538721,44,0.0296296296296,5,0.003367003367,3,0.0020202020202,16,0.0107744107744,8,58,58,8,66,0,0.0,8,0.00538720538721,24,0.0161616161616,1461,0.983838383838,1389,0.935353535354,BCK,Jackson,37099BCK
Jackson,518,505,0.974903474903,1,0.0019305019305,6,0.011583011583,2,0.003861003861,0,0.0,4,0.00772200772201,2,7,7,2,9,1,0.0019305019305,2,0.003861003861,9,0.0173745173745,509,0.982625482625,498,0.96138996139,CAN,Jackson,37099CAN
Jackson,1698,1587,0.934628975265,8,0.00471142520612,11,0.00647820965842,9,0.00530035335689,74,0.0435806831567,9,0.00530035335689,8,17,17,8,25,0,0.0,8,0.00471142520612,128,0.075382803298,1570,0.924617196702,1539,0.906360424028,CAS,Jackson,37099CAS
Jackson,591,575,0.972927241963,0,0.0,9,0.0152284263959,1,0.00169204737733,4,0.00676818950931,2,0.00338409475465,1,10,10,1,11,1,0.00169204737733,1,0.00169204737733,7,0.0118443316413,584,0.988155668359,572,0.967851099831,CFK,Jackson,37099CFK
Jackson,8698,7680,0.882961600368,515,0.0592090135663,56,0.00643826166935,98,0.0112669579214,222,0.0255231087606,127,0.0146010577144,571,110,94,555,665,56,0.00643826166935,571,0.0656472752357,357,0.0410439181421,8341,0.958956081858,7572,0.870544952863,CUL,Jackson,37099CUL
Jackson,1147,1112,0.969485614647,6,0.0052310374891,9,0.00784655623365,8,0.00697471665214,4,0.00348735832607,8,0.00697471665214,7,15,15,7,22,1,0.000871839581517,7,0.00610287707062,15,0.0130775937228,1132,0.986922406277,1101,0.95989537925,GCK,Jackson,37099GCK
Jackson,1825,1754,0.961095890411,1,0.000547945205479,11,0.00602739726027,6,0.00328767123288,45,0.0246575342466,8,0.00438356164384,2,16,16,2,18,1,0.000547945205479,2,0.00109589041096,136,0.0745205479452,1689,0.925479452055,1664,0.911780821918,HAMMNT,Jackson,37099HAMMNT
Jackson,4553,2020,0.443663518559,22,0.004831978915,2227,0.489128047441,45,0.00988359323523,69,0.0151548429607,170,0.0373380188886,37,2380,2376,33,2413,15,0.00329453107841,37,0.00812650999341,187,0.0410718207775,4366,0.958928179222,1960,0.430485394246,QUA,Jackson,37099QUA
Jackson,1024,873,0.8525390625,10,0.009765625,14,0.013671875,6,0.005859375,118,0.115234375,3,0.0029296875,10,17,17,10,27,0,0.0,10,0.009765625,150,0.146484375,874,0.853515625,845,0.8251953125,RIV,Jackson,37099RIV
Jackson,1186,1146,0.966273187184,1,0.000843170320405,27,0.0227655986509,3,0.00252951096121,0,0.0,9,0.00758853288364,2,33,33,2,35,1,0.000843170320405,2,0.00168634064081,6,0.00505902192243,1180,0.994940978078,1142,0.962900505902,SAV,Jackson,37099SAV
Jackson,6562,6039,0.920298689424,95,0.0144772935081,99,0.015086863761,84,0.0128009753124,160,0.0243828101189,85,0.0129533678756,109,161,154,102,263,14,0.0021334958854,109,0.0166107893935,266,0.0405364218226,6296,0.959463578177,5951,0.906888143859,SYLDIL,Jackson,37099SYLDIL
Jackson,2159,2064,0.95599814729,23,0.0106530801297,22,0.0101899027327,16,0.00741083835109,12,0.00555812876332,22,0.0101899027327,25,38,37,24,62,2,0.000926354793886,25,0.0115794349236,22,0.0101899027327,2137,0.989810097267,2056,0.952292728115,WEB,Jackson,37099WEB
Johnston,1681,1272,0.756692444973,207,0.123140987507,8,0.00475907198096,10,0.0059488399762,151,0.0898274836407,33,0.0196311719215,214,31,28,211,242,7,0.00416418798334,214,0.127305175491,199,0.118381915526,1482,0.881618084474,1240,0.737656157049,PR01,Johnston,37101PR01
Johnston,1257,841,0.669053301512,349,0.277645186953,5,0.00397772474145,1,0.00079554494829,52,0.0413683373111,9,0.00715990453461,354,11,7,350,361,5,0.00397772474145,354,0.281622911695,91,0.0723945902944,1166,0.927605409706,807,0.64200477327,PR02,Johnston,37101PR02
Johnston,2244,1861,0.829322638146,212,0.0944741532977,13,0.00579322638146,6,0.00267379679144,130,0.0579322638146,22,0.00980392156863,219,19,18,218,237,7,0.00311942959002,219,0.0975935828877,180,0.0802139037433,2064,0.919786096257,1822,0.811942959002,PR03,Johnston,37101PR03
Johnston,1424,980,0.688202247191,273,0.191713483146,17,0.0119382022472,1,0.000702247191011,140,0.0983146067416,13,0.00912921348315,275,22,22,275,297,2,0.00140449438202,275,0.193117977528,166,0.116573033708,1258,0.883426966292,966,0.678370786517,PR04,Johnston,37101PR04
Johnston,1312,1019,0.776676829268,214,0.163109756098,8,0.00609756097561,1,0.000762195121951,69,0.0525914634146,1,0.000762195121951,214,9,9,214,223,0,0.0,214,0.163109756098,95,0.0724085365854,1217,0.927591463415,993,0.756859756098,PR05,Johnston,37101PR05
Johnston,1973,1653,0.837810440953,237,0.120121642169,9,0.0045615813482,4,0.00202736948809,54,0.0273694880892,16,0.00810947795236,240,18,16,238,256,3,0.00152052711607,240,0.121642169285,117,0.0593005575266,1856,0.940699442473,1598,0.809934110492,PR06,Johnston,37101PR06
Johnston,3120,2578,0.826282051282,367,0.117628205128,12,0.00384615384615,10,0.00320512820513,131,0.0419871794872,22,0.00705128205128,375,20,19,374,394,8,0.0025641025641,375,0.120192307692,187,0.0599358974359,2933,0.940064102564,2526,0.809615384615,PR07,Johnston,37101PR07
Johnston,2235,2046,0.915436241611,87,0.0389261744966,10,0.00447427293065,10,0.00447427293065,64,0.0286353467562,18,0.00805369127517,90,18,17,89,107,3,0.00134228187919,90,0.0402684563758,107,0.0478747203579,2128,0.952125279642,2013,0.90067114094,PR08,Johnston,37101PR08
Johnston,4164,3440,0.826128722382,456,0.109510086455,14,0.00336215177714,53,0.0127281460134,166,0.0398655139289,35,0.00840537944284,466,26,19,459,485,10,0.00240153698367,466,0.111911623439,336,0.0806916426513,3828,0.919308357349,3294,0.791066282421,PR09,Johnston,37101PR09
Johnston,4766,3427,0.719051615611,927,0.194502727654,13,0.00272765421737,37,0.00776332354175,297,0.0623164078892,65,0.0136382710869,956,36,28,948,984,29,0.00608476710029,956,0.200587494755,467,0.0979857322702,4299,0.90201426773,3297,0.691775073437,PR10,Johnston,37101PR10
Johnston,2875,2045,0.711304347826,679,0.236173913043,11,0.00382608695652,17,0.00591304347826,91,0.031652173913,32,0.0111304347826,689,29,23,683,712,10,0.00347826086957,689,0.239652173913,201,0.0699130434783,2674,0.930086956522,1951,0.678608695652,PR11A,Johnston,37101PR11A
Johnston,4077,3277,0.803777287221,606,0.14863870493,15,0.00367917586461,59,0.0144714250675,87,0.0213392200147,33,0.00809418690213,619,29,23,613,642,13,0.00318861908266,619,0.151827324013,226,0.0554329163601,3851,0.94456708364,3153,0.77336276674,PR11B,Johnston,37101PR11B
Johnston,6596,5488,0.8320194057,843,0.127804730139,39,0.00591267434809,68,0.0103092783505,82,0.0124317768344,76,0.011522134627,869,71,62,860,931,26,0.00394178289873,869,0.131746513038,229,0.0347180109157,6367,0.965281989084,5363,0.81306852638,PR12,Johnston,37101PR12
Johnston,2659,2274,0.855208725085,243,0.0913877397518,17,0.00639338097029,23,0.00864986837157,71,0.0267017675818,31,0.0116585182399,256,36,28,248,284,13,0.0048890560361,256,0.0962767957879,165,0.0620534035352,2494,0.937946596465,2198,0.826626551335,PR13,Johnston,37101PR13
Johnston,2327,2087,0.896862913623,63,0.027073485174,14,0.00601633003868,8,0.00343790287924,128,0.0550064460679,27,0.0116029222174,67,22,20,65,87,4,0.00171895143962,67,0.0287924366137,202,0.0868070477009,2125,0.913192952299,2030,0.872367855608,PR14,Johnston,37101PR14
Johnston,2893,2304,0.796405115797,193,0.0667127549257,21,0.00725890079502,7,0.00241963359834,332,0.11475976495,36,0.0124438299343,200,37,34,197,234,7,0.00241963359834,200,0.069132388524,487,0.168337366056,2406,0.831662633944,2177,0.752506049084,PR15,Johnston,37101PR15
Johnston,2305,1686,0.731453362256,312,0.13535791757,21,0.00911062906725,3,0.00130151843818,245,0.106290672451,38,0.0164859002169,319,40,37,316,356,7,0.00303687635575,319,0.138394793926,342,0.148373101952,1963,0.851626898048,1619,0.702386117137,PR16,Johnston,37101PR16
Johnston,985,841,0.853807106599,45,0.0456852791878,4,0.00406091370558,2,0.00203045685279,92,0.0934010152284,1,0.0010152284264,45,4,4,45,49,0,0.0,45,0.0456852791878,96,0.097461928934,889,0.902538071066,837,0.849746192893,PR17,Johnston,37101PR17
Johnston,1503,1268,0.843646041251,114,0.0758483033932,8,0.00532268795742,1,0.000665335994677,92,0.0612109115103,20,0.0133067198935,119,16,14,117,133,5,0.00332667997339,119,0.0791749833666,152,0.101131071191,1351,0.898868928809,1219,0.811044577512,PR18,Johnston,37101PR18
Johnston,2129,1711,0.803663691874,238,0.111789572569,6,0.00281822451855,1,0.000469704086426,161,0.0756223579145,12,0.00563644903711,244,8,7,243,251,6,0.00281822451855,244,0.114607797088,196,0.0920620009394,1933,0.907937999061,1681,0.789572569281,PR19,Johnston,37101PR19
Johnston,3446,2277,0.66076610563,799,0.2318630296,17,0.00493325594893,4,0.00116076610563,300,0.0870574579222,49,0.014219384794,824,36,23,811,847,25,0.00725478816019,824,0.23911781776,481,0.139582124202,2965,0.860417875798,2133,0.618978525827,PR20,Johnston,37101PR20
Johnston,3032,2486,0.819920844327,247,0.0814643799472,15,0.00494722955145,5,0.00164907651715,242,0.0798153034301,37,0.0122031662269,252,32,32,252,284,5,0.00164907651715,252,0.0831134564644,327,0.107849604222,2705,0.892150395778,2417,0.797163588391,PR21,Johnston,37101PR21
Johnston,3517,2729,0.775945408018,438,0.124537958487,14,0.00398066533978,4,0.00113733295422,304,0.0864373045209,28,0.00796133067956,442,19,18,441,460,4,0.00113733295422,442,0.125675291442,442,0.125675291442,3075,0.874324708558,2615,0.743531418823,PR22,Johnston,37101PR22
Johnston,6742,5585,0.828389202017,632,0.0937407297538,46,0.00682290121626,37,0.0054879857609,369,0.0547315336695,73,0.0108276475823,643,74,70,639,713,11,0.00163156333432,643,0.0953722930881,704,0.104420053397,6038,0.895579946603,5288,0.784336991991,PR23,Johnston,37101PR23
Johnston,3100,1580,0.509677419355,1012,0.326451612903,16,0.00516129032258,9,0.00290322580645,438,0.141290322581,45,0.0145161290323,1025,27,21,1019,1046,13,0.0041935483871,1025,0.33064516129,760,0.245161290323,2340,0.754838709677,1301,0.419677419355,PR24,Johnston,37101PR24
Johnston,3178,1660,0.522341095028,846,0.266205160478,13,0.00409062303335,8,0.00251730648206,588,0.185022026432,63,0.0198237885463,866,26,19,859,885,20,0.00629326620516,866,0.272498426683,889,0.279735682819,2289,0.720264317181,1413,0.444619257395,PR25,Johnston,37101PR25
Johnston,3336,1489,0.446342925659,1273,0.381594724221,9,0.00269784172662,13,0.003896882494,495,0.148381294964,57,0.0170863309353,1288,23,15,1280,1303,15,0.0044964028777,1288,0.386091127098,717,0.214928057554,2619,0.785071942446,1332,0.39928057554,PR26,Johnston,37101PR26
Johnston,5521,3943,0.714182213367,1073,0.194348849846,29,0.00525267161746,66,0.0119543560949,356,0.0644810722695,54,0.00978083680493,1099,53,45,1091,1144,26,0.00470929179496,1099,0.199058141641,580,0.105053432349,4941,0.894946567651,3748,0.678862524905,PR27,Johnston,37101PR27
Johnston,4314,3251,0.753592953176,609,0.141168289291,19,0.00440426518312,22,0.0050996754752,372,0.086230876217,41,0.00950394065832,622,35,33,620,655,13,0.00301344459898,622,0.14418173389,702,0.162726008345,3612,0.837273991655,2968,0.68799258229,PR28,Johnston,37101PR28
Johnston,4290,3737,0.871095571096,295,0.0687645687646,17,0.0039627039627,35,0.00815850815851,158,0.0368298368298,48,0.0111888111888,307,38,35,304,342,12,0.0027972027972,307,0.0715617715618,270,0.0629370629371,4020,0.937062937063,3641,0.848717948718,PR29A,Johnston,37101PR29A
Johnston,5236,4508,0.860962566845,522,0.0996944232238,21,0.00401069518717,33,0.0063025210084,96,0.0183346065699,56,0.0106951871658,540,37,29,532,569,18,0.00343773873186,540,0.103132161956,262,0.050038197097,4974,0.949961802903,4368,0.83422459893,PR29B,Johnston,37101PR29B
Johnston,4043,2609,0.64531288647,1064,0.263170912689,44,0.0108830076676,25,0.00618352708385,252,0.0623299530052,49,0.0121197130843,1082,64,59,1077,1141,18,0.00445213950037,1082,0.267623052189,498,0.12317585951,3545,0.87682414049,2415,0.5973287163,PR30,Johnston,37101PR30
Johnston,2535,2030,0.800788954635,308,0.121499013807,11,0.0043392504931,20,0.00788954635108,135,0.0532544378698,31,0.0122287968442,314,19,19,314,333,6,0.00236686390533,314,0.123865877712,216,0.0852071005917,2319,0.914792899408,1965,0.775147928994,PR31A,Johnston,37101PR31A
Johnston,4463,3679,0.824333408022,470,0.105310329375,26,0.00582567779521,44,0.00985883934573,178,0.0398834864441,66,0.0147882590186,490,53,48,485,538,20,0.0044812906117,490,0.109791619987,359,0.0804391664799,4104,0.91956083352,3520,0.788707147659,PR31B,Johnston,37101PR31B
Johnston,2793,2293,0.820981023989,287,0.102756892231,13,0.0046544933763,13,0.0046544933763,148,0.0529896168994,39,0.0139634801289,304,23,19,300,323,17,0.00608664518439,304,0.108843537415,279,0.0998925886144,2514,0.900107411386,2188,0.783387039026,PR32,Johnston,37101PR32
Johnston,3702,3188,0.861156131821,218,0.0588870880605,41,0.0110750945435,28,0.00756347920043,180,0.0486223662885,47,0.0126958400864,224,72,70,222,294,6,0.00162074554295,224,0.0605078336035,381,0.102917341977,3321,0.897082658023,3023,0.81658562939,PR33,Johnston,37101PR33
Johnston,6135,4186,0.682314588427,1384,0.225590872046,43,0.00700896495518,67,0.0109209453953,370,0.0603096984515,85,0.0138549307253,1422,75,61,1408,1483,38,0.00619396903015,1422,0.231784841076,727,0.118500407498,5408,0.881499592502,3891,0.634229828851,PR34,Johnston,37101PR34
Jones,822,538,0.654501216545,250,0.304136253041,2,0.00243309002433,2,0.00243309002433,20,0.0243309002433,10,0.0121654501217,253,7,7,253,260,3,0.0036496350365,253,0.307785888078,32,0.0389294403893,790,0.961070559611,529,0.643552311436,P01,Jones,37103P01
Jones,521,433,0.831094049904,62,0.119001919386,4,0.00767754318618,0,0.0,19,0.0364683301344,3,0.00575815738964,64,4,4,64,68,2,0.00383877159309,64,0.122840690979,24,0.0460652591171,497,0.953934740883,430,0.825335892514,P02,Jones,37103P02
Jones,689,612,0.88824383164,67,0.0972423802612,3,0.00435413642961,0,0.0,6,0.00870827285922,1,0.00145137880987,67,3,3,67,70,0,0.0,67,0.0972423802612,19,0.0275761973875,670,0.972423802612,600,0.870827285922,P03,Jones,37103P03
Jones,2102,1377,0.655090390105,678,0.322549952426,7,0.00333016175071,11,0.00523311132255,9,0.00428163653663,20,0.00951474785918,691,21,13,683,704,13,0.00618458610847,691,0.328734538535,36,0.0171265461465,2066,0.982873453853,1353,0.643672692674,P04,Jones,37103P04
Jones,1538,726,0.472041612484,759,0.493498049415,12,0.00780234070221,3,0.00195058517555,21,0.0136540962289,17,0.0110533159948,767,20,16,763,783,8,0.00520156046814,767,0.498699609883,46,0.0299089726918,1492,0.970091027308,703,0.457087126138,P05,Jones,37103P05
Jones,707,559,0.790664780764,101,0.142857142857,3,0.004243281471,4,0.00565770862801,32,0.045261669024,8,0.011315417256,102,8,8,102,110,1,0.001414427157,102,0.144271570014,42,0.0594059405941,665,0.940594059406,552,0.780763790665,P06,Jones,37103P06
Jones,1566,888,0.567049808429,617,0.393997445722,13,0.00830140485313,11,0.00702426564496,9,0.00574712643678,28,0.0178799489144,630,29,23,624,653,13,0.00830140485313,630,0.402298850575,50,0.0319284802043,1516,0.968071519796,858,0.547892720307,P07,Jones,37103P07
Lee,13299,6816,0.512519738326,4298,0.32318219415,115,0.00864726671178,122,0.00917362207685,1693,0.127302804722,255,0.0191743740131,4379,193,160,4346,4539,81,0.00609068351004,4379,0.32927287766,3228,0.242725016919,10071,0.757274983081,5513,0.414542446801,A,Lee,37105A
Lee,5063,3646,0.720126407268,1026,0.202646652183,27,0.00533280663638,44,0.00869049970373,255,0.0503653960103,65,0.0128382381987,1048,57,50,1041,1098,22,0.00434524985187,1048,0.206991902034,576,0.113766541576,4487,0.886233458424,3359,0.663440647837,B,Lee,37105B
Lee,8986,7322,0.81482305809,1042,0.115958157133,65,0.00723347429335,40,0.0044513687959,385,0.0428444246606,132,0.0146895170265,1072,119,109,1062,1181,30,0.00333852659693,1072,0.11929668373,702,0.0781215223681,8284,0.921878477632,7072,0.787002003116,C,Lee,37105C
Lee,8015,6717,0.838053649407,861,0.107423580786,34,0.00424204616344,126,0.0157205240175,206,0.0257018091079,71,0.00885839051778,888,58,48,878,936,27,0.00336868371803,888,0.110792264504,453,0.0565190268247,7562,0.943480973175,6511,0.812351840299,D,Lee,37105D
Lee,7643,5609,0.733874133194,1114,0.145754284967,49,0.00641109511972,55,0.00719612717519,692,0.0905403637315,124,0.0162239958132,1145,76,70,1139,1215,31,0.00405599895329,1145,0.14981028392,1364,0.178463953945,6279,0.821536046055,5055,0.661389506738,E,Lee,37105E
Lenoir,2724,1522,0.558737151248,1073,0.393906020558,7,0.00256975036711,14,0.00513950073421,83,0.03046989721,25,0.00917767988253,1089,19,10,1080,1099,16,0.00587371512482,1089,0.399779735683,145,0.0532305433186,2579,0.946769456681,1472,0.540381791483,C,Lenoir,37107C
Lenoir,4572,3581,0.783245844269,785,0.171697287839,36,0.00787401574803,37,0.0080927384077,98,0.0214348206474,35,0.00765529308836,799,47,43,795,842,14,0.00306211723535,799,0.174759405074,230,0.0503062117235,4342,0.949693788276,3473,0.759623797025,FC,Lenoir,37107FC
Lenoir,1941,1420,0.731581658939,407,0.209685729006,14,0.00721277691911,7,0.00360638845956,86,0.0443070582174,7,0.00360638845956,411,18,17,410,428,4,0.00206079340546,411,0.211746522411,134,0.0690365790829,1807,0.930963420917,1375,0.708397733127,I,Lenoir,37107I
Lenoir,1242,28,0.0225442834138,1202,0.967793880837,2,0.00161030595813,1,0.000805152979066,2,0.00161030595813,7,0.00563607085346,1209,7,2,1204,1211,7,0.00563607085346,1209,0.973429951691,9,0.00724637681159,1233,0.992753623188,26,0.0209339774557,K1,Lenoir,37107K1
Lenoir,1373,109,0.0793882010197,1236,0.900218499636,1,0.000728332119446,2,0.00145666423889,14,0.0101966496723,11,0.00801165331391,1243,5,4,1242,1247,7,0.00509832483613,1243,0.905316824472,20,0.0145666423889,1353,0.985433357611,109,0.0793882010197,K2,Lenoir,37107K2
Lenoir,1541,579,0.375730045425,883,0.573004542505,5,0.00324464633355,10,0.0064892926671,39,0.0253082414017,25,0.0162232316677,896,13,8,891,904,13,0.00843608046723,896,0.581440622972,88,0.0571057754705,1453,0.94289422453,542,0.351719662557,K3,Lenoir,37107K3
Lenoir,3020,2101,0.695695364238,829,0.274503311258,4,0.00132450331126,31,0.0102649006623,36,0.0119205298013,19,0.00629139072848,840,11,8,837,848,11,0.00364238410596,840,0.278145695364,69,0.0228476821192,2951,0.977152317881,2070,0.685430463576,K4,Lenoir,37107K4
Lenoir,1622,655,0.40382244143,925,0.570283600493,3,0.00184956843403,18,0.0110974106042,12,0.00739827373613,9,0.0055487053021,932,4,3,931,935,7,0.00431565967941,932,0.574599260173,24,0.0147965474723,1598,0.985203452528,647,0.39889025894,K5,Lenoir,37107K5
Lenoir,2322,341,0.146856158484,1938,0.834625322997,6,0.00258397932817,14,0.00602928509905,10,0.00430663221361,13,0.00559862187769,1948,10,7,1945,1955,10,0.00430663221361,1948,0.838931955211,32,0.0137812230835,2290,0.986218776916,333,0.143410852713,K6,Lenoir,37107K6
Lenoir,2150,392,0.182325581395,1704,0.792558139535,9,0.00418604651163,6,0.00279069767442,18,0.00837209302326,21,0.00976744186047,1722,19,10,1713,1732,18,0.00837209302326,1722,0.800930232558,40,0.0186046511628,2110,0.981395348837,380,0.176744186047,K7,Lenoir,37107K7
Lenoir,1118,6,0.00536672629696,1100,0.983899821109,6,0.00536672629696,1,0.000894454382826,0,0.0,5,0.00447227191413,1105,10,6,1101,1111,5,0.00447227191413,1105,0.988372093023,3,0.00268336314848,1115,0.997316636852,6,0.00536672629696,K8,Lenoir,37107K8
Lenoir,1998,991,0.495995995996,931,0.465965965966,5,0.0025025025025,31,0.0155155155155,19,0.00950950950951,21,0.0105105105105,939,12,10,937,949,8,0.004004004004,939,0.46996996997,50,0.025025025025,1948,0.974974974975,964,0.482482482482,K9,Lenoir,37107K9
Lenoir,4381,2347,0.5357224378,1775,0.40515863958,18,0.00410865099292,24,0.0054782013239,178,0.0406299931522,39,0.00890207715134,1792,36,27,1783,1819,17,0.00388039260443,1792,0.409039032184,278,0.0634558320018,4103,0.936544167998,2272,0.518603058662,MH,Lenoir,37107MH
Lenoir,3898,2784,0.714212416624,896,0.229861467419,14,0.00359158542842,7,0.00179579271421,157,0.0402770651616,40,0.0102616726526,912,27,24,909,936,16,0.00410466906106,912,0.23396613648,262,0.0672139558748,3636,0.932786044125,2699,0.692406362237,N,Lenoir,37107N
Lenoir,793,663,0.83606557377,60,0.0756620428752,9,0.0113493064313,0,0.0,55,0.0693568726356,6,0.00756620428752,62,9,9,62,71,2,0.00252206809584,62,0.078184110971,88,0.110970996217,705,0.889029003783,642,0.809583858764,PH1,Lenoir,37107PH1
Lenoir,1467,1116,0.760736196319,152,0.103612815269,3,0.00204498977505,3,0.00204498977505,188,0.12815269257,5,0.00340831629175,155,6,5,154,160,3,0.00204498977505,155,0.105657805044,242,0.164962508521,1225,0.835037491479,1070,0.729379686435,PH2,Lenoir,37107PH2
Lenoir,945,782,0.827513227513,119,0.125925925926,3,0.0031746031746,2,0.0021164021164,29,0.0306878306878,10,0.010582010582,120,9,8,119,128,1,0.0010582010582,120,0.126984126984,52,0.0550264550265,893,0.944973544974,760,0.804232804233,SH,Lenoir,37107SH
Lenoir,1324,1128,0.851963746224,123,0.0929003021148,5,0.00377643504532,4,0.00302114803625,54,0.0407854984894,10,0.00755287009063,123,12,12,123,135,0,0.0,123,0.0929003021148,70,0.0528700906344,1254,0.947129909366,1113,0.840634441088,SW,Lenoir,37107SW
Lenoir,1564,1268,0.81074168798,151,0.096547314578,8,0.00511508951407,5,0.00319693094629,118,0.0754475703325,14,0.00895140664962,154,13,11,152,165,3,0.00191815856777,154,0.0984654731458,164,0.104859335038,1400,0.895140664962,1234,0.789002557545,T1,Lenoir,37107T1
Lenoir,1177,1014,0.861512319456,66,0.0560747663551,4,0.00339847068819,3,0.00254885301614,77,0.0654205607477,13,0.0110450297366,68,11,9,66,77,2,0.0016992353441,68,0.0577740016992,120,0.101954120646,1057,0.898045879354,977,0.83007646559,T2,Lenoir,37107T2
Lenoir,2709,1364,0.503506829088,1197,0.441860465116,8,0.00295311923219,7,0.00258397932817,116,0.0428202288667,17,0.0062753783684,1203,14,13,1202,1216,6,0.00221483942414,1203,0.44407530454,193,0.0712440014766,2516,0.928755998523,1294,0.477667035807,V,Lenoir,37107V
Lenoir,1282,1171,0.913416536661,69,0.0538221528861,4,0.00312012480499,0,0.0,32,0.0249609984399,6,0.00468018720749,70,6,6,70,76,1,0.000780031201248,70,0.0546021840874,50,0.0390015600624,1232,0.960998439938,1155,0.900936037441,W,Lenoir,37107W
Lincoln,2558,2326,0.909304143862,98,0.0383111806099,5,0.00195465207193,21,0.00820953870211,74,0.0289288506646,34,0.0132916340891,102,12,12,102,114,4,0.00156372165754,102,0.0398749022674,239,0.0934323690383,2319,0.906567630962,2180,0.852228303362,AS25,Lincoln,37109AS25
Lincoln,2484,1861,0.749194847021,356,0.143317230274,6,0.0024154589372,22,0.00885668276973,188,0.0756843800322,51,0.0205314009662,371,11,10,370,381,15,0.006038647343,371,0.149355877617,531,0.213768115942,1953,0.786231884058,1569,0.631642512077,BC13,Lincoln,37109BC13
Lincoln,2237,1844,0.824318283415,327,0.146177916853,1,0.000447027268663,7,0.00312919088064,43,0.0192221725525,15,0.00670540902995,328,7,7,328,335,1,0.000447027268663,328,0.146624944122,127,0.0567724631203,2110,0.94322753688,1768,0.790344210997,BS26,Lincoln,37109BS26
Lincoln,1402,1354,0.965763195435,13,0.009272467903,4,0.00285306704708,10,0.00713266761769,12,0.00855920114123,9,0.00641940085592,14,6,6,14,20,1,0.000713266761769,14,0.00998573466476,26,0.018544935806,1376,0.981455064194,1342,0.957203994294,CF19,Lincoln,37109CF19
Lincoln,1108,1061,0.957581227437,12,0.0108303249097,2,0.00180505415162,1,0.000902527075812,23,0.0207581227437,9,0.00812274368231,15,4,3,14,18,3,0.00270758122744,15,0.0135379061372,72,0.0649819494585,1036,0.935018050542,1018,0.918772563177,CR06,Lincoln,37109CR06
Lincoln,2644,2528,0.956127080182,49,0.018532526475,11,0.00416036308623,21,0.00794251134644,23,0.00869894099849,12,0.00453857791225,49,18,18,49,67,0,0.0,49,0.018532526475,61,0.0230711043873,2583,0.976928895613,2489,0.941376701967,DN29,Lincoln,37109DN29
Lincoln,2905,2804,0.965232358003,41,0.0141135972461,7,0.00240963855422,9,0.00309810671256,26,0.00895008605852,18,0.00619621342513,43,20,20,43,63,2,0.000688468158348,43,0.0148020654045,107,0.0368330464716,2798,0.963166953528,2726,0.938382099828,DV08,Lincoln,37109DV08
Lincoln,2234,2059,0.921665174575,131,0.0586392121755,11,0.00492390331244,10,0.00447627573859,11,0.00492390331244,12,0.0053715308863,132,21,20,131,152,1,0.000447627573859,132,0.0590868397493,36,0.0161145926589,2198,0.983885407341,2033,0.910026857654,DW28,Lincoln,37109DW28
Lincoln,2156,1647,0.763914656772,279,0.129406307978,7,0.00324675324675,8,0.00371057513915,189,0.0876623376623,26,0.0120593692022,283,13,11,281,294,4,0.00185528756957,283,0.131261595547,357,0.165584415584,1799,0.834415584416,1507,0.698979591837,HG17,Lincoln,37109HG17
Lincoln,2770,2620,0.945848375451,55,0.0198555956679,3,0.00108303249097,10,0.00361010830325,56,0.0202166064982,26,0.00938628158845,60,15,14,59,74,5,0.00180505415162,60,0.0216606498195,170,0.0613718411552,2600,0.938628158845,2519,0.909386281588,HV07,Lincoln,37109HV07
Lincoln,1770,1648,0.931073446328,65,0.0367231638418,8,0.0045197740113,5,0.00282485875706,29,0.016384180791,15,0.00847457627119,65,19,19,65,84,0,0.0,65,0.0367231638418,50,0.0282485875706,1720,0.971751412429,1624,0.917514124294,IS20,Lincoln,37109IS20
Lincoln,2515,2178,0.866003976143,273,0.108548707753,7,0.00278330019881,14,0.00556660039761,18,0.00715705765408,25,0.00994035785288,278,18,18,278,296,5,0.00198807157058,278,0.110536779324,82,0.0326043737575,2433,0.967395626243,2122,0.843737574553,IS23,Lincoln,37109IS23
Lincoln,1783,1606,0.900729108245,105,0.0588895120583,4,0.00224340998317,15,0.0084127874369,39,0.021873247336,14,0.00785193494111,108,9,8,107,116,3,0.00168255748738,108,0.0605720695457,76,0.0426247896803,1707,0.95737521032,1572,0.881660123388,LI14,Lincoln,37109LI14
Lincoln,1764,1669,0.946145124717,29,0.0164399092971,0,0.0,10,0.00566893424036,45,0.0255102040816,11,0.0062358276644,30,3,3,30,33,1,0.000566893424036,30,0.0170068027211,86,0.0487528344671,1678,0.951247165533,1633,0.925736961451,LM16,Lincoln,37109LM16
Lincoln,1755,1420,0.809116809117,254,0.144729344729,5,0.002849002849,4,0.0022792022792,43,0.0245014245014,29,0.0165242165242,270,16,10,264,280,16,0.00911680911681,270,0.153846153846,148,0.0843304843305,1607,0.91566951567,1328,0.756695156695,LN11,Lincoln,37109LN11
Lincoln,2066,1627,0.787512100678,303,0.146660212972,9,0.00435624394966,3,0.00145208131655,91,0.0440464666021,33,0.0159728944821,317,20,17,314,334,14,0.00677637947725,317,0.153436592449,207,0.100193610842,1859,0.899806389158,1531,0.741045498548,LS12,Lincoln,37109LS12
Lincoln,1584,1514,0.955808080808,26,0.0164141414141,2,0.00126262626263,7,0.00441919191919,19,0.0119949494949,16,0.010101010101,28,11,11,28,39,2,0.00126262626263,28,0.0176767676768,43,0.0271464646465,1541,0.972853535354,1493,0.942550505051,LS15,Lincoln,37109LS15
Lincoln,1362,1135,0.833333333333,180,0.132158590308,9,0.00660792951542,8,0.00587371512482,3,0.00220264317181,27,0.0198237885463,184,31,31,184,215,4,0.00293685756241,184,0.135095447871,21,0.0154185022026,1341,0.984581497797,1122,0.823788546256,LW18,Lincoln,37109LW18
Lincoln,2823,2628,0.930924548353,112,0.0396741055615,19,0.00673042862203,23,0.00814736096351,28,0.00991852639036,13,0.00460503010981,116,26,25,115,141,4,0.00141693234148,116,0.0410910379029,62,0.021962451293,2761,0.978037548707,2596,0.919589089621,LW31,Lincoln,37109LW31
Lincoln,1471,1395,0.948334466349,26,0.0176750509857,10,0.00679809653297,4,0.00271923861319,25,0.0169952413324,11,0.00747790618627,29,15,15,29,44,3,0.00203942895989,29,0.0197144799456,41,0.0278721957852,1430,0.972127804215,1385,0.941536369816,NB03,Lincoln,37109NB03
Lincoln,3020,2854,0.945033112583,70,0.023178807947,11,0.00364238410596,1,0.000331125827815,67,0.0221854304636,17,0.00562913907285,72,20,20,72,92,2,0.000662251655629,72,0.0238410596026,105,0.0347682119205,2915,0.965231788079,2822,0.934437086093,NB09,Lincoln,37109NB09
Lincoln,2210,2098,0.949321266968,47,0.0212669683258,5,0.00226244343891,18,0.00814479638009,22,0.00995475113122,20,0.00904977375566,52,15,14,51,66,5,0.00226244343891,52,0.0235294117647,51,0.0230769230769,2159,0.976923076923,2070,0.93665158371,OB21,Lincoln,37109OB21
Lincoln,1895,1729,0.912401055409,63,0.0332453825858,2,0.00105540897098,8,0.00422163588391,82,0.04327176781,11,0.00580474934037,67,7,6,66,73,4,0.00211081794195,67,0.0353562005277,158,0.0833773087071,1737,0.916622691293,1661,0.876517150396,OG10,Lincoln,37109OG10
Lincoln,2582,2466,0.955073586367,48,0.0185902401239,7,0.00271107668474,8,0.00309837335399,35,0.0135553834237,18,0.00697134004648,56,15,13,54,69,8,0.00309837335399,56,0.0216886134779,92,0.0356312935709,2490,0.964368706429,2413,0.934546862897,PC22,Lincoln,37109PC22
Lincoln,2002,1789,0.893606393606,86,0.042957042957,5,0.0024975024975,12,0.00599400599401,77,0.0384615384615,33,0.0164835164835,88,15,14,87,102,2,0.000999000999001,88,0.043956043956,161,0.0804195804196,1841,0.91958041958,1717,0.857642357642,SL24,Lincoln,37109SL24
Lincoln,1764,1687,0.956349206349,29,0.0164399092971,5,0.00283446712018,15,0.00850340136054,23,0.0130385487528,5,0.00283446712018,31,5,5,31,36,2,0.00113378684807,31,0.0175736961451,69,0.0391156462585,1695,0.960884353741,1642,0.930839002268,TE27,Lincoln,37109TE27
Lincoln,1108,971,0.876353790614,94,0.0848375451264,12,0.0108303249097,1,0.000902527075812,16,0.014440433213,14,0.0126353790614,98,18,18,98,116,4,0.00361010830325,98,0.0884476534296,26,0.0234657039711,1082,0.976534296029,960,0.86642599278,TR30,Lincoln,37109TR30
Lincoln,3812,3622,0.950157397692,101,0.0264952780693,5,0.00131164742917,34,0.00891920251836,36,0.00944386149003,14,0.00367261280168,102,15,14,101,116,1,0.000262329485834,102,0.0267576075551,85,0.0222980062959,3727,0.977701993704,3573,0.937303252886,WP32,Lincoln,37109WP32
Macon,2614,2453,0.938408569243,64,0.0244835501148,11,0.00420811017598,20,0.00765110941086,44,0.0168324407039,22,0.00841622035195,69,19,17,67,86,5,0.00191277735272,69,0.0263963274675,160,0.0612088752869,2454,0.938791124713,2351,0.899387911247,01,Macon,3711301
Macon,1495,1317,0.880936454849,32,0.0214046822742,13,0.00869565217391,14,0.00936454849498,107,0.0715719063545,12,0.00802675585284,32,18,18,32,50,0,0.0,32,0.0214046822742,231,0.154515050167,1264,0.845484949833,1193,0.797993311037,02,Macon,3711302
Macon,2729,2558,0.937339684866,42,0.0153902528399,14,0.00513008427996,14,0.00513008427996,73,0.0267497251741,28,0.0102601685599,47,27,26,46,73,5,0.00183217295713,47,0.017222425797,193,0.0707218761451,2536,0.929278123855,2443,0.895199706852,03,Macon,3711303
Macon,1612,1568,0.97270471464,10,0.00620347394541,3,0.00186104218362,7,0.00434243176179,16,0.00992555831266,8,0.00496277915633,10,6,6,10,16,0,0.0,10,0.00620347394541,83,0.0514888337469,1529,0.948511166253,1506,0.934243176179,04,Macon,3711304
Macon,2991,2822,0.943497158141,13,0.00434637245069,18,0.00601805416249,21,0.00702106318957,87,0.0290872617854,30,0.0100300902708,14,29,29,14,43,1,0.00033433634236,14,0.00468070879305,204,0.0682046138415,2787,0.931795386158,2723,0.910397860247,05,Macon,3711305
Macon,2245,2174,0.968374164811,7,0.00311804008909,14,0.00623608017817,23,0.0102449888641,18,0.00801781737194,9,0.00400890868597,9,19,19,9,28,2,0.000890868596882,9,0.00400890868597,56,0.0249443207127,2189,0.975055679287,2137,0.951893095768,06,Macon,3711306
Macon,2208,2121,0.960597826087,7,0.00317028985507,6,0.00271739130435,27,0.0122282608696,37,0.0167572463768,10,0.00452898550725,9,13,12,8,21,2,0.000905797101449,9,0.00407608695652,84,0.0380434782609,2124,0.961956521739,2079,0.941576086957,07,Macon,3711307
Macon,451,435,0.964523281596,0,0.0,2,0.00443458980044,2,0.00443458980044,7,0.0155210643016,5,0.0110864745011,0,5,5,0,5,0,0.0,0,0.0,11,0.0243902439024,440,0.975609756098,431,0.955654101996,08,Macon,3711308
Macon,2296,2199,0.95775261324,10,0.00435540069686,3,0.00130662020906,6,0.00261324041812,55,0.0239547038328,23,0.0100174216028,14,18,18,14,32,4,0.00174216027875,14,0.00609756097561,90,0.0391986062718,2206,0.960801393728,2167,0.94381533101,09,Macon,3711309
Macon,380,357,0.939473684211,6,0.0157894736842,1,0.00263157894737,0,0.0,10,0.0263157894737,6,0.0157894736842,6,3,3,6,9,0,0.0,6,0.0157894736842,26,0.0684210526316,354,0.931578947368,342,0.9,10,Macon,3711310
Macon,3071,2928,0.953435363074,23,0.00748941712797,9,0.00293064148486,6,0.00195376098991,79,0.0257245197004,26,0.00846629762292,27,27,27,27,54,4,0.0013025073266,27,0.00879192445458,175,0.0569846955389,2896,0.943015304461,2838,0.924128948225,11,Macon,3711311
Macon,2007,1850,0.921773791729,119,0.0592924763328,6,0.00298953662182,8,0.0039860488291,9,0.00448430493274,15,0.00747384155456,123,12,12,123,135,4,0.00199302441455,123,0.0612855007474,27,0.0134529147982,1980,0.986547085202,1837,0.915296462382,12,Macon,3711312
Macon,667,656,0.983508245877,0,0.0,7,0.0104947526237,0,0.0,0,0.0,4,0.00599700149925,0,11,11,0,11,0,0.0,0,0.0,15,0.0224887556222,652,0.977511244378,646,0.968515742129,13,Macon,3711313
Macon,751,742,0.988015978695,0,0.0,5,0.00665778961385,1,0.00133155792277,0,0.0,3,0.00399467376831,0,7,7,0,7,0,0.0,0,0.0,6,0.00798934753662,745,0.992010652463,736,0.980026631158,14,Macon,3711314
Macon,1871,1824,0.974879743453,7,0.00374131480492,9,0.00481026189204,4,0.00213789417424,13,0.00694815606627,14,0.00748262960983,9,18,18,9,27,2,0.00106894708712,9,0.00481026189204,31,0.0165686798503,1840,0.98343132015,1807,0.965793693212,15,Macon,3711315
Madison,2500,2443,0.9772,8,0.0032,5,0.002,5,0.002,11,0.0044,28,0.0112,10,29,28,9,38,2,0.0008,10,0.004,56,0.0224,2444,0.9776,2401,0.9604,BEECH,Madison,37115BEECH
Madison,1002,983,0.981037924152,7,0.00698602794411,1,0.000998003992016,0,0.0,4,0.00399201596806,7,0.00698602794411,8,6,5,7,13,1,0.000998003992016,8,0.00798403193613,7,0.00698602794411,995,0.993013972056,980,0.978043912176,EBBS-C,Madison,37115EBBS-C
Madison,1148,1130,0.984320557491,4,0.00348432055749,0,0.0,3,0.00261324041812,0,0.0,11,0.0095818815331,7,7,4,4,11,3,0.00261324041812,7,0.00609756097561,18,0.0156794425087,1130,0.984320557491,1113,0.969512195122,GRAPEV,Madison,37115GRAPEV
Madison,952,937,0.984243697479,5,0.00525210084034,0,0.0,0,0.0,3,0.0031512605042,7,0.00735294117647,5,7,7,5,12,0,0.0,5,0.00525210084034,8,0.00840336134454,944,0.991596638655,932,0.978991596639,HOT-SP,Madison,37115HOT-SP
Madison,945,927,0.980952380952,1,0.0010582010582,6,0.00634920634921,0,0.0,2,0.0021164021164,9,0.00952380952381,2,12,12,2,14,1,0.0010582010582,2,0.0021164021164,12,0.0126984126984,933,0.987301587302,920,0.973544973545,LAUREL,Madison,37115LAUREL
Madison,3867,3591,0.928626842514,182,0.0470649081976,9,0.00232738557021,27,0.00698215671063,13,0.00336177915697,45,0.011636927851,197,31,28,194,225,15,0.00387897595035,197,0.0509438841479,71,0.018360486165,3796,0.981639513835,3537,0.914662529092,MARS-H,Madison,37115MARS-H
Madison,2466,2416,0.979724249797,3,0.00121654501217,4,0.00162206001622,6,0.00243309002433,17,0.00689375506894,20,0.0081103000811,5,19,17,3,22,2,0.00081103000811,5,0.00202757502028,63,0.0255474452555,2403,0.974452554745,2374,0.962692619627,NORTH,Madison,37115NORTH
Madison,263,252,0.958174904943,7,0.0266159695817,1,0.00380228136882,1,0.00380228136882,1,0.00380228136882,1,0.00380228136882,7,1,1,7,8,0,0.0,7,0.0266159695817,2,0.00760456273764,261,0.992395437262,251,0.954372623574,REVERE,Madison,37115REVERE
Madison,437,429,0.981693363844,1,0.00228832951945,0,0.0,1,0.00228832951945,1,0.00228832951945,5,0.0114416475973,1,3,3,1,4,0,0.0,1,0.00228832951945,1,0.00228832951945,436,0.997711670481,429,0.981693363844,SANDY,Madison,37115SANDY
Madison,982,947,0.964358452138,3,0.0030549898167,5,0.0050916496945,1,0.0010183299389,4,0.0040733197556,22,0.0224032586558,4,22,22,4,26,1,0.0010183299389,4,0.0040733197556,17,0.0173116089613,965,0.982688391039,938,0.955193482688,SOUTH,Madison,37115SOUTH
Madison,780,763,0.978205128205,2,0.0025641025641,2,0.0025641025641,2,0.0025641025641,2,0.0025641025641,9,0.0115384615385,2,5,5,2,7,0,0.0,2,0.0025641025641,8,0.0102564102564,772,0.989743589744,757,0.970512820513,SPRING,Madison,37115SPRING
Madison,1330,1300,0.977443609023,0,0.0,5,0.00375939849624,11,0.00827067669173,3,0.00225563909774,11,0.00827067669173,2,13,12,1,14,2,0.0015037593985,2,0.0015037593985,8,0.00601503759398,1322,0.993984962406,1294,0.972932330827,WALNUT,Madison,37115WALNUT
Martin,1622,1384,0.8532675709,216,0.13316892725,3,0.00184956843403,0,0.0,14,0.00863131935882,5,0.00308261405672,217,6,6,217,223,1,0.000616522811344,217,0.133785450062,25,0.0154130702836,1597,0.984586929716,1373,0.846485819975,BG,Martin,37117BG
Martin,1158,741,0.639896373057,365,0.315198618307,2,0.00172711571675,4,0.00345423143351,42,0.0362694300518,4,0.00345423143351,367,3,3,367,370,2,0.00172711571675,367,0.316925734024,48,0.0414507772021,1110,0.958549222798,734,0.633851468048,CR,Martin,37117CR
Martin,905,334,0.369060773481,543,0.6,3,0.00331491712707,0,0.0,22,0.0243093922652,3,0.00331491712707,544,5,5,544,549,1,0.00110497237569,544,0.601104972376,42,0.046408839779,863,0.953591160221,320,0.353591160221,GN,Martin,37117GN
Martin,1004,805,0.801792828685,178,0.177290836653,2,0.00199203187251,1,0.000996015936255,12,0.0119521912351,6,0.00597609561753,178,5,5,178,183,0,0.0,178,0.177290836653,19,0.0189243027888,985,0.981075697211,804,0.800796812749,GR,Martin,37117GR
Martin,929,386,0.415500538213,527,0.56727664155,3,0.0032292787944,3,0.0032292787944,3,0.0032292787944,7,0.00753498385361,531,6,3,528,534,4,0.0043057050592,531,0.571582346609,11,0.0118406889128,918,0.988159311087,382,0.411194833154,HM,Martin,37117HM
Martin,312,124,0.397435897436,188,0.602564102564,0,0.0,0,0.0,0,0.0,0,0.0,188,0,0,188,188,0,0.0,188,0.602564102564,0,0.0,312,1.0,124,0.397435897436,HS,Martin,37117HS
Martin,2075,1474,0.710361445783,549,0.264578313253,8,0.00385542168675,1,0.000481927710843,22,0.0106024096386,21,0.0101204819277,568,24,10,554,578,19,0.00915662650602,568,0.273734939759,39,0.0187951807229,2036,0.981204819277,1458,0.70265060241,J,Martin,37117J
Martin,387,259,0.669250645995,111,0.286821705426,3,0.0077519379845,1,0.00258397932817,10,0.0258397932817,3,0.0077519379845,111,4,4,111,115,0,0.0,111,0.286821705426,11,0.0284237726098,376,0.97157622739,259,0.669250645995,PP,Martin,37117PP
Martin,1196,434,0.362876254181,706,0.590301003344,4,0.00334448160535,6,0.00501672240803,42,0.0351170568562,4,0.00334448160535,709,5,5,709,714,3,0.00250836120401,709,0.592809364548,57,0.0476588628763,1139,0.952341137124,423,0.353678929766,R1,Martin,37117R1
Martin,1536,525,0.341796875,973,0.633463541667,3,0.001953125,3,0.001953125,20,0.0130208333333,12,0.0078125,979,13,7,973,986,6,0.00390625,979,0.637369791667,36,0.0234375,1500,0.9765625,512,0.333333333333,R2,Martin,37117R2
Martin,994,705,0.709255533199,258,0.259557344064,15,0.0150905432596,1,0.0010060362173,10,0.010060362173,5,0.00503018108652,259,16,16,259,275,1,0.0010060362173,259,0.260563380282,13,0.0130784708249,981,0.986921529175,703,0.707243460765,W,Martin,37117W
Martin,3593,1755,0.488449763429,1706,0.474812134706,5,0.0013915947676,23,0.00640133593098,73,0.020317283607,31,0.00862788755914,1725,17,8,1716,1733,19,0.00528806011689,1725,0.480100194823,128,0.0356248260507,3465,0.964375173949,1719,0.478430281102,W1,Martin,37117W1
Martin,3359,1603,0.477225364692,1692,0.503721345639,9,0.00267936885978,14,0.00416790711521,19,0.00565644537065,22,0.00654956832391,1704,21,15,1698,1719,12,0.00357249181304,1704,0.507293837452,41,0.0122060136946,3318,0.987793986305,1588,0.472759749926,W2,Martin,37117W2
McDowell,1930,1878,0.973056994819,17,0.00880829015544,12,0.00621761658031,3,0.00155440414508,6,0.00310880829016,14,0.00725388601036,19,21,19,17,38,2,0.00103626943005,19,0.00984455958549,13,0.00673575129534,1917,0.993264248705,1872,0.969948186528,CCREEK,McDowell,37111CCREEK
McDowell,2638,2444,0.926459438969,41,0.0155420773313,12,0.00454890068234,80,0.0303260045489,53,0.0200909780136,8,0.00303260045489,42,19,18,41,60,1,0.000379075056861,42,0.0159211523882,79,0.029946929492,2559,0.970053070508,2419,0.916982562547,DYSART,McDowell,37111DYSART
McDowell,1524,1419,0.931102362205,78,0.0511811023622,2,0.00131233595801,4,0.00262467191601,15,0.00984251968504,6,0.00393700787402,79,6,6,79,85,1,0.000656167979003,79,0.0518372703412,34,0.0223097112861,1490,0.977690288714,1401,0.919291338583,FORT-1,McDowell,37111FORT-1
McDowell,2057,1908,0.927564414195,99,0.048128342246,2,0.000972289742343,7,0.0034030140982,16,0.00777831793875,25,0.0121536217793,108,16,12,104,120,9,0.00437530384054,108,0.0525036460865,33,0.0160427807487,2024,0.983957219251,1892,0.919786096257,FORT-2,McDowell,37111FORT-2
McDowell,1957,1921,0.981604496679,7,0.00357690342361,5,0.00255493101686,10,0.00510986203373,6,0.00306591722024,8,0.00408788962698,7,11,11,7,18,0,0.0,7,0.00357690342361,30,0.0153295861012,1927,0.984670413899,1899,0.970362800204,GLENWD,McDowell,37111GLENWD
McDowell,2640,2173,0.823106060606,349,0.132196969697,14,0.00530303030303,18,0.00681818181818,79,0.0299242424242,7,0.00265151515152,349,16,16,349,365,0,0.0,349,0.132196969697,104,0.0393939393939,2536,0.960606060606,2151,0.814772727273,HIGGIN,McDowell,37111HIGGIN
McDowell,1894,1841,0.972016895459,12,0.00633579725449,9,0.00475184794087,1,0.000527983104541,21,0.0110876451954,10,0.00527983104541,13,15,15,13,28,1,0.000527983104541,13,0.00686378035903,37,0.019535374868,1857,0.980464625132,1829,0.965681098205,M.COVE,McDowell,37111M.COVE
McDowell,3357,3085,0.918975275544,97,0.0288948465892,15,0.00446827524576,24,0.00714924039321,109,0.0324694667858,27,0.00804289544236,101,31,31,101,132,4,0.00119154006553,101,0.0300863866548,178,0.0530235329163,3179,0.946976467084,3033,0.903485254692,MAR-1,McDowell,37111MAR-1
McDowell,1826,1385,0.758488499452,312,0.170865279299,7,0.00383351588171,16,0.00876232201533,85,0.0465498357065,21,0.0115005476451,322,21,14,315,336,10,0.00547645125958,322,0.176341730559,108,0.0591456736035,1718,0.940854326396,1364,0.746987951807,MAR-2,McDowell,37111MAR-2
McDowell,1211,1092,0.901734104046,27,0.0222956234517,7,0.00578034682081,4,0.00330305532618,71,0.0586292320396,10,0.00825763831544,27,17,17,27,44,0,0.0,27,0.0222956234517,96,0.0792733278282,1115,0.920726672172,1073,0.886044591247,MAR-3,McDowell,37111MAR-3
McDowell,1655,1431,0.864652567976,27,0.0163141993958,13,0.00785498489426,5,0.00302114803625,160,0.0966767371601,19,0.0114803625378,32,23,22,31,54,5,0.00302114803625,32,0.019335347432,218,0.131722054381,1437,0.868277945619,1381,0.834441087613,MAR-4,McDowell,37111MAR-4
McDowell,1445,1336,0.924567474048,20,0.0138408304498,3,0.00207612456747,6,0.00415224913495,59,0.040830449827,21,0.0145328719723,21,16,16,21,37,1,0.000692041522491,21,0.0145328719723,110,0.076124567474,1335,0.923875432526,1287,0.890657439446,MAR-5,McDowell,37111MAR-5
McDowell,859,840,0.977881257276,2,0.0023282887078,0,0.0,6,0.0069848661234,0,0.0,11,0.0128055878929,3,10,10,3,13,1,0.0011641443539,3,0.0034924330617,3,0.0034924330617,856,0.996507566938,837,0.974388824214,N.COVE,McDowell,37111N.COVE
McDowell,2727,2571,0.942794279428,101,0.037037037037,7,0.002566923359,16,0.00586725339201,17,0.00623395672901,15,0.00550055005501,104,13,13,104,117,3,0.001100110011,104,0.038137147048,47,0.017235056839,2680,0.982764943161,2545,0.933259992666,NEBO,McDowell,37111NEBO
McDowell,2295,2188,0.953376906318,22,0.00958605664488,7,0.00305010893246,15,0.00653594771242,51,0.0222222222222,12,0.00522875816993,26,14,14,26,40,4,0.00174291938998,26,0.0113289760349,81,0.0352941176471,2214,0.964705882353,2161,0.941612200436,PLEASA,McDowell,37111PLEASA
McDowell,958,925,0.965553235908,2,0.00208768267223,6,0.0062630480167,3,0.00313152400835,19,0.0198329853862,3,0.00313152400835,3,8,8,3,11,1,0.00104384133612,3,0.00313152400835,25,0.0260960334029,933,0.973903966597,919,0.959290187891,T.COVE,McDowell,37111T.COVE
McDowell,4238,3899,0.920009438414,181,0.0427088249174,15,0.0035394053799,24,0.00566304860783,80,0.0188768286928,39,0.00920245398773,191,40,37,188,228,10,0.0023596035866,191,0.045068428504,157,0.0370457763096,4081,0.96295422369,3847,0.907739499764,WEST-M,McDowell,37111WEST-M
Mecklenburg,1557,1449,0.93063583815,74,0.0475272960822,1,0.000642260757868,16,0.0102761721259,6,0.00385356454721,11,0.00706486833654,80,6,4,78,84,6,0.00385356454721,80,0.0513808606294,28,0.0179833012203,1529,0.98201669878,1427,0.916506101477,001,Mecklenburg,37119001
Mecklenburg,2646,2072,0.783068783069,451,0.17044595616,8,0.00302343159486,56,0.021164021164,29,0.0109599395314,30,0.0113378684807,460,13,12,459,472,9,0.00340136054422,460,0.173847316704,63,0.0238095238095,2583,0.97619047619,2044,0.772486772487,002,Mecklenburg,37119002
Mecklenburg,3310,557,0.168277945619,1942,0.58670694864,24,0.00725075528701,128,0.038670694864,553,0.167069486405,106,0.0320241691843,2003,65,37,1975,2040,61,0.0184290030211,2003,0.605135951662,857,0.258912386707,2453,0.741087613293,345,0.104229607251,003,Mecklenburg,37119003
Mecklenburg,2793,1118,0.400286430362,1199,0.429287504475,6,0.00214822771214,98,0.0350877192982,310,0.110991765127,62,0.0221983530254,1223,28,13,1208,1236,24,0.00859291084855,1223,0.437880415324,520,0.186179735052,2273,0.813820264948,948,0.339419978518,004,Mecklenburg,37119004
Mecklenburg,2743,919,0.335034633613,1011,0.368574553409,10,0.00364564345607,80,0.0291651476486,653,0.238060517681,70,0.0255195041925,1050,34,16,1032,1066,39,0.0142180094787,1050,0.382792562887,979,0.356908494349,1764,0.643091505651,652,0.237695953336,005,Mecklenburg,37119005
Mecklenburg,3676,1164,0.316648531012,1863,0.506800870511,43,0.0116974972797,52,0.0141458106638,460,0.12513601741,94,0.025571273123,1908,72,56,1892,1964,45,0.0122415669206,1908,0.519042437432,772,0.210010881393,2904,0.789989118607,947,0.257616974973,006,Mecklenburg,37119006
Mecklenburg,2177,1440,0.661460725769,561,0.257694074414,6,0.00275608635737,36,0.0165365181442,92,0.042259990813,42,0.0192926045016,581,22,14,573,595,20,0.00918695452458,581,0.266881028939,201,0.092328892972,1976,0.907671107028,1353,0.621497473588,007,Mecklenburg,37119007
Mecklenburg,2468,2280,0.923824959481,119,0.0482171799028,1,0.000405186385737,34,0.0137763371151,10,0.00405186385737,24,0.0097244732577,135,9,4,130,139,16,0.0064829821718,135,0.0547001620746,50,0.0202593192869,2418,0.979740680713,2244,0.909238249595,008,Mecklenburg,37119008
Mecklenburg,2868,2237,0.779986052999,523,0.182357043236,2,0.000697350069735,65,0.0226638772664,15,0.00523012552301,26,0.00906555090656,534,11,9,532,543,11,0.00383542538354,534,0.186192468619,42,0.0146443514644,2826,0.985355648536,2206,0.769177126918,009,Mecklenburg,37119009
Mecklenburg,2193,2049,0.934336525308,57,0.0259917920657,14,0.00638394892841,44,0.0200638394893,6,0.00273597811218,23,0.0104879160967,62,21,20,61,82,5,0.00227998176015,62,0.0282717738258,44,0.0200638394893,2149,0.979936160511,2011,0.917008663931,010,Mecklenburg,37119010
Mecklenburg,7647,5156,0.674251340395,1993,0.260625081731,21,0.00274617497058,268,0.035046423434,64,0.00836929514842,145,0.0189616843206,2053,61,50,2042,2103,60,0.00784621420165,2053,0.268471295933,250,0.0326925591735,7397,0.967307440826,5011,0.655289656074,011,Mecklenburg,37119011
Mecklenburg,2930,251,0.0856655290102,2476,0.845051194539,10,0.00341296928328,42,0.0143344709898,48,0.0163822525597,103,0.0351535836177,2533,84,55,2504,2588,57,0.0194539249147,2533,0.864505119454,174,0.059385665529,2756,0.940614334471,208,0.0709897610922,012,Mecklenburg,37119012
Mecklenburg,5749,2435,0.423551922073,2974,0.517307357801,9,0.00156548965037,225,0.0391372412593,44,0.00765350495738,62,0.0107844842581,3015,24,17,3008,3032,41,0.00713167507393,3015,0.524439032875,264,0.0459210297443,5485,0.954078970256,2254,0.392068185771,013,Mecklenburg,37119013
Mecklenburg,2360,419,0.177542372881,1772,0.750847457627,8,0.00338983050847,77,0.0326271186441,35,0.0148305084746,49,0.0207627118644,1812,21,10,1801,1822,40,0.0169491525424,1812,0.767796610169,67,0.0283898305085,2293,0.971610169492,403,0.170762711864,014,Mecklenburg,37119014
Mecklenburg,2548,2228,0.874411302983,208,0.0816326530612,8,0.00313971742543,34,0.0133437990581,24,0.0094191522763,46,0.0180533751962,228,30,22,220,250,20,0.00784929356358,228,0.0894819466248,66,0.0259026687598,2482,0.97409733124,2190,0.859497645212,015,Mecklenburg,37119015
Mecklenburg,2965,51,0.0172006745363,2804,0.945699831366,5,0.00168634064081,13,0.0043844856661,40,0.0134907251265,52,0.0175379426644,2847,33,8,2822,2855,43,0.014502529511,2847,0.960202360877,107,0.0360876897133,2858,0.963912310287,21,0.0070826306914,016,Mecklenburg,37119016
Mecklenburg,2236,548,0.245080500894,1487,0.665026833631,13,0.00581395348837,33,0.0147584973166,111,0.0496422182469,44,0.0196779964222,1520,28,15,1507,1535,33,0.0147584973166,1520,0.679785330948,221,0.0988372093023,2015,0.901162790698,474,0.21198568873,017,Mecklenburg,37119017
Mecklenburg,1411,1400,0.99220411056,3,0.00212615166549,0,0.0,4,0.00283486888731,2,0.00141743444366,2,0.00141743444366,3,0,0,3,3,0,0.0,3,0.00212615166549,14,0.0099220411056,1397,0.990077958894,1386,0.982282069454,018,Mecklenburg,37119018
Mecklenburg,1771,1680,0.948616600791,36,0.0203274985884,2,0.00112930547713,26,0.0146809712027,8,0.00451722190853,19,0.0107284020327,43,6,5,42,48,7,0.00395256916996,43,0.0242800677583,25,0.0141163184641,1746,0.985883681536,1664,0.939582156973,019,Mecklenburg,37119019
Mecklenburg,2093,1962,0.937410415671,47,0.0224558050645,1,0.000477783086479,53,0.0253225035834,6,0.00286669851887,24,0.0114667940755,54,8,7,53,61,7,0.00334448160535,54,0.0258002866699,25,0.011944577162,2068,0.988055422838,1940,0.926899187769,020,Mecklenburg,37119020
Mecklenburg,2386,1881,0.788348700754,325,0.136211232188,11,0.0046102263202,63,0.0264040234702,70,0.0293378038558,36,0.0150880134116,347,18,14,343,361,22,0.0092204526404,347,0.145431684828,139,0.058256496228,2247,0.941743503772,1815,0.760687342833,021,Mecklenburg,37119021
Mecklenburg,4043,1726,0.426910709869,2102,0.51991095721,20,0.00494682166708,99,0.024486767252,45,0.0111303487509,51,0.0126143952511,2133,45,25,2113,2158,31,0.00766757358397,2133,0.527578530794,142,0.0351224338363,3901,0.964877566164,1656,0.409596834034,022,Mecklenburg,37119022
Mecklenburg,1799,348,0.193440800445,1367,0.759866592551,18,0.0100055586437,12,0.00667037242913,24,0.0133407448583,30,0.0166759310728,1389,26,20,1383,1409,22,0.0122290161201,1389,0.772095608671,54,0.0300166759311,1745,0.969983324069,323,0.179544191217,023,Mecklenburg,37119023
Mecklenburg,2602,604,0.232129131437,1878,0.721752498078,15,0.00576479631053,40,0.0153727901614,17,0.0065334358186,48,0.0184473481937,1901,40,31,1892,1932,23,0.00883935434281,1901,0.730591852421,72,0.0276710222905,2530,0.972328977709,581,0.223289777095,024,Mecklenburg,37119024
Mecklenburg,2241,41,0.0182954038376,2140,0.954930834449,5,0.00223114680946,16,0.00713966979027,17,0.00758589915216,22,0.00981704596162,2158,18,7,2147,2165,18,0.00803212851406,2158,0.962962962963,31,0.0138331102187,2210,0.986166889781,34,0.0151717983043,025,Mecklenburg,37119025
Mecklenburg,3693,711,0.1925264013,2602,0.704576225291,29,0.00785269428649,110,0.0297860817763,192,0.0519902518278,49,0.0132683455185,2634,48,34,2620,2668,32,0.0086650419713,2634,0.713241267262,320,0.086650419713,3373,0.913349580287,621,0.168155970755,026,Mecklenburg,37119026
Mecklenburg,3721,528,0.141897339425,2528,0.679387261489,28,0.0075248589089,61,0.016393442623,504,0.13544746036,72,0.0193496371943,2562,56,39,2545,2601,34,0.00913732867509,2562,0.688524590164,707,0.19000268745,3014,0.80999731255,381,0.102391830153,027,Mecklenburg,37119027
Mecklenburg,2770,862,0.31119133574,1579,0.570036101083,12,0.0043321299639,108,0.0389891696751,150,0.0541516245487,59,0.0212996389892,1614,38,23,1599,1637,35,0.0126353790614,1614,0.582671480144,240,0.086642599278,2530,0.913357400722,799,0.28844765343,028,Mecklenburg,37119028
Mecklenburg,3152,1542,0.48921319797,667,0.211611675127,36,0.011421319797,266,0.0843908629442,569,0.180520304569,72,0.0228426395939,693,51,45,687,738,26,0.00824873096447,693,0.219860406091,850,0.269670050761,2302,0.730329949239,1312,0.416243654822,029,Mecklenburg,37119029
Mecklenburg,2461,1729,0.702559934986,559,0.227143437627,10,0.00406338886631,82,0.0333197887038,39,0.0158472165786,42,0.0170662332385,580,24,18,574,598,21,0.00853311661926,580,0.235676554246,109,0.0442909386428,2352,0.955709061357,1676,0.681023973994,030,Mecklenburg,37119030
Mecklenburg,2659,104,0.0391124482888,2451,0.921775103422,22,0.00827378713802,14,0.00526513726965,14,0.00526513726965,54,0.0203083866115,2502,42,22,2482,2524,51,0.0191801429109,2502,0.940955246333,59,0.0221887927792,2600,0.977811207221,86,0.032342986085,031,Mecklenburg,37119031
Mecklenburg,1690,1643,0.972189349112,8,0.00473372781065,3,0.00177514792899,28,0.0165680473373,2,0.00118343195266,6,0.00355029585799,11,3,3,11,14,3,0.00177514792899,11,0.00650887573964,28,0.0165680473373,1662,0.983431952663,1618,0.957396449704,032,Mecklenburg,37119032
Mecklenburg,3136,1481,0.472257653061,828,0.264030612245,38,0.0121173469388,84,0.0267857142857,628,0.200255102041,77,0.0245535714286,852,55,49,846,901,24,0.00765306122449,852,0.271683673469,1005,0.320471938776,2131,0.679528061224,1181,0.376594387755,033,Mecklenburg,37119033
Mecklenburg,3257,1894,0.58151673319,831,0.25514276942,15,0.00460546515198,174,0.053423395763,270,0.0828983727356,73,0.0224132637396,861,40,34,855,895,30,0.00921093030396,861,0.264353699724,452,0.13877801658,2805,0.86122198342,1744,0.53546208167,034,Mecklenburg,37119034
Mecklenburg,1635,1353,0.82752293578,198,0.121100917431,1,0.000611620795107,39,0.0238532110092,17,0.0103975535168,27,0.0165137614679,212,9,7,210,219,14,0.0085626911315,212,0.129663608563,59,0.0360856269113,1576,0.963914373089,1321,0.807951070336,035,Mecklenburg,37119035
Mecklenburg,2492,2214,0.888443017657,111,0.0445425361156,3,0.00120385232745,131,0.0525682182986,12,0.00481540930979,21,0.00842696629213,125,6,4,123,129,14,0.00561797752809,125,0.0501605136437,53,0.0212680577849,2439,0.978731942215,2174,0.872391653291,036,Mecklenburg,37119036
Mecklenburg,2262,1934,0.854995579134,93,0.0411140583554,7,0.00309460654288,59,0.02608311229,147,0.0649867374005,22,0.00972590627763,99,17,14,96,113,6,0.0026525198939,99,0.0437665782493,268,0.118479221927,1994,0.881520778073,1821,0.805039787798,037,Mecklenburg,37119037
Mecklenburg,3031,1930,0.636753546684,612,0.201913559881,26,0.00857802705378,75,0.024744308809,330,0.108874958759,58,0.0191355988123,634,48,38,624,672,22,0.00725833058397,634,0.209171890465,639,0.210821511052,2392,0.789178488948,1672,0.551633124381,038,Mecklenburg,37119038
Mecklenburg,3121,266,0.0852290932393,2611,0.83659083627,10,0.0032041012496,110,0.0352451137456,89,0.0285165011214,35,0.0112143543736,2642,26,12,2628,2654,31,0.00993271387376,2642,0.846523550144,157,0.0503043896187,2964,0.949695610381,232,0.0743351489907,039,Mecklenburg,37119039
Mecklenburg,3045,608,0.199671592775,2003,0.657799671593,25,0.00821018062397,225,0.0738916256158,126,0.0413793103448,58,0.0190476190476,2040,53,34,2021,2074,37,0.0121510673235,2040,0.669950738916,182,0.0597701149425,2863,0.940229885057,591,0.194088669951,040,Mecklenburg,37119040
Mecklenburg,3188,570,0.178795483061,2266,0.710790464241,30,0.00941028858218,169,0.0530112923463,109,0.0341907151819,44,0.0138017565872,2287,47,40,2280,2327,21,0.00658720200753,2287,0.717377666248,197,0.0617942283563,2991,0.938205771644,506,0.158720200753,041,Mecklenburg,37119041
Mecklenburg,3650,303,0.0830136986301,2736,0.749589041096,13,0.00356164383562,52,0.0142465753425,496,0.135890410959,50,0.013698630137,2774,29,13,2758,2787,38,0.0104109589041,2774,0.76,661,0.181095890411,2989,0.818904109589,182,0.0498630136986,042,Mecklenburg,37119042
Mecklenburg,4182,975,0.233142037303,2199,0.525824964132,40,0.00956480153037,131,0.031324725012,687,0.164275466284,150,0.0358680057389,2263,90,60,2233,2323,64,0.0153036824486,2263,0.541128646581,1134,0.271162123386,3048,0.728837876614,698,0.166905786705,043,Mecklenburg,37119043
Mecklenburg,1732,1334,0.770207852194,269,0.155311778291,12,0.00692840646651,48,0.0277136258661,50,0.0288683602771,19,0.0109699769053,282,22,16,276,298,13,0.00750577367206,282,0.162817551963,114,0.0658198614319,1618,0.934180138568,1279,0.738452655889,044,Mecklenburg,37119044
Mecklenburg,3104,1218,0.392396907216,717,0.230992268041,19,0.00612113402062,278,0.0895618556701,803,0.258698453608,69,0.0222293814433,737,42,29,724,766,20,0.00644329896907,737,0.23743556701,1079,0.347615979381,2025,0.652384020619,1010,0.325386597938,045,Mecklenburg,37119045
Mecklenburg,3584,1521,0.424386160714,1232,0.34375,26,0.00725446428571,302,0.0842633928571,397,0.110770089286,106,0.0295758928571,1278,44,35,1269,1313,46,0.0128348214286,1278,0.356584821429,622,0.173549107143,2962,0.826450892857,1344,0.375,046,Mecklenburg,37119046
Mecklenburg,2521,2262,0.897262990877,170,0.0674335581119,5,0.00198333994447,45,0.0178500595002,22,0.00872669575565,17,0.00674335581119,177,6,6,177,183,7,0.00277667592225,177,0.0702102340341,55,0.0218167393891,2466,0.978183260611,2236,0.886949623165,047,Mecklenburg,37119047
Mecklenburg,1610,1542,0.957763975155,22,0.0136645962733,2,0.00124223602484,28,0.0173913043478,6,0.00372670807453,10,0.00621118012422,28,4,3,27,31,6,0.00372670807453,28,0.0173913043478,24,0.0149068322981,1586,0.985093167702,1524,0.946583850932,048,Mecklenburg,37119048
Mecklenburg,2098,1866,0.889418493804,108,0.0514775977121,3,0.00142993326978,32,0.0152526215443,67,0.0319351763584,22,0.0104861773117,111,9,8,110,119,3,0.00142993326978,111,0.0529075309819,150,0.071496663489,1948,0.928503336511,1794,0.855100095329,049,Mecklenburg,37119049
Mecklenburg,2465,1615,0.655172413793,328,0.133062880325,4,0.00162271805274,69,0.0279918864097,413,0.167545638945,36,0.0146044624746,341,19,16,338,357,13,0.0052738336714,341,0.138336713996,548,0.222312373225,1917,0.777687626775,1499,0.608113590264,050,Mecklenburg,37119050
Mecklenburg,3058,2358,0.771092217135,308,0.10071942446,14,0.00457815565729,71,0.0232177894048,268,0.0876389797253,39,0.0127534336167,324,19,15,320,339,16,0.00523217789405,324,0.105951602354,453,0.148136036625,2605,0.851863963375,2200,0.719424460432,051,Mecklenburg,37119051
Mecklenburg,2649,177,0.0668176670442,2331,0.879954699887,13,0.00490751226878,5,0.00188750471876,86,0.0324650811627,37,0.0139675349188,2356,31,16,2341,2372,25,0.00943752359381,2356,0.889392223481,158,0.0596451491129,2491,0.940354850887,127,0.0479426198565,052,Mecklenburg,37119052
Mecklenburg,4119,835,0.202719106579,2636,0.63996115562,15,0.00364166059723,148,0.035931051226,391,0.0949259529012,94,0.022821073076,2681,40,26,2667,2707,45,0.0109249817917,2681,0.650886137412,669,0.162418062637,3450,0.837581937363,634,0.153920854576,053,Mecklenburg,37119053
Mecklenburg,2462,116,0.0471161657189,2281,0.926482534525,16,0.00649878147847,9,0.00365556458164,12,0.00487408610885,28,0.0113728675873,2306,24,16,2298,2322,25,0.0101543460601,2306,0.936636880585,31,0.0125913891145,2431,0.987408610885,109,0.0442729488221,054,Mecklenburg,37119054
Mecklenburg,1741,61,0.035037334865,1580,0.907524411258,4,0.00229753015508,16,0.00919012062033,53,0.0304422745549,27,0.0155083285468,1591,11,6,1586,1597,11,0.00631820792648,1591,0.913842619184,121,0.0695002871913,1620,0.930499712809,28,0.0160827110856,055,Mecklenburg,37119055
Mecklenburg,1752,95,0.0542237442922,1547,0.88299086758,3,0.00171232876712,46,0.0262557077626,46,0.0262557077626,15,0.00856164383562,1559,10,4,1553,1563,12,0.00684931506849,1559,0.889840182648,89,0.050799086758,1663,0.949200913242,68,0.0388127853881,056,Mecklenburg,37119056
Mecklenburg,2775,2457,0.885405405405,205,0.0738738738739,12,0.00432432432432,67,0.0241441441441,11,0.00396396396396,23,0.00828828828829,213,20,16,209,229,8,0.00288288288288,213,0.0767567567568,65,0.0234234234234,2710,0.976576576577,2409,0.868108108108,057,Mecklenburg,37119057
Mecklenburg,1760,1312,0.745454545455,203,0.115340909091,6,0.00340909090909,101,0.0573863636364,118,0.0670454545455,20,0.0113636363636,207,12,11,206,218,4,0.00227272727273,207,0.117613636364,224,0.127272727273,1536,0.872727272727,1204,0.684090909091,058,Mecklenburg,37119058
Mecklenburg,1739,1185,0.681426106958,184,0.105807935595,10,0.00575043128235,66,0.0379528464635,270,0.155261644623,24,0.0138010350776,191,17,17,191,208,7,0.00402530189764,191,0.109833237493,390,0.224266820012,1349,0.775733179988,1089,0.626221966647,059,Mecklenburg,37119059
Mecklenburg,2186,234,0.107044830741,1802,0.824336688015,7,0.0032021957914,36,0.0164684354986,82,0.0375114364135,25,0.0114364135407,1818,15,7,1810,1825,16,0.00731930466606,1818,0.831655992681,145,0.0663311985361,2041,0.933668801464,187,0.0855443732845,060,Mecklenburg,37119060
Mecklenburg,3339,1809,0.541778975741,1061,0.317759808326,12,0.00359389038634,154,0.0461215932914,237,0.0709793351303,66,0.0197663971249,1083,23,20,1080,1103,22,0.00658879904163,1083,0.324348607367,423,0.126684636119,2916,0.873315363881,1670,0.500149745433,061,Mecklenburg,37119061
Mecklenburg,3476,937,0.269562715765,1386,0.398734177215,19,0.00546605293441,176,0.0506329113924,868,0.249712313003,90,0.0258918296893,1427,35,25,1417,1452,41,0.0117951668585,1427,0.410529344074,1301,0.374280782509,2175,0.625719217491,598,0.172036823936,062,Mecklenburg,37119062
Mecklenburg,2887,1091,0.377900935227,1102,0.381711118808,34,0.0117769310703,170,0.0588846553516,419,0.145133356425,71,0.0245930031174,1126,51,41,1116,1167,24,0.00831312781434,1126,0.390024246623,862,0.298579840665,2025,0.701420159335,722,0.250086595081,063,Mecklenburg,37119063
Mecklenburg,1446,869,0.600968188105,376,0.260027662517,12,0.00829875518672,57,0.0394190871369,89,0.0615491009682,43,0.0297372060858,385,13,13,385,398,9,0.00622406639004,385,0.266251728907,267,0.184647302905,1179,0.815352697095,731,0.505532503458,064,Mecklenburg,37119064
Mecklenburg,1379,1168,0.846990572879,103,0.0746918056563,3,0.00217548948513,63,0.0456852791878,26,0.0188542422045,16,0.0116026105874,107,7,7,107,114,4,0.00290065264685,107,0.0775924583031,56,0.0406091370558,1323,0.959390862944,1136,0.823785351704,065,Mecklenburg,37119065
Mecklenburg,1513,1309,0.865168539326,124,0.0819563780568,6,0.0039656311963,40,0.0264375413087,10,0.00660938532716,24,0.0158625247852,131,14,10,127,141,7,0.00462656972902,131,0.0865829477859,50,0.0330469266358,1463,0.966953073364,1280,0.846001321877,066,Mecklenburg,37119066
Mecklenburg,1451,1376,0.948311509304,42,0.0289455547898,3,0.00206753962784,9,0.00620261888353,10,0.00689179875948,11,0.00758097863542,47,8,7,46,54,5,0.00344589937974,47,0.0323914541695,30,0.0206753962784,1421,0.979324603722,1355,0.933838731909,067,Mecklenburg,37119067
Mecklenburg,2251,1194,0.530430919591,784,0.348289649045,4,0.00177698800533,55,0.0244335850733,137,0.0608618391826,77,0.0342070191026,824,37,13,800,837,40,0.0177698800533,824,0.366059529098,248,0.110173256331,2003,0.889826743669,1114,0.494891159485,068,Mecklenburg,37119068
Mecklenburg,3768,3350,0.88906581741,157,0.0416666666667,8,0.00212314225053,174,0.046178343949,44,0.0116772823779,35,0.00928874734607,169,18,13,164,182,12,0.0031847133758,169,0.0448513800425,123,0.0326433121019,3645,0.967356687898,3268,0.867303609342,069,Mecklenburg,37119069
Mecklenburg,1899,1807,0.951553449184,24,0.0126382306477,4,0.00210637177462,45,0.0236966824645,4,0.00210637177462,15,0.00789889415482,27,11,10,26,37,3,0.00157977883096,27,0.0142180094787,33,0.0173775671406,1866,0.982622432859,1778,0.936282253818,070,Mecklenburg,37119070
Mecklenburg,2135,1634,0.765339578454,212,0.0992974238876,5,0.00234192037471,217,0.101639344262,42,0.0196721311475,25,0.0117096018735,223,15,13,221,236,11,0.00515222482436,223,0.104449648712,125,0.0585480093677,2010,0.941451990632,1566,0.733489461358,071,Mecklenburg,37119071
Mecklenburg,1517,1372,0.904416611734,57,0.0375741595254,5,0.00329597890574,31,0.0204350692156,30,0.0197758734344,22,0.0145023071852,63,11,11,63,74,6,0.00395517468688,63,0.0415293342123,91,0.0599868160844,1426,0.940013183916,1320,0.870138431114,072,Mecklenburg,37119072
Mecklenburg,1820,1590,0.873626373626,131,0.071978021978,4,0.0021978021978,54,0.0296703296703,17,0.00934065934066,24,0.0131868131868,137,14,13,136,150,6,0.0032967032967,137,0.0752747252747,63,0.0346153846154,1757,0.965384615385,1549,0.851098901099,073,Mecklenburg,37119073
Mecklenburg,2623,2327,0.887152115898,121,0.0461303850553,8,0.00304994281357,105,0.0400304994281,25,0.00953107129241,37,0.0141059855128,133,12,11,132,144,12,0.00457491422036,133,0.0507052992756,92,0.0350743423561,2531,0.964925657644,2273,0.866565001906,074,Mecklenburg,37119074
Mecklenburg,3102,2848,0.918117343649,114,0.036750483559,3,0.000967117988395,74,0.0238555770471,32,0.0103159252095,31,0.00999355254674,122,14,8,116,130,8,0.00257898130239,122,0.0393294648614,95,0.0306254029658,3007,0.969374597034,2788,0.898774983881,075,Mecklenburg,37119075
Mecklenburg,2880,2652,0.920833333333,100,0.0347222222222,1,0.000347222222222,57,0.0197916666667,33,0.0114583333333,37,0.0128472222222,111,15,11,107,122,11,0.00381944444444,111,0.0385416666667,100,0.0347222222222,2780,0.965277777778,2593,0.900347222222,076,Mecklenburg,37119076
Mecklenburg,3267,475,0.145393327212,1947,0.59595959596,38,0.0116314661769,31,0.00948882767065,681,0.208448117539,95,0.0290786654423,1975,54,45,1966,2020,28,0.0085705540251,1975,0.604530149985,1144,0.350168350168,2123,0.649831649832,153,0.0468319559229,077,Mecklenburg,37119077
Mecklenburg,2679,863,0.322135125047,884,0.329973870847,17,0.00634565136245,640,0.238895110116,219,0.0817469204927,56,0.0209033221351,907,36,22,893,929,23,0.00858529301978,907,0.338559163867,393,0.146696528555,2286,0.853303471445,738,0.275475923852,078.1,Mecklenburg,37119078.1
Mecklenburg,2211,993,0.449118046133,704,0.318407960199,22,0.00995024875622,282,0.127544097693,162,0.0732700135685,48,0.0217096336499,719,32,29,716,748,15,0.0067842605156,719,0.325192220715,284,0.128448665762,1927,0.871551334238,905,0.409317051108,079,Mecklenburg,37119079
Mecklenburg,3418,1445,0.422761849035,1498,0.438267992978,17,0.00497366881217,224,0.0655354008192,156,0.0456407255705,78,0.0228203627853,1529,68,43,1504,1572,31,0.00906963136337,1529,0.447337624342,343,0.100351082504,3075,0.899648917496,1306,0.382094792276,080,Mecklenburg,37119080
Mecklenburg,4818,1377,0.285803237858,2806,0.582399335824,52,0.0107928601079,265,0.05500207555,233,0.0483603154836,85,0.0176421751764,2858,94,69,2833,2927,52,0.0107928601079,2858,0.593192195932,484,0.100456621005,4334,0.899543378995,1204,0.249896222499,081,Mecklenburg,37119081
Mecklenburg,5096,913,0.179160125589,2718,0.533359497645,36,0.00706436420722,56,0.010989010989,1216,0.238618524333,157,0.030808477237,2783,89,59,2753,2842,65,0.0127551020408,2783,0.546114599686,1901,0.373037676609,3195,0.626962323391,364,0.0714285714286,082,Mecklenburg,37119082
Mecklenburg,3827,2070,0.540893650379,1230,0.321400574863,19,0.00496472432715,137,0.0357982754115,278,0.0726417559446,93,0.024301019075,1278,58,38,1258,1316,48,0.0125424614581,1278,0.333943036321,542,0.141625293964,3285,0.858374706036,1861,0.48628168278,083,Mecklenburg,37119083
Mecklenburg,3722,1210,0.325094035465,1572,0.422353573348,38,0.0102095647501,108,0.0290166577109,698,0.187533584095,96,0.0257925846319,1615,77,59,1597,1674,43,0.011552928533,1615,0.433906501881,1059,0.284524449221,2663,0.715475550779,940,0.252552391188,084,Mecklenburg,37119084
Mecklenburg,2576,1933,0.750388198758,465,0.18051242236,12,0.00465838509317,53,0.0205745341615,76,0.0295031055901,37,0.0143633540373,489,31,18,476,507,24,0.00931677018634,489,0.189829192547,174,0.0675465838509,2402,0.932453416149,1834,0.711956521739,085,Mecklenburg,37119085
Mecklenburg,1783,1689,0.947279865395,25,0.0140213123948,0,0.0,54,0.0302860347729,1,0.000560852495794,14,0.00785193494111,30,2,2,30,32,5,0.00280426247897,30,0.0168255748738,16,0.0089736399327,1767,0.991026360067,1674,0.938867077958,086,Mecklenburg,37119086
Mecklenburg,3366,2573,0.764408793821,406,0.120617944147,10,0.00297088532383,105,0.0311942959002,194,0.0576351752822,78,0.0231729055258,429,40,31,420,460,23,0.0068330362448,429,0.127450980392,456,0.135472370766,2910,0.864527629234,2337,0.694295900178,087,Mecklenburg,37119087
Mecklenburg,3492,2805,0.803264604811,312,0.0893470790378,16,0.00458190148912,142,0.0406643757159,149,0.0426689576174,68,0.0194730813288,338,32,25,331,363,26,0.00744558991982,338,0.0967926689576,390,0.111683848797,3102,0.888316151203,2605,0.745990836197,088,Mecklenburg,37119088
Mecklenburg,6329,3207,0.506715120872,2554,0.403539263707,33,0.00521409385369,134,0.0211723811029,295,0.0466108389951,106,0.0167483014694,2617,81,57,2593,2674,63,0.00995417917523,2617,0.413493442882,539,0.0851635329436,5790,0.914836467056,3028,0.478432611787,089,Mecklenburg,37119089
Mecklenburg,1646,1480,0.89914945322,81,0.0492102065614,4,0.00243013365735,39,0.0236938031592,21,0.0127582017011,21,0.0127582017011,85,12,11,84,96,4,0.00243013365735,85,0.0516403402187,85,0.0516403402187,1561,0.948359659781,1421,0.863304981774,090,Mecklenburg,37119090
Mecklenburg,3989,3424,0.858360491351,195,0.0488844321885,13,0.0032589621459,264,0.0661820005014,34,0.00852343945851,59,0.0147906743545,215,22,20,213,235,20,0.00501378791677,215,0.0538982201053,136,0.034093757834,3853,0.965906242166,3323,0.833040862372,091,Mecklenburg,37119091
Mecklenburg,3175,2585,0.814173228346,289,0.0910236220472,10,0.00314960629921,157,0.0494488188976,86,0.0270866141732,48,0.0151181102362,306,23,17,300,323,17,0.00535433070866,306,0.0963779527559,237,0.0746456692913,2938,0.925354330709,2448,0.771023622047,092,Mecklenburg,37119092
Mecklenburg,1858,1595,0.858449946179,93,0.0500538213132,3,0.0016146393972,92,0.0495156081808,53,0.0285252960172,22,0.0118406889128,100,17,13,96,113,7,0.0037674919268,100,0.05382131324,130,0.0699677072121,1728,0.930032292788,1517,0.816469321851,093,Mecklenburg,37119093
Mecklenburg,2535,1210,0.477317554241,930,0.366863905325,33,0.0130177514793,97,0.0382642998028,200,0.0788954635108,65,0.025641025641,961,59,43,945,1004,31,0.0122287968442,961,0.37909270217,385,0.151873767258,2150,0.848126232742,1060,0.418145956607,094,Mecklenburg,37119094
Mecklenburg,2483,831,0.334675795409,1213,0.488521949255,19,0.00765203383004,89,0.0358437374144,254,0.102295610149,77,0.0310108739428,1258,46,30,1242,1288,45,0.0181232380185,1258,0.506645187273,417,0.167942005638,2066,0.832057994362,709,0.285541683447,095,Mecklenburg,37119095
Mecklenburg,1961,1722,0.878123406425,129,0.065782763896,4,0.00203977562468,35,0.017848036716,33,0.0168281489036,38,0.0193778684345,142,8,7,141,149,13,0.00662927078021,142,0.0724120346762,104,0.0530341662417,1857,0.946965833758,1653,0.8429372769,096,Mecklenburg,37119096
Mecklenburg,1879,796,0.423629590208,882,0.469398616285,8,0.00425758382118,44,0.0234167110165,108,0.0574773815859,41,0.0218201170836,906,29,15,892,921,24,0.0127727514635,906,0.482171367749,235,0.125066524747,1644,0.874933475253,691,0.367748802555,097,Mecklenburg,37119097
Mecklenburg,5488,1697,0.309220116618,1866,0.340014577259,45,0.00819970845481,144,0.0262390670554,1496,0.272594752187,240,0.0437317784257,1918,86,73,1905,1991,52,0.00947521865889,1918,0.349489795918,2969,0.540998542274,2519,0.459001457726,540,0.0983965014577,098,Mecklenburg,37119098
Mecklenburg,3696,1397,0.377976190476,1595,0.431547619048,23,0.00622294372294,125,0.0338203463203,453,0.122564935065,103,0.027867965368,1655,58,33,1630,1688,60,0.0162337662338,1655,0.447781385281,694,0.187770562771,3002,0.812229437229,1133,0.306547619048,099,Mecklenburg,37119099
Mecklenburg,2871,2324,0.809474050853,203,0.0707070707071,7,0.00243817485197,248,0.0863810518983,49,0.0170672239638,40,0.0139324277255,216,25,19,210,235,13,0.0045280390108,216,0.0752351097179,152,0.052943225357,2719,0.947056774643,2220,0.773249738767,100,Mecklenburg,37119100
Mecklenburg,3074,2457,0.799284320104,281,0.0914118412492,11,0.00357839947951,125,0.0406636304489,155,0.0504229017567,45,0.0146389069616,288,25,21,284,309,7,0.00227716330514,288,0.0936890045543,326,0.106050748211,2748,0.893949251789,2304,0.749512036435,101,Mecklenburg,37119101
Mecklenburg,5457,2787,0.510720175921,1774,0.325087044163,20,0.00366501740883,196,0.0359171706066,533,0.0976727139454,147,0.0269378779549,1832,72,41,1801,1873,58,0.0106285504856,1832,0.335715594649,934,0.171156312992,4523,0.828843687008,2455,0.449880886934,102,Mecklenburg,37119102
Mecklenburg,3045,2798,0.918883415435,92,0.0302134646962,6,0.00197044334975,107,0.0351395730706,24,0.00788177339901,18,0.00591133004926,95,12,12,95,107,3,0.000985221674877,95,0.0311986863711,116,0.0380952380952,2929,0.961904761905,2703,0.887684729064,103,Mecklenburg,37119103
Mecklenburg,3646,602,0.165112452002,2485,0.681568842567,19,0.00521119034558,128,0.0351069665387,324,0.088864509051,88,0.0241360394953,2532,56,34,2510,2566,47,0.0128908392759,2532,0.694459681843,594,0.162918266594,3052,0.837081733406,386,0.105869445968,104,Mecklenburg,37119104
Mecklenburg,5049,2382,0.471776589424,1903,0.376906318083,28,0.00554565260448,339,0.0671420083185,256,0.0507031095266,141,0.027926322044,1977,76,39,1940,2016,74,0.0146563675975,1977,0.39156268568,506,0.100217864924,4543,0.899782135076,2192,0.434145375322,105,Mecklenburg,37119105
Mecklenburg,1658,1505,0.907720144753,91,0.0548854041013,11,0.00663449939686,19,0.0114595898673,20,0.0120627261761,12,0.00723763570567,97,16,14,95,111,6,0.00361881785283,97,0.0585042219542,47,0.0283474065139,1611,0.971652593486,1481,0.893244873341,106,Mecklenburg,37119106
Mecklenburg,3697,1408,0.380849337301,1824,0.493373005139,12,0.00324587503381,221,0.0597781985394,171,0.0462537192318,61,0.0164998647552,1861,39,23,1845,1884,37,0.0100081146876,1861,0.503381119827,327,0.0884500946714,3370,0.911549905329,1290,0.348931566135,107.1,Mecklenburg,37119107.1
Mecklenburg,3888,903,0.23225308642,1898,0.48816872428,39,0.0100308641975,232,0.059670781893,708,0.182098765432,108,0.0277777777778,1958,73,50,1935,2008,60,0.0154320987654,1958,0.503600823045,1168,0.300411522634,2720,0.699588477366,564,0.145061728395,108,Mecklenburg,37119108
Mecklenburg,2146,1974,0.919850885368,90,0.0419384902144,5,0.00232991612302,26,0.0121155638397,27,0.0125815470643,24,0.0111835973905,97,12,9,94,106,7,0.00326188257223,97,0.0452003727866,65,0.0302889095993,2081,0.969711090401,1938,0.903075489282,109,Mecklenburg,37119109
Mecklenburg,1319,1162,0.880970432146,70,0.0530705079606,4,0.00303260045489,40,0.0303260045489,24,0.0181956027293,19,0.0144048521607,77,5,4,76,81,7,0.00530705079606,77,0.0583775587566,78,0.0591357088704,1241,0.94086429113,1119,0.848369977255,110,Mecklenburg,37119110
Mecklenburg,2600,2349,0.903461538462,111,0.0426923076923,3,0.00115384615385,87,0.0334615384615,20,0.00769230769231,30,0.0115384615385,124,15,9,118,133,13,0.005,124,0.0476923076923,63,0.0242307692308,2537,0.975769230769,2311,0.888846153846,111,Mecklenburg,37119111
Mecklenburg,2099,1878,0.894711767508,86,0.0409718913768,1,0.000476417341591,101,0.0481181515007,15,0.00714626012387,18,0.00857551214864,95,2,2,95,97,9,0.00428775607432,95,0.0452596474512,72,0.0343020485946,2027,0.965697951405,1831,0.872320152454,112,Mecklenburg,37119112
Mecklenburg,3169,2818,0.889239507731,172,0.0542757967813,7,0.00220889870622,124,0.0391290627958,24,0.00757336699274,24,0.00757336699274,180,14,10,176,190,8,0.00252445566425,180,0.0568002524456,99,0.0312401388451,3070,0.968759861155,2747,0.866834963711,113,Mecklenburg,37119113
Mecklenburg,2862,2628,0.918238993711,132,0.0461215932914,6,0.0020964360587,47,0.0164220824598,19,0.00663871418588,30,0.0104821802935,142,9,7,140,149,10,0.00349406009783,142,0.0496156533892,88,0.0307477288609,2774,0.969252271139,2573,0.899021663173,114,Mecklenburg,37119114
Mecklenburg,1947,971,0.498715973292,661,0.339496661531,20,0.010272213662,32,0.0164355418593,210,0.107858243451,53,0.0272213662044,679,36,27,670,706,18,0.00924499229584,679,0.348741653826,391,0.200821777093,1556,0.799178222907,829,0.425783256292,115,Mecklenburg,37119115
Mecklenburg,1931,637,0.32988089073,953,0.493526670119,21,0.0108751941999,50,0.0258933195236,216,0.111859140342,54,0.0279647850854,981,45,32,968,1013,28,0.0145002589332,981,0.508026929052,401,0.207664422579,1530,0.792335577421,491,0.254272397721,116,Mecklenburg,37119116
Mecklenburg,2744,1188,0.432944606414,1240,0.451895043732,9,0.00327988338192,64,0.0233236151603,178,0.0648688046647,65,0.0236880466472,1277,27,14,1264,1291,37,0.0134839650146,1277,0.465379008746,352,0.128279883382,2392,0.871720116618,1037,0.377915451895,117,Mecklenburg,37119117
Mecklenburg,3255,2598,0.798156682028,307,0.0943164362519,8,0.00245775729647,219,0.0672811059908,71,0.0218125960061,52,0.015975422427,324,23,18,319,342,17,0.00522273425499,324,0.0995391705069,185,0.0568356374808,3070,0.943164362519,2492,0.765591397849,118,Mecklenburg,37119118
Mecklenburg,1651,1482,0.897637795276,122,0.0738946093277,3,0.00181708055724,31,0.0187764990915,4,0.00242277407632,9,0.00545124167171,126,5,4,125,130,4,0.00242277407632,126,0.076317383404,29,0.0175651120533,1622,0.982434887947,1456,0.88188976378,119,Mecklenburg,37119119
Mecklenburg,4682,1543,0.329560017087,1788,0.381888082016,26,0.00555318240068,201,0.0429303716361,938,0.200341734302,186,0.0397266125587,1846,70,54,1830,1900,58,0.0123878684323,1846,0.394275950449,1776,0.379325074754,2906,0.620674925246,884,0.188808201623,120,Mecklenburg,37119120
Mecklenburg,3539,3176,0.897428652162,163,0.0460582085335,8,0.0022605255722,139,0.0392766318169,15,0.00423848544787,38,0.0107374964679,176,15,13,174,189,13,0.00367335405482,176,0.0497315625883,92,0.0259960440802,3447,0.97400395592,3100,0.875953659226,121,Mecklenburg,37119121
Mecklenburg,6015,3690,0.613466334165,1571,0.261180382377,23,0.00382377389859,299,0.0497090606816,306,0.0508728179551,126,0.0209476309227,1636,63,34,1607,1670,65,0.0108063175395,1636,0.271986699917,752,0.12502078138,5263,0.87497921862,3306,0.549625935162,122,Mecklenburg,37119122
Mecklenburg,2449,828,0.338097182523,1234,0.503879134341,10,0.00408329930584,79,0.0322580645161,225,0.0918742343814,73,0.0298080849326,1270,35,21,1256,1291,36,0.014699877501,1270,0.518579011842,383,0.156390363414,2066,0.843609636586,718,0.293180890159,123,Mecklenburg,37119123
Mecklenburg,2959,685,0.231497127408,1836,0.620479891855,27,0.00912470429199,69,0.0233186887462,239,0.0807705305847,103,0.0348090571139,1895,71,44,1868,1939,59,0.0199391686381,1895,0.640419060493,445,0.150388644812,2514,0.849611355188,549,0.185535653937,124,Mecklenburg,37119124
Mecklenburg,1612,713,0.442307692308,650,0.403225806452,8,0.00496277915633,54,0.0334987593052,156,0.0967741935484,31,0.0192307692308,665,14,11,662,676,15,0.00930521091811,665,0.41253101737,330,0.204714640199,1282,0.795285359801,557,0.345533498759,125,Mecklenburg,37119125
Mecklenburg,3531,895,0.253469272161,1974,0.559048428207,11,0.00311526479751,438,0.124044180119,156,0.0441801189465,57,0.0161427357689,2014,31,14,1997,2028,40,0.0113282356273,2014,0.570376663835,250,0.0708014726706,3281,0.929198527329,803,0.227414330218,126,Mecklenburg,37119126
Mecklenburg,3278,3094,0.943868212325,62,0.0189139719341,6,0.00183038438072,52,0.0158633312996,42,0.012812690665,22,0.00671140939597,69,14,14,69,83,7,0.00213544844417,69,0.0210494203783,110,0.0335570469799,3168,0.96644295302,3029,0.9240390482,127,Mecklenburg,37119127
Mecklenburg,3191,2024,0.634283923535,857,0.26856784707,6,0.00188028831087,193,0.0604826073331,55,0.017235976183,56,0.0175493575682,886,22,12,876,898,29,0.00908806016923,886,0.277655907239,168,0.0526480727045,3023,0.947351927296,1932,0.605452836102,128,Mecklenburg,37119128
Mecklenburg,2212,1399,0.632459312839,474,0.214285714286,9,0.00406871609403,70,0.0316455696203,217,0.0981012658228,43,0.0194394213382,491,21,20,490,511,17,0.00768535262206,491,0.221971066908,516,0.233273056058,1696,0.766726943942,1124,0.508137432188,129,Mecklenburg,37119129
Mecklenburg,2091,937,0.448110951698,716,0.342419894787,17,0.00813008130081,118,0.0564323290292,238,0.113821138211,65,0.0310856049737,748,34,26,740,774,32,0.0153036824486,748,0.357723577236,401,0.191774270684,1690,0.808225729316,812,0.388330942133,130,Mecklenburg,37119130
Mecklenburg,1658,1523,0.918576598311,50,0.0301568154403,2,0.00120627261761,70,0.0422195416164,4,0.00241254523522,9,0.00542822677925,53,4,3,52,56,3,0.00180940892642,53,0.0319662243667,44,0.0265379975875,1614,0.973462002413,1485,0.895657418577,131,Mecklenburg,37119131
Mecklenburg,2800,1232,0.44,777,0.2775,35,0.0125,118,0.0421428571429,576,0.205714285714,62,0.0221428571429,807,48,41,800,848,30,0.0107142857143,807,0.288214285714,913,0.326071428571,1887,0.673928571429,950,0.339285714286,132,Mecklenburg,37119132
Mecklenburg,4031,3600,0.893078640536,239,0.0592904986356,5,0.00124038700074,123,0.0305135202183,27,0.00669808980402,37,0.00917886380551,252,11,10,251,262,13,0.00322500620194,252,0.0625155048375,157,0.0389481518234,3874,0.961051848177,3484,0.864301662119,133,Mecklenburg,37119133
Mecklenburg,6613,5449,0.823983063662,642,0.0970815061243,29,0.00438530167851,148,0.0223801602903,231,0.0349311961288,114,0.0172387721155,681,57,45,669,726,39,0.0058974746711,681,0.102978980795,486,0.0734916074399,6127,0.92650839256,5229,0.790715257825,134,Mecklenburg,37119134
Mecklenburg,8085,2916,0.360667903525,4178,0.516759431045,51,0.00630797773655,250,0.0309214594929,536,0.0662956091528,154,0.0190476190476,4281,90,64,4255,4345,103,0.0127396413111,4281,0.529499072356,1054,0.130364873222,7031,0.869635126778,2511,0.310575139147,135,Mecklenburg,37119135
Mecklenburg,2127,1952,0.917724494593,81,0.0380818053597,22,0.010343206394,47,0.0220968500235,11,0.00517160319699,14,0.00658204043253,86,27,27,86,113,5,0.00235072872591,86,0.0404325340856,64,0.0300893276916,2063,0.969910672308,1900,0.893276915844,136,Mecklenburg,37119136
Mecklenburg,5110,4136,0.80939334638,301,0.058904109589,7,0.0013698630137,563,0.110176125245,47,0.00919765166341,56,0.0109589041096,319,22,18,315,337,18,0.00352250489237,319,0.0624266144814,221,0.0432485322896,4889,0.95675146771,3982,0.779256360078,137,Mecklenburg,37119137
Mecklenburg,3737,1439,0.385068236553,1576,0.421728659352,24,0.00642226384801,278,0.0743912229061,337,0.0901792881991,83,0.022210329141,1633,47,35,1621,1668,57,0.015252876639,1633,0.436981535991,690,0.18464008563,3047,0.81535991437,1129,0.302113995183,138,Mecklenburg,37119138
Mecklenburg,3509,2962,0.844115132516,242,0.0689655172414,10,0.00284981476204,229,0.0652607580507,30,0.00854944428612,36,0.0102593331433,253,19,12,246,265,11,0.00313479623824,253,0.0721003134796,188,0.0535765175264,3321,0.946423482474,2818,0.803077799943,139.1,Mecklenburg,37119139.1
Mecklenburg,6005,4471,0.74454621149,594,0.0989175686928,17,0.00283097418818,688,0.114571190674,142,0.0236469608659,93,0.0154870940883,631,40,26,617,657,37,0.00616153205662,631,0.105079100749,350,0.0582847626978,5655,0.941715237302,4271,0.711240632806,140,Mecklenburg,37119140
Mecklenburg,6627,3987,0.601629696695,1406,0.212162366078,29,0.00437603742266,794,0.119812886676,232,0.0350082993813,179,0.0270107137468,1511,77,40,1474,1551,105,0.0158442734269,1511,0.228006639505,491,0.074090840501,6136,0.925909159499,3803,0.573864493738,141,Mecklenburg,37119141
Mecklenburg,5239,4545,0.86753197175,392,0.0748234395877,12,0.00229051345677,174,0.0332124451231,63,0.012025195648,53,0.0101164344341,409,28,22,403,431,17,0.00324489406375,409,0.0780683336515,222,0.0423744989502,5017,0.95762550105,4395,0.838900553541,142,Mecklenburg,37119142
Mecklenburg,5309,4576,0.861932567338,368,0.0693162554153,8,0.00150687511772,210,0.0395554718403,68,0.0128084385007,79,0.0148803917875,393,35,27,385,420,25,0.00470898474289,393,0.0740252401582,274,0.0516104727821,5035,0.948389527218,4393,0.827462799021,143,Mecklenburg,37119143
Mecklenburg,3502,2915,0.832381496288,240,0.0685322672758,9,0.00256996002284,258,0.0736721873215,32,0.00913763563678,48,0.0137064534552,260,19,18,259,278,20,0.00571102227299,260,0.0742432895488,131,0.0374071958881,3371,0.962592804112,2828,0.8075385494,144,Mecklenburg,37119144
Mecklenburg,9286,6222,0.670040921818,2226,0.239715701055,36,0.00387680379065,485,0.0522291621796,160,0.0172302390696,157,0.016907172087,2305,97,62,2270,2367,79,0.0085074305406,2305,0.248223131596,464,0.0499676933017,8822,0.950032306698,5979,0.643872496231,145,Mecklenburg,37119145
Mecklenburg,5948,1795,0.301782111634,2532,0.42568930733,23,0.00386684599866,1246,0.209482178884,190,0.0319435104237,162,0.0272360457297,2618,62,35,2591,2653,86,0.0144586415602,2618,0.44014794889,453,0.0761600537996,5495,0.9238399462,1619,0.272192333557,146,Mecklenburg,37119146
Mecklenburg,5078,1623,0.319614021268,2256,0.444269397401,32,0.00630169358015,470,0.0925561244584,559,0.110082709728,138,0.0271760535644,2308,65,45,2288,2353,52,0.0102402520677,2308,0.454509649468,1057,0.208152816069,4021,0.791847183931,1224,0.241039779441,147,Mecklenburg,37119147
Mecklenburg,8593,6237,0.725823344583,870,0.101245199581,26,0.00302571860817,1166,0.135691842197,161,0.0187361806121,133,0.0154777144187,918,51,38,905,956,48,0.00558594204585,918,0.106831141627,576,0.0670313045502,8017,0.93296869545,5860,0.681950424764,148,Mecklenburg,37119148
Mecklenburg,4608,1753,0.380425347222,2153,0.467230902778,15,0.00325520833333,289,0.0627170138889,301,0.0653211805556,97,0.0210503472222,2206,30,19,2195,2225,53,0.0115017361111,2206,0.478732638889,609,0.132161458333,3999,0.867838541667,1530,0.33203125,149,Mecklenburg,37119149
Mecklenburg,3466,1932,0.557414887478,1278,0.368724754761,15,0.00432775533756,101,0.0291402192729,95,0.0274091171379,45,0.0129832660127,1301,32,24,1293,1325,23,0.0066358915176,1301,0.375360646278,199,0.0574148874784,3267,0.942585112522,1846,0.532602423543,150,Mecklenburg,37119150
Mecklenburg,3854,1843,0.478204462896,1582,0.410482615464,10,0.00259470679813,168,0.0435910742086,159,0.0412558380903,92,0.0238713025428,1624,39,29,1614,1653,42,0.0108977685522,1624,0.421380384017,359,0.0931499740529,3495,0.906850025947,1680,0.435910742086,151,Mecklenburg,37119151
Mecklenburg,2304,1486,0.644965277778,366,0.158854166667,18,0.0078125,125,0.0542534722222,263,0.114149305556,46,0.0199652777778,380,35,31,376,411,14,0.00607638888889,380,0.164930555556,422,0.183159722222,1882,0.816840277778,1350,0.5859375,200,Mecklenburg,37119200
Mecklenburg,6280,3374,0.537261146497,2208,0.351592356688,39,0.0062101910828,118,0.0187898089172,435,0.0692675159236,106,0.0168789808917,2264,73,46,2237,2310,56,0.00891719745223,2264,0.36050955414,762,0.121337579618,5518,0.878662420382,3118,0.496496815287,201,Mecklenburg,37119201
Mecklenburg,7110,5932,0.834317862166,691,0.0971870604782,26,0.00365682137834,177,0.0248945147679,187,0.0263009845288,97,0.0136427566807,721,58,49,712,770,30,0.0042194092827,721,0.101406469761,570,0.0801687763713,6540,0.919831223629,5595,0.786919831224,202,Mecklenburg,37119202
Mecklenburg,5537,2294,0.414303774607,2601,0.469748961532,19,0.00343146108001,154,0.0278128950695,324,0.0585154415749,145,0.0261874661369,2694,68,39,2665,2733,93,0.0167960989706,2694,0.486545060502,756,0.136536030341,4781,0.863463969659,1953,0.352718078382,203,Mecklenburg,37119203
Mecklenburg,4736,1746,0.368665540541,2468,0.521114864865,12,0.00253378378378,229,0.0483530405405,179,0.0377956081081,102,0.0215371621622,2525,38,14,2501,2539,57,0.012035472973,2525,0.533150337838,453,0.0956503378378,4283,0.904349662162,1542,0.325591216216,204.1,Mecklenburg,37119204.1
Mecklenburg,3236,1730,0.534610630408,1039,0.321075401731,8,0.00247218788628,138,0.0426452410383,263,0.0812731767614,58,0.0179233621755,1063,26,18,1055,1081,24,0.00741656365884,1063,0.328491965389,497,0.153584672435,2739,0.846415327565,1534,0.474042027194,205,Mecklenburg,37119205
Mecklenburg,5656,4793,0.847418670438,510,0.0901697312588,15,0.00265205091938,189,0.0334158415842,73,0.0129066478076,76,0.0134370579915,539,26,21,534,560,29,0.00512729844413,539,0.095297029703,237,0.0419024045262,5419,0.958097595474,4655,0.82301980198,206,Mecklenburg,37119206
Mecklenburg,5123,4267,0.83291040406,417,0.0813976185829,30,0.00585594378294,100,0.0195198126098,242,0.0472379465157,67,0.0130782744486,442,53,45,434,487,25,0.00487995315245,442,0.0862775717353,654,0.127659574468,4469,0.872340425532,3908,0.762834276791,207,Mecklenburg,37119207
Mecklenburg,4341,4081,0.940105966367,118,0.0271826768026,7,0.00161253167473,73,0.0168164017507,29,0.00668048836674,33,0.00760193503801,127,15,14,126,141,9,0.00207325501037,127,0.0292559318129,81,0.0186592950933,4260,0.981340704907,4032,0.928818244644,208,Mecklenburg,37119208
Mecklenburg,4440,3639,0.819594594595,551,0.124099099099,23,0.00518018018018,66,0.0148648648649,94,0.0211711711712,67,0.0150900900901,575,56,47,566,622,24,0.00540540540541,575,0.129504504505,249,0.0560810810811,4191,0.943918918919,3496,0.787387387387,209,Mecklenburg,37119209
Mecklenburg,6046,1086,0.179622891168,4389,0.72593450215,24,0.00396956665564,111,0.0183592457823,298,0.0492887859742,138,0.0228250082699,4477,88,45,4434,4522,88,0.0145550777373,4477,0.740489579888,537,0.0888190539199,5509,0.91118094608,920,0.1521667218,210,Mecklenburg,37119210
Mecklenburg,7736,3934,0.508531540848,3010,0.389089968976,33,0.00426577042399,332,0.0429162357808,289,0.0373578076525,138,0.0178386763185,3087,89,53,3051,3140,77,0.00995346432265,3087,0.399043433299,669,0.0864788004137,7067,0.913521199586,3622,0.468200620476,211,Mecklenburg,37119211
Mecklenburg,12127,5317,0.438443143399,4404,0.363156592727,45,0.00371072812732,1763,0.145378081966,289,0.0238311206399,309,0.0254803331409,4527,109,67,4485,4594,123,0.0101426568813,4527,0.373299249608,723,0.0596190319123,11404,0.940380968088,4972,0.409994227756,212,Mecklenburg,37119212
Mecklenburg,4867,1141,0.234435997534,3006,0.617628929525,32,0.00657489213068,218,0.0447914526402,388,0.0797205670844,82,0.0168481610849,3065,61,38,3042,3103,59,0.0121224573659,3065,0.629751386891,576,0.118348058352,4291,0.881651941648,1014,0.208341894391,213,Mecklenburg,37119213
Mecklenburg,3255,1706,0.524116743472,1260,0.387096774194,14,0.00430107526882,167,0.0513056835637,53,0.0162826420891,55,0.0168970814132,1297,37,26,1286,1323,37,0.0113671274962,1297,0.39846390169,143,0.0439324116743,3112,0.956067588326,1642,0.5044546851,214,Mecklenburg,37119214
Mecklenburg,3572,2867,0.802631578947,375,0.104983202688,9,0.0025195968645,219,0.0613101903695,58,0.0162374020157,44,0.0123180291153,394,25,20,389,414,19,0.00531914893617,394,0.110302351624,160,0.0447928331467,3412,0.955207166853,2768,0.774916013438,215,Mecklenburg,37119215
Mecklenburg,4813,3609,0.749844172034,684,0.142115104924,20,0.00415541242468,249,0.0517348846873,170,0.0353210056098,81,0.01682942032,721,35,31,717,752,37,0.00768751298566,721,0.14980261791,402,0.0835237897361,4411,0.916476210264,3412,0.708913359651,216,Mecklenburg,37119216
Mecklenburg,3228,2494,0.772614622057,479,0.148389095415,7,0.00216852540273,123,0.0381040892193,88,0.0272614622057,37,0.0114622057001,490,18,14,486,504,11,0.00340768277571,490,0.151796778191,237,0.0734200743494,2991,0.926579925651,2351,0.728314745973,217,Mecklenburg,37119217
Mecklenburg,2763,2444,0.884545783569,178,0.0644227289178,11,0.00398117987695,39,0.014115092291,62,0.0224393774882,29,0.0104958378574,185,21,21,185,206,7,0.00253347810351,185,0.0669562070214,124,0.0448787549765,2639,0.955121245024,2387,0.863916033297,218,Mecklenburg,37119218
Mecklenburg,2426,1898,0.782357790602,266,0.109645507007,21,0.00865622423743,106,0.0436933223413,106,0.0436933223413,29,0.0119538334707,276,27,23,272,299,10,0.00412201154163,276,0.113767518549,173,0.0713107996702,2253,0.92868920033,1842,0.759274525969,219,Mecklenburg,37119219
Mecklenburg,3017,2646,0.877030162413,216,0.0715942989725,13,0.00430891614186,66,0.0218760357971,53,0.0175671196553,23,0.00762346702022,224,22,20,222,244,8,0.00265164070268,224,0.0742459396752,129,0.0427577063308,2888,0.957242293669,2574,0.853165396089,220,Mecklenburg,37119220
Mecklenburg,4229,3783,0.894537715772,238,0.0562780799243,17,0.00401986285174,97,0.022936864507,55,0.013005438638,39,0.00922203830693,246,36,34,244,280,8,0.00189170016552,246,0.0581697800899,173,0.0409080160795,4056,0.959091983921,3677,0.869472688579,221,Mecklenburg,37119221
Mecklenburg,6351,2392,0.376633601008,3367,0.530152731853,40,0.00629822075264,219,0.0344827586207,204,0.0321209258385,129,0.0203117619273,3443,90,58,3411,3501,76,0.01196661943,3443,0.542119351283,384,0.0604629192253,5967,0.939537080775,2258,0.355534561486,222,Mecklenburg,37119222
Mecklenburg,6055,3585,0.592072667217,2037,0.336416184971,14,0.00231213872832,192,0.0317093311313,135,0.0222956234517,92,0.0151940545004,2091,63,32,2060,2123,54,0.00891824938068,2091,0.345334434352,311,0.051362510322,5744,0.948637489678,3438,0.56779521057,223.1,Mecklenburg,37119223.1
Mecklenburg,3036,1867,0.614953886693,786,0.258893280632,15,0.00494071146245,171,0.0563241106719,140,0.0461133069829,57,0.0187747035573,818,31,23,810,841,32,0.0105401844532,818,0.269433465086,256,0.0843214756258,2780,0.915678524374,1764,0.581027667984,224,Mecklenburg,37119224
Mecklenburg,1851,1452,0.784440842788,223,0.120475418693,11,0.00594273365748,59,0.0318746623447,87,0.0470016207455,19,0.010264721772,231,19,16,228,247,8,0.00432198811453,231,0.124797406807,201,0.108589951378,1650,0.891410048622,1347,0.727714748784,225,Mecklenburg,37119225
Mecklenburg,4171,3302,0.791656677056,476,0.114121313834,11,0.00263725725246,205,0.0491488851594,103,0.0246943179094,74,0.0177415487893,508,39,24,493,532,32,0.00767202109806,508,0.121793334932,290,0.0695276912012,3881,0.930472308799,3134,0.751378566291,226,Mecklenburg,37119226
Mecklenburg,5336,4354,0.815967016492,382,0.0715892053973,24,0.00449775112444,445,0.083395802099,57,0.0106821589205,74,0.013868065967,406,45,34,395,440,24,0.00449775112444,406,0.0760869565217,352,0.0659670164918,4984,0.934032983508,4077,0.764055472264,227,Mecklenburg,37119227
Mecklenburg,4772,2423,0.507753562448,1479,0.309932942163,10,0.00209555741827,397,0.0831936295054,369,0.0773260687343,94,0.0196982397318,1531,44,27,1514,1558,52,0.010896898575,1531,0.320829840738,816,0.170997485331,3956,0.829002514669,2030,0.425398155909,228,Mecklenburg,37119228
Mecklenburg,6274,4260,0.678992668154,1236,0.197003506535,29,0.00462225055786,396,0.0631176283073,232,0.0369780044629,121,0.0192859419828,1288,61,42,1269,1330,52,0.00828817341409,1288,0.205291679949,667,0.106311762831,5607,0.893688237169,3901,0.621772394007,229,Mecklenburg,37119229
Mecklenburg,6725,3374,0.501710037175,1972,0.293234200743,35,0.00520446096654,657,0.0976951672862,553,0.0822304832714,134,0.0199256505576,2025,68,50,2007,2075,53,0.00788104089219,2025,0.301115241636,1149,0.170855018587,5576,0.829144981413,2866,0.426171003717,230,Mecklenburg,37119230
Mecklenburg,4816,3228,0.670265780731,774,0.160714285714,17,0.00352990033223,354,0.0735049833887,344,0.0714285714286,99,0.0205564784053,797,39,34,792,831,23,0.00477574750831,797,0.165490033223,689,0.143064784053,4127,0.856935215947,2937,0.609842192691,231,Mecklenburg,37119231
Mecklenburg,5142,4166,0.81019058732,350,0.0680669000389,12,0.00233372228705,460,0.0894593543368,74,0.0143912874368,80,0.0155581485803,372,34,26,364,398,22,0.00427849085959,372,0.0723453908985,327,0.0635939323221,4815,0.936406067678,3938,0.765849863866,232,Mecklenburg,37119232
Mecklenburg,3921,3640,0.928334608518,91,0.023208365213,2,0.000510073960724,145,0.0369803621525,16,0.00408059168579,27,0.00688599846978,96,4,4,96,100,5,0.00127518490181,96,0.0244835501148,79,0.0201479214486,3842,0.979852078551,3578,0.912522315736,233,Mecklenburg,37119233
Mecklenburg,4107,2880,0.701241782323,732,0.17823228634,31,0.00754808862917,79,0.0192354516679,313,0.0762113464816,72,0.0175310445581,770,56,47,761,817,38,0.00925249573898,770,0.187484782079,597,0.145361577794,3510,0.854638422206,2638,0.642317993669,234,Mecklenburg,37119234
Mecklenburg,3856,2460,0.637966804979,919,0.238329875519,29,0.00752074688797,85,0.0220435684647,289,0.0749481327801,74,0.0191908713693,954,52,39,941,993,35,0.00907676348548,954,0.247406639004,531,0.13770746888,3325,0.86229253112,2259,0.585840248963,235,Mecklenburg,37119235
Mecklenburg,3863,3511,0.9088791095,188,0.0486668392441,28,0.00724825265338,58,0.0150142376391,52,0.013461040642,26,0.00673052032099,194,41,39,192,233,6,0.00155319699715,194,0.0502200362413,133,0.0344292001035,3730,0.965570799896,3434,0.888946414704,236,Mecklenburg,37119236
Mecklenburg,4676,2107,0.450598802395,1952,0.41745081266,18,0.0038494439692,203,0.0434131736527,292,0.0624465355004,104,0.0222412318221,2007,53,33,1987,2040,55,0.0117621899059,2007,0.429213002566,516,0.110350727117,4160,0.889649272883,1948,0.416595380667,237,Mecklenburg,37119237
Mecklenburg,2924,1973,0.674760601915,721,0.24658002736,9,0.0030779753762,131,0.0448016415869,46,0.015731874145,44,0.015047879617,748,24,13,737,761,27,0.00923392612859,748,0.255813953488,172,0.0588235294118,2752,0.941176470588,1863,0.637140902873,238.1,Mecklenburg,37119238.1
Mecklenburg,3320,1630,0.490963855422,1093,0.32921686747,9,0.00271084337349,460,0.138554216867,54,0.016265060241,74,0.0222891566265,1131,34,16,1113,1147,38,0.0114457831325,1131,0.340662650602,189,0.0569277108434,3131,0.943072289157,1533,0.461746987952,239,Mecklenburg,37119239
Mecklenburg,5621,5119,0.910692047678,225,0.040028464686,18,0.00320227717488,134,0.0238391745241,79,0.014054438712,46,0.00818359722469,239,32,29,236,268,14,0.00249066002491,239,0.0425191247109,207,0.0368261875111,5414,0.963173812489,5009,0.891122576054,240,Mecklenburg,37119240
Mecklenburg,4448,3501,0.787095323741,661,0.148606115108,13,0.0029226618705,111,0.0249550359712,102,0.0229316546763,60,0.0134892086331,689,34,23,678,712,28,0.00629496402878,689,0.154901079137,240,0.0539568345324,4208,0.946043165468,3374,0.758543165468,241,Mecklenburg,37119241
Mecklenburg,2536,2372,0.935331230284,82,0.032334384858,7,0.00276025236593,56,0.0220820189274,7,0.00276025236593,12,0.00473186119874,85,12,12,85,97,3,0.00118296529968,85,0.0335173501577,41,0.016167192429,2495,0.983832807571,2341,0.923107255521,242,Mecklenburg,37119242
Mecklenburg,8303,4947,0.595808743828,2149,0.258822112489,35,0.00421534385162,489,0.0588943755269,509,0.0613031434421,174,0.0209562808623,2221,78,57,2200,2278,72,0.00867156449476,2221,0.267493676984,1196,0.14404432133,7107,0.85595567867,4397,0.529567626159,243,Mecklenburg,37119243
Mitchell,1472,1423,0.966711956522,9,0.00611413043478,5,0.00339673913043,0,0.0,11,0.00747282608696,24,0.0163043478261,10,17,17,10,27,1,0.000679347826087,10,0.00679347826087,22,0.0149456521739,1450,0.985054347826,1418,0.963315217391,01,Mitchell,3712101
Mitchell,331,329,0.993957703927,0,0.0,0,0.0,0,0.0,0,0.0,2,0.00604229607251,0,2,2,0,2,0,0.0,0,0.0,0,0.0,331,1.0,329,0.993957703927,02,Mitchell,3712102
Mitchell,630,619,0.98253968254,1,0.0015873015873,0,0.0,1,0.0015873015873,0,0.0,9,0.0142857142857,1,5,5,1,6,0,0.0,1,0.0015873015873,2,0.0031746031746,628,0.996825396825,617,0.979365079365,03,Mitchell,3712103
Mitchell,6555,6244,0.952555301297,25,0.00381388253242,32,0.0048817696415,28,0.00427154843631,192,0.029290617849,34,0.00518688024409,28,54,54,28,82,3,0.00045766590389,28,0.00427154843631,284,0.0433257055683,6271,0.956674294432,6169,0.941113653699,04,Mitchell,3712104
Mitchell,971,954,0.982492276004,1,0.0010298661174,1,0.0010298661174,3,0.00308959835221,5,0.00514933058702,7,0.00720906282183,1,7,7,1,8,0,0.0,1,0.0010298661174,11,0.0113285272915,960,0.988671472709,948,0.9763130793,05,Mitchell,3712105
Mitchell,648,611,0.942901234568,3,0.00462962962963,5,0.00771604938272,2,0.00308641975309,21,0.0324074074074,6,0.00925925925926,3,10,10,3,13,0,0.0,3,0.00462962962963,30,0.0462962962963,618,0.953703703704,605,0.933641975309,06,Mitchell,3712106
Mitchell,202,200,0.990099009901,0,0.0,0,0.0,0,0.0,0,0.0,2,0.00990099009901,0,2,2,0,2,0,0.0,0,0.0,3,0.0148514851485,199,0.985148514851,197,0.975247524752,07,Mitchell,3712107
Mitchell,295,291,0.986440677966,0,0.0,0,0.0,0,0.0,1,0.00338983050847,3,0.0101694915254,2,1,1,2,3,2,0.00677966101695,2,0.00677966101695,7,0.0237288135593,288,0.976271186441,286,0.969491525424,08,Mitchell,3712108
Mitchell,1440,1389,0.964583333333,1,0.000694444444444,4,0.00277777777778,4,0.00277777777778,21,0.0145833333333,21,0.0145833333333,2,17,17,2,19,1,0.000694444444444,2,0.00138888888889,37,0.0256944444444,1403,0.974305555556,1376,0.955555555556,09,Mitchell,3712109
Montgomery,2048,1262,0.6162109375,368,0.1796875,4,0.001953125,15,0.00732421875,386,0.1884765625,13,0.00634765625,375,9,6,372,381,7,0.00341796875,375,0.18310546875,532,0.259765625,1516,0.740234375,1126,0.5498046875,BIS,Montgomery,37123BIS
Montgomery,2252,1361,0.604351687389,369,0.163854351687,22,0.00976909413854,9,0.00399644760213,452,0.200710479574,39,0.0173179396092,388,34,26,380,414,19,0.00843694493783,388,0.172291296625,661,0.29351687389,1591,0.70648312611,1178,0.523090586146,CAN,Montgomery,37123CAN
Montgomery,761,623,0.818659658344,101,0.132720105125,3,0.00394218134034,0,0.0,30,0.0394218134034,4,0.00525624178712,104,5,4,103,108,3,0.00394218134034,104,0.136662286465,46,0.0604467805519,715,0.939553219448,610,0.801576872536,CHE,Montgomery,37123CHE
Montgomery,1602,1565,0.976903870162,15,0.00936329588015,4,0.00249687890137,2,0.00124843945069,3,0.00187265917603,13,0.00811485642946,16,7,7,16,23,1,0.000624219725343,16,0.00998751560549,5,0.00312109862672,1597,0.996878901373,1563,0.975655430712,ELD,Montgomery,37123ELD
Montgomery,640,614,0.959375,13,0.0203125,1,0.0015625,4,0.00625,5,0.0078125,3,0.0046875,14,2,2,14,16,1,0.0015625,14,0.021875,10,0.015625,630,0.984375,609,0.9515625,LIT,Montgomery,37123LIT
Montgomery,1771,758,0.428006775833,957,0.540372670807,5,0.00282326369283,30,0.016939582157,9,0.00508187464709,12,0.00677583286279,961,14,13,960,974,4,0.00225861095426,961,0.542631281762,18,0.0101637492942,1753,0.989836250706,756,0.426877470356,MTG,Montgomery,37123MTG
Montgomery,371,366,0.986522911051,0,0.0,1,0.00269541778976,4,0.010781671159,0,0.0,0,0.0,0,1,1,0,1,0,0.0,0,0.0,2,0.00539083557951,369,0.99460916442,364,0.981132075472,OPH,Montgomery,37123OPH
Montgomery,1174,1006,0.856899488927,102,0.0868824531516,6,0.00511073253833,44,0.0374787052811,8,0.00681431005111,8,0.00681431005111,106,11,10,105,116,4,0.00340715502555,106,0.0902896081772,12,0.0102214650767,1162,0.989778534923,1003,0.854344122658,PEE,Montgomery,37123PEE
Montgomery,1242,465,0.374396135266,547,0.440418679549,7,0.00563607085346,6,0.0048309178744,208,0.167471819646,9,0.00724637681159,552,10,7,549,559,5,0.00402576489533,552,0.444444444444,316,0.254428341385,926,0.745571658615,366,0.294685990338,ROC,Montgomery,37123ROC
Montgomery,2189,1975,0.902238465053,105,0.0479671082686,4,0.00182731841023,11,0.00502512562814,71,0.0324349017816,23,0.0105070808588,109,13,12,108,121,4,0.00182731841023,109,0.0497944266788,172,0.07857469164,2017,0.92142530836,1887,0.862037460027,STA,Montgomery,37123STA
Montgomery,2481,1732,0.69810560258,572,0.230552196695,4,0.00161225312374,50,0.0201531640468,103,0.0415155179363,20,0.0080612656187,582,14,10,578,592,10,0.00403063280935,582,0.234582829504,181,0.0729544538493,2300,0.927045546151,1660,0.669085046352,T1,Montgomery,37123T1
Montgomery,2457,1787,0.72730972731,551,0.224257224257,27,0.010989010989,15,0.00610500610501,65,0.026455026455,12,0.004884004884,557,35,30,552,587,6,0.002442002442,557,0.226699226699,96,0.039072039072,2361,0.960927960928,1754,0.713878713879,T2,Montgomery,37123T2
Montgomery,1500,1424,0.949333333333,18,0.012,7,0.00466666666667,44,0.0293333333333,3,0.002,4,0.00266666666667,18,9,9,18,27,0,0.0,18,0.012,10,0.00666666666667,1490,0.993333333333,1419,0.946,UWH,Montgomery,37123UWH
Montgomery,564,284,0.503546099291,189,0.335106382979,0,0.0,85,0.150709219858,2,0.00354609929078,4,0.00709219858156,189,4,4,189,193,0,0.0,189,0.335106382979,3,0.00531914893617,561,0.994680851064,283,0.501773049645,WAD,Montgomery,37123WAD
Moore,2477,1838,0.742026645135,430,0.173597093258,13,0.00524828421478,9,0.00363342753331,173,0.0698425514736,14,0.00565199838514,434,22,19,431,453,4,0.00161485668147,434,0.175211949939,231,0.0932579733549,2246,0.906742026645,1786,0.721033508276,BEN,Moore,37125BEN
Moore,2887,2432,0.842396951853,326,0.112919986145,36,0.0124696917215,10,0.00346380325598,50,0.0173190162799,33,0.0114305507447,333,60,59,332,392,7,0.00242466227918,333,0.115344648424,131,0.0453758226533,2756,0.954624177347,2360,0.81745756841,CAM,Moore,37125CAM
Moore,5442,4418,0.811833884601,848,0.155825064315,49,0.00900404263139,32,0.00588019110621,35,0.00643145902242,60,0.0110253583241,871,79,72,864,943,23,0.00422638735759,871,0.160051451672,122,0.0224182285924,5320,0.977581771408,4343,0.798052186696,CAR,Moore,37125CAR
Moore,2068,1776,0.858800773694,198,0.0957446808511,9,0.00435203094778,10,0.00483558994197,56,0.027079303675,19,0.00918762088975,204,15,15,204,219,6,0.00290135396518,204,0.0986460348162,134,0.0647969052224,1934,0.935203094778,1712,0.827852998066,DHR,Moore,37125DHR
Moore,2637,1834,0.69548729617,639,0.242320819113,53,0.0200985968904,50,0.0189609404626,32,0.0121350018961,29,0.0109973454683,652,66,62,648,714,13,0.00492984452029,652,0.247250663633,99,0.037542662116,2538,0.962457337884,1778,0.674251042852,EAB,Moore,37125EAB
Moore,3212,3038,0.945828144458,66,0.0205479452055,9,0.00280199252802,44,0.013698630137,20,0.00622665006227,35,0.010896637609,71,24,23,70,94,5,0.00155666251557,71,0.022104607721,88,0.027397260274,3124,0.972602739726,2983,0.928704856787,EUR,Moore,37125EUR
Moore,1614,1251,0.775092936803,276,0.171003717472,15,0.0092936802974,7,0.00433705080545,36,0.0223048327138,29,0.0179677819083,285,27,22,280,307,9,0.00557620817844,285,0.176579925651,70,0.0433705080545,1544,0.956629491945,1228,0.760842627014,EWD,Moore,37125EWD
Moore,3260,3041,0.93282208589,143,0.0438650306748,12,0.00368098159509,25,0.00766871165644,21,0.00644171779141,18,0.00552147239264,147,23,21,145,168,4,0.00122699386503,147,0.0450920245399,65,0.0199386503067,3195,0.980061349693,3000,0.920245398773,KWD,Moore,37125KWD
Moore,2854,2366,0.829011913104,291,0.101962158374,34,0.0119131044149,34,0.0119131044149,77,0.0269796776454,52,0.0182200420463,305,63,56,298,361,14,0.00490539593553,305,0.10686755431,166,0.0581639803784,2688,0.941836019622,2297,0.804835318851,LTR,Moore,37125LTR
Moore,2649,2270,0.856927142318,258,0.0973952434881,9,0.00339750849377,16,0.00604001510004,75,0.0283125707814,21,0.0079275198188,268,20,14,262,282,10,0.00377500943752,268,0.101170252926,157,0.0592676481691,2492,0.940732351831,2197,0.829369573424,NSP,Moore,37125NSP
Moore,2530,1697,0.670750988142,583,0.230434782609,55,0.0217391304348,28,0.0110671936759,130,0.0513833992095,37,0.0146245059289,601,73,65,593,666,18,0.00711462450593,601,0.237549407115,194,0.0766798418972,2336,0.923320158103,1643,0.649407114625,PBF,Moore,37125PBF
Moore,3217,2897,0.900528442648,199,0.061858874728,9,0.00279763755051,52,0.0161641280696,28,0.00870376126826,32,0.00994715573516,210,18,15,207,225,11,0.00341933478396,210,0.065278209512,90,0.0279763755051,3127,0.972023624495,2844,0.884053465962,PDN,Moore,37125PDN
Moore,4641,4315,0.929756517992,203,0.0437405731523,19,0.00409394527042,51,0.010989010989,22,0.00474035768153,31,0.00667959491489,215,31,28,212,243,12,0.00258564964447,215,0.0463262227968,66,0.0142210730446,4575,0.985778926955,4277,0.921568627451,PHA,Moore,37125PHA
Moore,2574,2394,0.93006993007,115,0.0446775446775,12,0.004662004662,33,0.0128205128205,6,0.002331002331,14,0.00543900543901,117,21,20,116,137,2,0.000777000777001,117,0.0454545454545,33,0.0128205128205,2541,0.987179487179,2367,0.91958041958,PHB1,Moore,37125PHB1
Moore,2268,2169,0.956349206349,51,0.0224867724868,7,0.00308641975309,31,0.0136684303351,4,0.00176366843034,6,0.0026455026455,52,9,8,51,60,1,0.000440917107584,52,0.0229276895944,25,0.0110229276896,2243,0.98897707231,2149,0.947530864198,PHB2,Moore,37125PHB2
Moore,3710,3363,0.906469002695,229,0.0617250673854,18,0.00485175202156,43,0.011590296496,22,0.00592991913747,35,0.00943396226415,244,24,21,241,265,15,0.00404312668464,244,0.0657681940701,82,0.022102425876,3628,0.977897574124,3310,0.89218328841,PHC,Moore,37125PHC
Moore,2065,1550,0.750605326877,156,0.0755447941889,13,0.00629539951574,20,0.00968523002421,309,0.149636803874,17,0.00823244552058,163,20,20,163,183,7,0.00338983050847,163,0.0789346246973,588,0.284745762712,1477,0.715254237288,1291,0.625181598063,RBN,Moore,37125RBN
Moore,3944,3748,0.950304259635,106,0.0268762677485,8,0.00202839756592,24,0.00608519269777,23,0.00583164300203,35,0.00887423935091,118,27,17,108,135,12,0.00304259634888,118,0.0299188640974,63,0.0159736308316,3881,0.984026369168,3711,0.940922920892,SLS,Moore,37125SLS
Moore,3272,1524,0.465770171149,1645,0.502750611247,31,0.00947432762836,26,0.00794621026895,12,0.00366748166259,34,0.010391198044,1672,47,32,1657,1704,27,0.00825183374083,1672,0.511002444988,80,0.0244498777506,3192,0.975550122249,1472,0.449877750611,SSP,Moore,37125SSP
Moore,630,231,0.366666666667,385,0.611111111111,1,0.0015873015873,5,0.00793650793651,2,0.0031746031746,6,0.00952380952381,387,3,3,387,390,2,0.0031746031746,387,0.614285714286,2,0.0031746031746,628,0.996825396825,230,0.365079365079,TLT,Moore,37125TLT
Moore,2321,1864,0.803102111159,256,0.110297285653,38,0.0163722533391,8,0.00344679017665,128,0.0551486428264,27,0.0116329168462,264,54,49,259,313,8,0.00344679017665,264,0.113744075829,227,0.0978026712624,2094,0.902197328738,1776,0.765187419216,VSS,Moore,37125VSS
Moore,4133,3055,0.739172513912,816,0.197435277038,51,0.0123397048149,60,0.0145172997822,79,0.0191144447133,72,0.0174207597387,838,79,70,829,908,22,0.00532300992015,838,0.202758286959,213,0.051536414227,3920,0.948463585773,2944,0.712315509315,WAB,Moore,37125WAB
Moore,2330,2146,0.921030042918,123,0.0527896995708,5,0.00214592274678,3,0.00128755364807,50,0.0214592274678,3,0.00128755364807,125,6,6,125,131,2,0.000858369098712,125,0.0536480686695,75,0.0321888412017,2255,0.967811158798,2122,0.910729613734,WEM,Moore,37125WEM
Moore,2363,1886,0.79813796022,379,0.16038933559,22,0.0093101988997,9,0.0038087177317,49,0.0207363520948,18,0.00761743546339,387,30,26,383,413,8,0.00338552687262,387,0.163774862463,90,0.038087177317,2273,0.961912822683,1846,0.781210325857,WND,Moore,37125WND
Nash,3255,2212,0.679569892473,663,0.203686635945,12,0.0036866359447,6,0.00184331797235,315,0.0967741935484,47,0.0144393241167,689,26,19,682,708,26,0.00798771121352,689,0.211674347158,454,0.139477726575,2801,0.860522273425,2108,0.647619047619,0001,Nash,371270001
Nash,1176,576,0.489795918367,568,0.482993197279,3,0.00255102040816,1,0.000850340136054,16,0.0136054421769,12,0.0102040816327,577,11,5,571,582,9,0.00765306122449,577,0.490646258503,28,0.0238095238095,1148,0.97619047619,570,0.484693877551,0002,Nash,371270002
Nash,1540,978,0.635064935065,487,0.316233766234,15,0.00974025974026,8,0.00519480519481,33,0.0214285714286,19,0.0123376623377,504,27,17,494,521,17,0.011038961039,504,0.327272727273,55,0.0357142857143,1485,0.964285714286,968,0.628571428571,0003,Nash,371270003
Nash,2777,2490,0.896651062297,166,0.0597767374865,8,0.00288080662586,3,0.0010803024847,94,0.0338494778538,16,0.00576161325171,171,14,14,171,185,5,0.00180050414116,171,0.0615772416277,154,0.0554555275477,2623,0.944544472452,2438,0.877925819229,0004,Nash,371270004
Nash,2684,1748,0.651266766021,683,0.254470938897,14,0.00521609538003,7,0.00260804769001,204,0.0760059612519,28,0.0104321907601,692,27,23,688,715,9,0.00335320417288,692,0.25782414307,314,0.116989567809,2370,0.883010432191,1655,0.616616989568,0005,Nash,371270005
Nash,2149,1600,0.744532340624,365,0.169846440205,10,0.0046533271289,3,0.00139599813867,141,0.0656119125174,30,0.0139599813867,380,29,21,372,401,15,0.00697999069335,380,0.176826430898,191,0.0888785481619,1958,0.911121451838,1554,0.723127035831,0006,Nash,371270006
Nash,2219,852,0.383956737269,1252,0.564218116269,50,0.0225326723749,2,0.000901306894998,36,0.01622352411,27,0.0121676430825,1272,66,54,1260,1326,20,0.00901306894998,1272,0.573231185219,48,0.0216313654799,2171,0.97836863452,845,0.380802163137,0007,Nash,371270007
Nash,2299,1459,0.634623749456,387,0.168334058286,16,0.0069595476294,2,0.000869943453676,414,0.180078294911,21,0.00913440626359,392,25,23,390,415,5,0.00217485863419,392,0.17050891692,621,0.270117442366,1678,0.729882557634,1271,0.552849064811,0008,Nash,371270008
Nash,3285,1798,0.547336377473,1290,0.392694063927,26,0.00791476407915,6,0.00182648401826,123,0.0374429223744,42,0.0127853881279,1312,52,40,1300,1352,22,0.00669710806697,1312,0.399391171994,170,0.0517503805175,3115,0.948249619482,1763,0.536681887367,0011,Nash,371270011
Nash,886,690,0.778781038375,165,0.186230248307,2,0.00225733634312,1,0.00112866817156,25,0.0282167042889,3,0.00338600451467,165,4,4,165,169,0,0.0,165,0.186230248307,29,0.0327313769752,857,0.967268623025,686,0.774266365688,0012,Nash,371270012
Nash,8013,4777,0.5961562461,3024,0.377386746537,52,0.00648945463622,29,0.00361911893174,70,0.00873580431798,61,0.0076126294771,3067,89,63,3041,3130,43,0.00536627979533,3067,0.382753026332,133,0.0165980282042,7880,0.983401971796,4731,0.590415574691,0015,Nash,371270015
Nash,844,276,0.327014218009,546,0.64691943128,1,0.00118483412322,3,0.00355450236967,13,0.0154028436019,5,0.00592417061611,551,6,1,546,552,5,0.00592417061611,551,0.652843601896,18,0.021327014218,826,0.978672985782,276,0.327014218009,0021,Nash,371270021
Nash,1061,499,0.470311027333,536,0.505183788878,11,0.0103675777568,3,0.00282752120641,0,0.0,12,0.0113100848256,539,16,16,539,555,3,0.00282752120641,539,0.508011310085,7,0.00659754948162,1054,0.993402450518,495,0.466540999057,0022,Nash,371270022
Nash,4436,3327,0.75,976,0.220018034265,15,0.00338142470694,30,0.00676284941389,64,0.014427412083,24,0.00541027953111,981,28,28,981,1009,5,0.00112714156898,981,0.221145175834,122,0.0275022542831,4314,0.972497745717,3272,0.737601442741,0025,Nash,371270025
Nash,2910,2574,0.884536082474,268,0.0920962199313,29,0.00996563573883,14,0.00481099656357,17,0.00584192439863,8,0.00274914089347,269,33,33,269,302,1,0.000343642611684,269,0.092439862543,36,0.0123711340206,2874,0.987628865979,2557,0.878694158076,0026,Nash,371270026
Nash,1473,456,0.309572301426,931,0.632043448744,17,0.0115410726409,35,0.0237610319077,7,0.00475220638153,27,0.0183299389002,945,31,23,937,968,14,0.00950441276307,945,0.641547861507,22,0.0149355057705,1451,0.985064494229,444,0.301425661914,0031,Nash,371270031
Nash,1942,818,0.421215242019,1064,0.547888774459,10,0.00514933058702,9,0.00463439752832,33,0.0169927909372,8,0.00411946446962,1070,14,12,1068,1082,6,0.00308959835221,1070,0.550978372812,49,0.0252317198764,1893,0.974768280124,803,0.413491246138,0032,Nash,371270032
Nash,2422,463,0.191164327002,1907,0.787365813377,11,0.00454170107349,17,0.00701899256813,7,0.0028901734104,17,0.00701899256813,1918,24,16,1910,1934,11,0.00454170107349,1918,0.791907514451,28,0.0115606936416,2394,0.988439306358,449,0.185383980182,0033,Nash,371270033
Nash,3864,961,0.248706004141,2789,0.721790890269,24,0.00621118012422,13,0.00336438923395,32,0.00828157349896,45,0.0116459627329,2823,40,27,2810,2850,34,0.00879917184265,2823,0.730590062112,65,0.0168219461698,3799,0.98317805383,943,0.244047619048,0034,Nash,371270034
Nash,3416,2557,0.748536299766,739,0.216334894614,10,0.00292740046838,33,0.00966042154567,52,0.0152224824356,25,0.00731850117096,754,19,14,749,768,15,0.00439110070258,754,0.220725995316,95,0.0278103044496,3321,0.97218969555,2524,0.73887587822,0035,Nash,371270035
Nash,2922,1886,0.645448323066,922,0.315537303217,16,0.00547570157426,24,0.0082135523614,40,0.0136892539357,34,0.0116358658453,941,32,22,931,963,19,0.00650239561944,941,0.322039698836,78,0.0266940451745,2844,0.973305954825,1860,0.636550308008,0036,Nash,371270036
Nash,3777,2267,0.600211808313,1261,0.333862854117,30,0.00794281175536,94,0.0248874768335,89,0.0235636748742,36,0.00953137410643,1279,46,37,1270,1316,18,0.00476568705322,1279,0.33862854117,165,0.0436854646545,3612,0.956314535346,2213,0.585914747154,0037,Nash,371270037
Nash,3234,1541,0.476499690785,1509,0.466604823748,36,0.0111317254174,61,0.0188620902907,30,0.00927643784787,57,0.0176252319109,1538,56,41,1523,1579,29,0.00896722325294,1538,0.475572047001,85,0.026283240569,3149,0.973716759431,1512,0.467532467532,0038,Nash,371270038
Nash,2447,1751,0.715570085819,560,0.228851655088,11,0.0044953003678,17,0.0069472823866,76,0.0310584389048,32,0.0130772374336,571,20,17,568,588,11,0.0044953003678,571,0.233346955456,147,0.0600735594606,2300,0.939926440539,1696,0.69309358398,0039,Nash,371270039
Nash,6575,3094,0.470570342205,2920,0.444106463878,52,0.00790874524715,136,0.0206844106464,288,0.0438022813688,85,0.012927756654,2966,80,61,2947,3027,46,0.00699619771863,2966,0.451102661597,439,0.0667680608365,6136,0.933231939163,2985,0.453992395437,0040,Nash,371270040
Nash,1299,959,0.738260200154,284,0.218629715166,6,0.00461893764434,9,0.00692840646651,27,0.0207852193995,14,0.0107775211701,293,15,9,287,302,9,0.00692840646651,293,0.225558121632,54,0.0415704387991,1245,0.958429561201,933,0.718244803695,0041,Nash,371270041
New Hanover,3965,2622,0.661286254729,1100,0.277427490542,37,0.0093316519546,20,0.00504413619168,116,0.0292559899117,70,0.0176544766709,1132,73,59,1118,1191,32,0.00807061790668,1132,0.285498108449,208,0.0524590163934,3757,0.947540983607,2553,0.643883984868,CF01,New Hanover,37129CF01
New Hanover,3653,2804,0.767588283603,647,0.177114700246,35,0.0095811661648,17,0.00465370928004,111,0.0303859841226,39,0.0106761565836,657,52,49,654,706,10,0.00273747604708,657,0.179852176293,237,0.0648781823159,3416,0.935121817684,2694,0.737476047085,CF02,New Hanover,37129CF02
New Hanover,6847,5444,0.795092741347,1111,0.162260844165,34,0.0049656783993,90,0.0131444428217,77,0.0112458010808,91,0.0132904921864,1156,64,57,1149,1213,45,0.00657222141084,1156,0.168833065576,223,0.0325690083248,6624,0.967430991675,5324,0.777566817584,CF03,New Hanover,37129CF03
New Hanover,8844,8098,0.915649027589,418,0.047263681592,52,0.00587969244686,98,0.0110809588422,93,0.0105156037992,85,0.00961103573044,439,82,75,432,514,21,0.00237449118046,439,0.0496381727725,230,0.0260063319765,8614,0.973993668024,7978,0.902080506558,FP01,New Hanover,37129FP01
New Hanover,2740,2651,0.967518248175,18,0.00656934306569,21,0.00766423357664,14,0.00510948905109,16,0.00583941605839,20,0.00729927007299,22,34,34,22,56,4,0.0014598540146,22,0.00802919708029,41,0.0149635036496,2699,0.98503649635,2630,0.959854014599,FP02,New Hanover,37129FP02
New Hanover,1720,1683,0.978488372093,12,0.00697674418605,4,0.00232558139535,7,0.00406976744186,7,0.00406976744186,7,0.00406976744186,12,10,10,12,22,0,0.0,12,0.00697674418605,23,0.0133720930233,1697,0.986627906977,1666,0.968604651163,FP03,New Hanover,37129FP03
New Hanover,4314,3947,0.914928140936,240,0.0556328233658,25,0.00579508576727,25,0.00579508576727,36,0.00834492350487,41,0.00950394065832,255,38,36,253,291,15,0.00347705146036,255,0.0591098748261,69,0.0159944367177,4245,0.984005563282,3913,0.907046824293,FP04,New Hanover,37129FP04
New Hanover,2043,1969,0.96377875673,17,0.00832109642682,13,0.00636319138522,9,0.00440528634361,10,0.00489476260401,25,0.01223690651,23,28,26,21,49,6,0.00293685756241,23,0.0112579539892,25,0.01223690651,2018,0.98776309349,1954,0.956436612824,FP05,New Hanover,37129FP05
New Hanover,2039,1526,0.748406081412,346,0.169691025012,15,0.00735654732712,27,0.0132417851888,96,0.0470819028936,29,0.0142226581658,354,23,21,352,375,8,0.0039234919078,354,0.17361451692,153,0.0750367827366,1886,0.924963217263,1483,0.727317312408,H01,New Hanover,37129H01
New Hanover,3101,2945,0.949693647211,54,0.017413737504,11,0.0035472428249,27,0.00870686875202,41,0.0132215414382,23,0.00741696227024,55,18,17,54,72,1,0.000322476620445,55,0.0177362141245,99,0.0319251854241,3002,0.968074814576,2894,0.933247339568,H02,New Hanover,37129H02
New Hanover,5486,4890,0.891359825009,163,0.029711994167,33,0.00601531170252,58,0.0105723660226,268,0.0488516223113,74,0.0134888807875,182,52,50,180,232,19,0.00346336128327,182,0.0331753554502,540,0.0984323733139,4946,0.901567626686,4658,0.849070360919,H03,New Hanover,37129H03
New Hanover,3860,3545,0.918393782383,176,0.0455958549223,17,0.00440414507772,30,0.00777202072539,60,0.0155440414508,32,0.00829015544041,190,30,26,186,216,14,0.00362694300518,190,0.0492227979275,174,0.0450777202073,3686,0.954922279793,3463,0.897150259067,H04,New Hanover,37129H04
New Hanover,3788,3497,0.923178458289,99,0.0261351636748,23,0.00607180570222,30,0.00791974656811,73,0.0192713833157,66,0.0174234424498,105,60,59,104,164,6,0.00158394931362,105,0.0277191129884,222,0.058606124604,3566,0.941393875396,3392,0.895459345301,H05,New Hanover,37129H05
New Hanover,3318,2742,0.826401446655,384,0.115732368897,22,0.00663050030139,40,0.0120554550934,92,0.0277275467149,38,0.0114526823388,397,33,28,392,425,13,0.00391802290536,397,0.119650391802,171,0.0515370705244,3147,0.948462929476,2671,0.805003013864,H06,New Hanover,37129H06
New Hanover,10091,8158,0.808443167179,1375,0.136260033693,32,0.00317114260232,189,0.0187295609949,223,0.0220989000099,114,0.0112971955208,1410,58,51,1403,1461,35,0.00346843722129,1410,0.139728470915,461,0.0456842731147,9630,0.954315726885,7968,0.789614507977,H07,New Hanover,37129H07
New Hanover,5075,4845,0.954679802956,85,0.0167487684729,16,0.00315270935961,52,0.0102463054187,31,0.00610837438424,46,0.00906403940887,95,36,33,92,128,10,0.00197044334975,95,0.0187192118227,110,0.0216748768473,4965,0.978325123153,4780,0.941871921182,H08,New Hanover,37129H08
New Hanover,6570,6179,0.940487062405,197,0.0299847792998,9,0.0013698630137,106,0.0161339421613,35,0.00532724505327,44,0.00669710806697,205,31,28,202,233,8,0.00121765601218,205,0.031202435312,104,0.0158295281583,6466,0.984170471842,6111,0.930136986301,H09,New Hanover,37129H09
New Hanover,5462,5101,0.933906993775,167,0.030574880996,19,0.00347857927499,85,0.0155620651776,26,0.00476016111315,64,0.0117173196631,190,49,36,177,226,23,0.00421091175394,190,0.0347857927499,103,0.0188575613328,5359,0.981142438667,5033,0.921457341633,M02,New Hanover,37129M02
New Hanover,4125,3344,0.810666666667,344,0.0833939393939,20,0.00484848484848,43,0.0104242424242,320,0.0775757575758,54,0.0130909090909,358,37,30,351,388,14,0.00339393939394,358,0.0867878787879,430,0.104242424242,3695,0.895757575758,3268,0.792242424242,M03,New Hanover,37129M03
New Hanover,6226,5533,0.888692579505,397,0.0637648570511,25,0.00401541920977,142,0.0228075811115,54,0.00867330549309,75,0.0120462576293,416,45,42,413,458,19,0.00305171859942,416,0.0668165756505,179,0.0287504015419,6047,0.971249598458,5415,0.869739800835,M04,New Hanover,37129M04
New Hanover,4669,4392,0.940672520882,119,0.0254872563718,7,0.00149925037481,78,0.0167059327479,20,0.00428357249946,53,0.0113514671236,132,33,27,126,159,13,0.00278432212465,132,0.0282715784965,83,0.0177768258728,4586,0.982223174127,4338,0.929106875134,M05,New Hanover,37129M05
New Hanover,2141,964,0.450256889304,1073,0.501167678655,15,0.00700607192901,10,0.00467071461934,28,0.0130780009341,51,0.0238206445586,1103,40,23,1086,1126,30,0.014012143858,1103,0.515179822513,68,0.0317608594115,2073,0.968239140589,937,0.437645959832,W03,New Hanover,37129W03
New Hanover,2300,1329,0.577826086957,881,0.383043478261,7,0.00304347826087,13,0.00565217391304,17,0.00739130434783,53,0.0230434782609,903,44,34,893,937,22,0.0095652173913,903,0.392608695652,67,0.0291304347826,2233,0.970869565217,1301,0.565652173913,W08,New Hanover,37129W08
New Hanover,1885,1563,0.829177718833,229,0.121485411141,9,0.00477453580902,27,0.0143236074271,25,0.0132625994695,32,0.016976127321,237,24,18,231,255,8,0.00424403183024,237,0.125729442971,62,0.0328912466844,1823,0.967108753316,1532,0.812732095491,W12,New Hanover,37129W12
New Hanover,3079,1785,0.579733679766,830,0.269568041572,20,0.00649561545956,48,0.015589477103,322,0.104579408899,74,0.0240337772004,861,49,33,845,894,31,0.0100682039623,861,0.279636245534,564,0.18317635596,2515,0.81682364404,1601,0.519974017538,W13,New Hanover,37129W13
New Hanover,6461,3615,0.559510911624,2478,0.383531960997,37,0.0057266676985,71,0.010989010989,128,0.0198111747408,132,0.0204302739514,2556,75,54,2535,2610,78,0.0120724346076,2556,0.395604395604,279,0.0431821699427,6182,0.956817830057,3503,0.542176133725,W15,New Hanover,37129W15
New Hanover,3113,2869,0.921619017025,113,0.0362993896563,8,0.00256986829425,76,0.0244137487954,22,0.00706713780919,25,0.00803083841953,119,16,15,118,134,6,0.00192740122069,119,0.038226790877,54,0.0173466109862,3059,0.982653389014,2835,0.910697076775,W16,New Hanover,37129W16
New Hanover,2487,2063,0.829513470044,312,0.125452352232,3,0.00120627261761,61,0.0245275432248,14,0.00562927221552,34,0.0136710896663,322,17,14,319,336,10,0.00402090872537,322,0.129473260957,57,0.0229191797346,2430,0.977080820265,2026,0.81463610776,W17,New Hanover,37129W17
New Hanover,1877,1742,0.928076718167,68,0.0362280234417,3,0.00159829515184,18,0.00958977091103,39,0.0207778369739,7,0.00372935535429,68,7,7,68,75,0,0.0,68,0.0362280234417,65,0.0346297282898,1812,0.96537027171,1721,0.916888652104,W18,New Hanover,37129W18
New Hanover,4248,3775,0.888653483992,300,0.0706214689266,10,0.00235404896422,58,0.0136534839925,48,0.0112994350282,57,0.013418079096,320,33,26,313,346,20,0.00470809792844,320,0.075329566855,130,0.0306026365348,4118,0.969397363465,3701,0.871233521657,W21,New Hanover,37129W21
New Hanover,7558,6537,0.86491135221,574,0.0759460174649,39,0.0051600952633,134,0.0177295580841,106,0.0140248743054,168,0.0222281026727,626,91,83,618,709,52,0.00688012701773,626,0.0828261444827,360,0.0476316485843,7198,0.952368351416,6321,0.836332363059,W24,New Hanover,37129W24
New Hanover,3632,1916,0.527533039648,1601,0.440803964758,11,0.00302863436123,26,0.00715859030837,19,0.00523127753304,59,0.0162444933921,1625,40,26,1611,1651,24,0.00660792951542,1625,0.447411894273,95,0.0261563876652,3537,0.973843612335,1857,0.511288546256,W25,New Hanover,37129W25
New Hanover,3312,2608,0.787439613527,477,0.14402173913,27,0.00815217391304,32,0.00966183574879,120,0.036231884058,48,0.0144927536232,495,47,40,488,535,18,0.0054347826087,495,0.149456521739,269,0.0812198067633,3043,0.918780193237,2494,0.753019323671,W26,New Hanover,37129W26
New Hanover,3182,2112,0.663733500943,972,0.305468258957,26,0.00817096165933,18,0.00565681961031,33,0.0103708359522,21,0.00659962287869,982,34,30,978,1012,10,0.00314267756128,982,0.308610936518,87,0.0273412947832,3095,0.972658705217,2081,0.653991200503,W27,New Hanover,37129W27
New Hanover,4004,3196,0.798201798202,522,0.13036963037,37,0.00924075924076,66,0.0164835164835,106,0.0264735264735,77,0.0192307692308,548,64,58,542,606,26,0.00649350649351,548,0.136863136863,297,0.0741758241758,3707,0.925824175824,3049,0.761488511489,W28,New Hanover,37129W28
New Hanover,3695,674,0.182408660352,2875,0.778078484438,20,0.00541271989175,3,0.000811907983762,51,0.013802435724,72,0.0194857916103,2920,54,35,2901,2955,45,0.0121786197564,2920,0.790257104195,123,0.0332882273342,3572,0.966711772666,632,0.171041948579,W29,New Hanover,37129W29
New Hanover,5330,3841,0.720637898687,940,0.176360225141,29,0.00544090056285,51,0.00956848030019,354,0.0664165103189,115,0.0215759849906,990,86,55,959,1045,50,0.0093808630394,990,0.18574108818,568,0.106566604128,4762,0.893433395872,3657,0.686116322702,W30,New Hanover,37129W30
New Hanover,3852,3594,0.933021806854,152,0.0394600207684,7,0.00181723779855,42,0.0109034267913,24,0.00623052959502,33,0.00856697819315,160,17,16,159,176,8,0.00207684319834,160,0.0415368639668,76,0.0197300103842,3776,0.980269989616,3543,0.919781931464,W31,New Hanover,37129W31
New Hanover,2162,2122,0.981498612396,6,0.00277520814061,4,0.00185013876041,12,0.00555041628122,6,0.00277520814061,12,0.00555041628122,8,10,10,8,18,2,0.000925069380204,8,0.00370027752081,23,0.0106382978723,2139,0.989361702128,2101,0.971785383904,WB,New Hanover,37129WB
Northampton,942,582,0.617834394904,343,0.364118895966,0,0.0,0,0.0,8,0.00849256900212,9,0.00955414012739,349,5,3,347,352,6,0.00636942675159,349,0.370488322718,16,0.0169851380042,926,0.983014861996,575,0.610403397028,CONWAY,Northampton,37131CONWAY
Northampton,692,437,0.631502890173,249,0.359826589595,0,0.0,0,0.0,4,0.00578034682081,2,0.0028901734104,251,2,0,249,251,2,0.0028901734104,251,0.362716763006,6,0.00867052023121,686,0.991329479769,436,0.630057803468,CREEKS,Northampton,37131CREEKS
Northampton,745,368,0.493959731544,355,0.476510067114,2,0.00268456375839,0,0.0,15,0.0201342281879,5,0.00671140939597,358,5,4,357,362,3,0.00402684563758,358,0.480536912752,14,0.0187919463087,731,0.981208053691,368,0.493959731544,GALATI,Northampton,37131GALATI
Northampton,1729,178,0.102949681897,1529,0.884326200116,8,0.00462695199537,2,0.00115673799884,2,0.00115673799884,10,0.00578368999422,1538,13,8,1533,1546,9,0.00520532099479,1538,0.88953152111,9,0.00520532099479,1720,0.994794679005,177,0.102371312898,GARYSB,Northampton,37131GARYSB
Northampton,3249,1131,0.34810710988,2045,0.629424438289,19,0.00584795321637,10,0.00307787011388,27,0.00831024930748,17,0.0052323791936,2056,24,21,2053,2077,11,0.00338565712527,2056,0.632810095414,48,0.0147737765466,3201,0.985226223453,1127,0.346875961834,GASTON,Northampton,37131GASTON
Northampton,859,367,0.427240977881,485,0.564610011641,1,0.0011641443539,0,0.0,3,0.0034924330617,3,0.0034924330617,488,2,1,487,489,3,0.0034924330617,488,0.568102444703,6,0.0069848661234,853,0.993015133877,366,0.426076833527,JACKSO,Northampton,37131JACKSO
Northampton,1402,961,0.68544935806,419,0.298858773181,4,0.00285306704708,4,0.00285306704708,3,0.00213980028531,11,0.00784593437946,426,8,7,425,433,7,0.00499286733238,426,0.303851640514,9,0.00641940085592,1393,0.993580599144,956,0.681883024251,LAKE-G,Northampton,37131LAKE-G
Northampton,278,199,0.715827338129,68,0.244604316547,1,0.00359712230216,4,0.0143884892086,2,0.00719424460432,4,0.0143884892086,70,4,3,69,73,2,0.00719424460432,70,0.251798561151,2,0.00719424460432,276,0.992805755396,199,0.715827338129,LASKER,Northampton,37131LASKER
Northampton,467,244,0.522483940043,216,0.462526766595,2,0.00428265524625,2,0.00428265524625,0,0.0,3,0.00642398286938,218,5,3,216,221,2,0.00428265524625,218,0.466809421842,1,0.00214132762313,466,0.997858672377,243,0.52034261242,MILWAU,Northampton,37131MILWAU
Northampton,680,425,0.625,241,0.354411764706,6,0.00882352941176,0,0.0,4,0.00588235294118,4,0.00588235294118,244,10,7,241,251,3,0.00441176470588,244,0.358823529412,7,0.0102941176471,673,0.989705882353,423,0.622058823529,NEWTOW,Northampton,37131NEWTOW
Northampton,228,109,0.478070175439,116,0.508771929825,0,0.0,0,0.0,0,0.0,3,0.0131578947368,116,2,2,116,118,0,0.0,116,0.508771929825,1,0.00438596491228,227,0.995614035088,109,0.478070175439,PENDLE,Northampton,37131PENDLE
Northampton,471,155,0.329087048832,308,0.653927813163,6,0.0127388535032,0,0.0,0,0.0,2,0.00424628450106,310,7,6,309,316,2,0.00424628450106,310,0.658174097665,0,0.0,471,1.0,155,0.329087048832,PLEASA,Northampton,37131PLEASA
Northampton,597,149,0.249581239531,403,0.675041876047,1,0.00167504187605,0,0.0,36,0.0603015075377,8,0.0134003350084,410,6,2,406,412,7,0.0117252931323,410,0.686767169179,38,0.0636515912898,559,0.93634840871,147,0.246231155779,POTECA,Northampton,37131POTECA
Northampton,816,300,0.367647058824,501,0.613970588235,8,0.00980392156863,3,0.00367647058824,2,0.00245098039216,2,0.00245098039216,501,9,9,501,510,0,0.0,501,0.613970588235,8,0.00980392156863,808,0.990196078431,296,0.362745098039,REHOBE,Northampton,37131REHOBE
Northampton,1617,436,0.269635126778,1155,0.714285714286,10,0.00618429189858,0,0.0,1,0.000618429189858,15,0.00927643784787,1164,18,11,1157,1175,9,0.00556586270872,1164,0.719851576994,17,0.0105132962276,1600,0.989486703772,431,0.266542980829,RICH-S,Northampton,37131RICH-S
Northampton,1206,416,0.344941956882,779,0.645936981758,2,0.0016583747927,1,0.000829187396352,3,0.00248756218905,5,0.00414593698176,782,6,4,780,786,3,0.00248756218905,782,0.648424543947,3,0.00248756218905,1203,0.997512437811,416,0.344941956882,SEABOA,Northampton,37131SEABOA
Northampton,530,314,0.592452830189,212,0.4,1,0.00188679245283,0,0.0,0,0.0,3,0.00566037735849,214,4,2,212,216,2,0.00377358490566,214,0.403773584906,3,0.00566037735849,527,0.994339622642,311,0.58679245283,SEVERN,Northampton,37131SEVERN
Northampton,991,484,0.48839556004,478,0.482341069627,6,0.00605449041372,4,0.00403632694248,6,0.00605449041372,13,0.0131180625631,484,16,12,480,496,6,0.00605449041372,484,0.48839556004,7,0.00706357214934,984,0.992936427851,482,0.486377396569,WOODLA,Northampton,37131WOODLA
Onslow,5739,5010,0.872974385781,309,0.0538421327757,39,0.00679560899111,132,0.0230005227392,126,0.0219550444328,123,0.0214323052797,332,81,78,329,410,23,0.00400766684091,332,0.0578497996167,385,0.0670848579892,5354,0.932915142011,4791,0.834814427601,BC21,Onslow,37133BC21
Onslow,10414,6615,0.635202611869,2373,0.227866333781,75,0.00720184367198,425,0.0408104474746,581,0.0557902823123,345,0.0331284808911,2534,160,117,2491,2651,161,0.0154599577492,2534,0.243326291531,1238,0.118878432879,9176,0.881121567121,6134,0.589014787786,BM08,Onslow,37133BM08
Onslow,2932,2569,0.87619372442,202,0.068894952251,10,0.00341064120055,36,0.012278308322,75,0.0255798090041,40,0.0136425648022,213,27,25,211,238,11,0.0037517053206,213,0.0726466575716,185,0.0630968622101,2747,0.93690313779,2478,0.845156889495,CL10,Onslow,37133CL10
Onslow,6979,5236,0.750250752257,1136,0.162774036395,55,0.00788078521278,106,0.0151884224101,255,0.0365381859865,191,0.0273678177389,1211,125,111,1197,1322,75,0.0107465252902,1211,0.173520561685,566,0.0811004441897,6413,0.91889955581,4997,0.716005158332,CR07,Onslow,37133CR07
Onslow,12767,8773,0.687162215086,2556,0.200203650035,81,0.00634448186731,486,0.0380668912039,470,0.0368136602177,401,0.03140910159,2746,212,152,2686,2898,190,0.0148821179604,2746,0.215085767996,1478,0.115767212344,11289,0.884232787656,7946,0.62238583849,EN03,Onslow,37133EN03
Onslow,3207,3040,0.947926410976,57,0.0177736202058,24,0.00748362956034,23,0.00717181166199,25,0.00779544745868,38,0.0118490801372,63,47,45,61,108,6,0.00187090739008,63,0.0196445275959,91,0.0283754287496,3116,0.97162457125,2982,0.929840972872,FS16,Onslow,37133FS16
Onslow,4291,3381,0.78792822186,634,0.147751106968,28,0.00652528548124,68,0.015847121883,86,0.0200419482638,94,0.0219063155442,662,57,51,656,713,28,0.00652528548124,662,0.154276392449,274,0.0638545793521,4017,0.936145420648,3246,0.756467024004,GB12,Onslow,37133GB12
Onslow,5784,4068,0.703319502075,1170,0.202282157676,40,0.00691562932227,181,0.0312932226833,149,0.0257607192254,176,0.030428769018,1242,79,63,1226,1305,72,0.0124481327801,1242,0.214730290456,468,0.0809128630705,5316,0.919087136929,3830,0.662171507607,HM05,Onslow,37133HM05
Onslow,2681,2181,0.813502424468,339,0.12644535621,12,0.00447594181276,21,0.00783289817232,66,0.0246176799702,62,0.0231256993659,362,44,34,352,396,23,0.00857888847445,362,0.135024244685,184,0.0686311077956,2497,0.931368892204,2079,0.77545691906,HN14,Onslow,37133HN14
Onslow,1710,1566,0.915789473684,77,0.0450292397661,14,0.00818713450292,16,0.0093567251462,13,0.00760233918129,24,0.0140350877193,87,27,21,81,108,10,0.00584795321637,87,0.0508771929825,45,0.0263157894737,1665,0.973684210526,1535,0.897660818713,HR17,Onslow,37133HR17
Onslow,3748,3160,0.843116328709,285,0.0760405549626,34,0.00907150480256,71,0.0189434364995,87,0.023212379936,111,0.0296157950907,312,72,71,311,383,27,0.00720384204909,312,0.0832443970117,237,0.0632337246531,3511,0.936766275347,3037,0.810298826041,HU20,Onslow,37133HU20
Onslow,26979,20723,0.768115942029,3495,0.129545201824,270,0.0100077838319,627,0.0232402980096,1020,0.0378071833648,844,0.0312835909411,3819,483,425,3761,4244,324,0.0120093405982,3819,0.141554542422,3624,0.134326698543,23355,0.865673301457,18646,0.691130138256,JA01,Onslow,37133JA01
Onslow,1367,1033,0.755669348939,262,0.191660570593,15,0.0109729334309,7,0.00512070226774,22,0.0160936356986,28,0.020482809071,267,27,26,266,293,5,0.00365764447696,267,0.195318215069,57,0.0416971470373,1310,0.958302852963,1010,0.738844184345,ML23,Onslow,37133ML23
Onslow,1948,1699,0.872176591376,162,0.0831622176591,8,0.0041067761807,18,0.00924024640657,20,0.0102669404517,41,0.0210472279261,174,30,27,171,201,12,0.00616016427105,174,0.0893223819302,68,0.0349075975359,1880,0.965092402464,1657,0.850616016427,MT24,Onslow,37133MT24
Onslow,11512,7775,0.675382209868,2457,0.213429464906,92,0.00799166087561,390,0.0338776928423,435,0.037786657401,363,0.031532314107,2601,194,158,2565,2759,144,0.0125086865879,2601,0.225938151494,1135,0.0985927727589,10377,0.901407227241,7235,0.628474635163,NE22,Onslow,37133NE22
Onslow,1390,1217,0.875539568345,103,0.0741007194245,14,0.010071942446,4,0.00287769784173,23,0.0165467625899,29,0.0208633093525,112,36,29,105,141,9,0.00647482014388,112,0.0805755395683,50,0.0359712230216,1340,0.964028776978,1194,0.858992805755,NM13,Onslow,37133NM13
Onslow,3380,1256,0.371597633136,1810,0.53550295858,19,0.00562130177515,78,0.0230769230769,124,0.0366863905325,93,0.0275147928994,1870,36,25,1859,1895,60,0.0177514792899,1870,0.55325443787,278,0.0822485207101,3102,0.91775147929,1155,0.341715976331,NR02,Onslow,37133NR02
Onslow,5717,4580,0.801119468253,807,0.141157949974,34,0.00594717509183,45,0.00787126115095,133,0.0232639496239,118,0.0206401959069,846,77,69,838,915,39,0.00682175966416,846,0.147979709638,361,0.0631450061221,5356,0.936854993878,4410,0.771383592793,RL09,Onslow,37133RL09
Onslow,4101,3803,0.927334796391,146,0.035601072909,14,0.00341380151183,45,0.0109729334309,34,0.00829066081444,59,0.0143867349427,158,40,37,155,195,12,0.00292611558157,158,0.0385271884906,123,0.029992684711,3978,0.970007315289,3725,0.908315045111,SF18,Onslow,37133SF18
Onslow,5001,4591,0.918016396721,143,0.0285942811438,32,0.00639872025595,81,0.0161967606479,63,0.0125974805039,91,0.0181963607279,157,55,53,155,210,14,0.00279944011198,157,0.0313937212557,198,0.0395920815837,4803,0.960407918416,4479,0.895620875825,SW19,Onslow,37133SW19
Onslow,4065,3106,0.764083640836,643,0.158179581796,36,0.00885608856089,102,0.0250922509225,116,0.0285362853629,62,0.0152521525215,670,63,51,658,721,27,0.00664206642066,670,0.164821648216,283,0.069618696187,3782,0.930381303813,2981,0.733333333333,TL06,Onslow,37133TL06
Onslow,2408,2006,0.833056478405,226,0.093853820598,11,0.00456810631229,45,0.0186877076412,61,0.0253322259136,59,0.0245016611296,241,35,29,235,270,15,0.0062292358804,241,0.100083056478,172,0.0714285714286,2236,0.928571428571,1910,0.793189368771,VR15,Onslow,37133VR15
Onslow,4714,3882,0.823504454815,485,0.102885023335,21,0.00445481544336,157,0.0333050487908,83,0.0176071277047,86,0.0182435299109,509,52,45,502,554,24,0.00509121764955,509,0.107976240984,282,0.0598218073823,4432,0.940178192618,3729,0.7910479423,WN04,Onslow,37133WN04
Orange,2220,1470,0.662162162162,241,0.108558558559,4,0.0018018018018,432,0.194594594595,38,0.0171171171171,35,0.0157657657658,253,14,13,252,266,12,0.00540540540541,253,0.113963963964,115,0.0518018018018,2105,0.948198198198,1398,0.62972972973,BC,Orange,37135BC
Orange,908,804,0.885462555066,45,0.0495594713656,4,0.00440528634361,32,0.0352422907489,7,0.00770925110132,16,0.0176211453744,50,7,6,49,56,5,0.00550660792952,50,0.0550660792952,43,0.0473568281938,865,0.952643171806,770,0.848017621145,BP,Orange,37135BP
Orange,1139,786,0.690079016681,306,0.268656716418,9,0.00790166812994,0,0.0,29,0.0254609306409,9,0.00790166812994,312,15,12,309,324,6,0.00526777875329,312,0.273924495171,59,0.0517998244074,1080,0.948200175593,764,0.670763827919,CA,Orange,37135CA
Orange,1535,1330,0.866449511401,89,0.0579804560261,2,0.00130293159609,42,0.0273615635179,46,0.0299674267101,26,0.0169381107492,97,13,9,93,106,8,0.00521172638436,97,0.0631921824104,91,0.0592833876221,1444,0.940716612378,1284,0.836482084691,CB,Orange,37135CB
Orange,2896,2267,0.782803867403,355,0.122582872928,12,0.00414364640884,176,0.060773480663,32,0.0110497237569,54,0.0186464088398,378,20,17,375,395,23,0.00794198895028,378,0.130524861878,104,0.0359116022099,2792,0.96408839779,2199,0.75932320442,CC,Orange,37135CC
Orange,2615,1667,0.637476099426,165,0.0630975143403,13,0.00497131931166,566,0.216443594646,134,0.0512428298279,70,0.0267686424474,187,44,32,175,219,22,0.00841300191205,187,0.0715105162524,351,0.134225621415,2264,0.865774378585,1489,0.569407265774,CF,Orange,37135CF
Orange,1547,1211,0.782805429864,261,0.168713639302,12,0.00775694893342,5,0.00323206205559,42,0.027149321267,16,0.0103425985779,268,21,17,264,285,7,0.00452488687783,268,0.17323852618,90,0.0581771170006,1457,0.941822882999,1172,0.757595345831,CG,Orange,37135CG
Orange,1164,978,0.840206185567,97,0.0833333333333,3,0.00257731958763,63,0.0541237113402,7,0.00601374570447,16,0.0137457044674,104,8,5,101,109,7,0.00601374570447,104,0.0893470790378,46,0.0395189003436,1118,0.960481099656,945,0.811855670103,CH,Orange,37135CH
Orange,2839,2180,0.767876012681,266,0.0936949630151,19,0.00669249735822,263,0.092638252906,40,0.0140894681226,71,0.0250088059176,293,37,31,287,324,27,0.00951039098274,293,0.103205353998,132,0.0464952448045,2707,0.953504755195,2102,0.740401549841,CO,Orange,37135CO
Orange,2630,2250,0.855513307985,290,0.110266159696,5,0.00190114068441,34,0.012927756654,16,0.00608365019011,35,0.0133079847909,299,25,21,295,320,9,0.00342205323194,299,0.113688212928,59,0.022433460076,2571,0.977566539924,2218,0.843346007605,CP,Orange,37135CP
Orange,1502,1396,0.929427430093,50,0.0332889480692,8,0.00532623169108,21,0.0139813581891,10,0.00665778961385,17,0.0113182423435,52,19,17,50,69,2,0.00133155792277,52,0.034620505992,39,0.025965379494,1463,0.974034620506,1372,0.91344873502,CS1,Orange,37135CS1
Orange,2713,2430,0.895687430888,214,0.0788794692223,7,0.002580169554,15,0.00552893475857,25,0.00921489126428,22,0.00810910431257,219,20,19,218,238,5,0.00184297825286,219,0.0807224474751,50,0.0184297825286,2663,0.981570217471,2407,0.887209730925,CW,Orange,37135CW
Orange,5071,3771,0.743640307632,1103,0.217511338986,14,0.00276079668704,45,0.00887398935121,72,0.0141983829619,66,0.0130151843818,1142,53,38,1127,1180,39,0.00769079077105,1142,0.225202129757,227,0.0447643462828,4844,0.955235653717,3627,0.715243541708,CX,Orange,37135CX
Orange,2690,2236,0.831226765799,86,0.031970260223,4,0.00148698884758,305,0.113382899628,24,0.0089219330855,35,0.0130111524164,95,12,9,92,104,9,0.00334572490706,95,0.0353159851301,94,0.0349442379182,2596,0.965055762082,2168,0.80594795539,DA,Orange,37135DA
Orange,2816,2106,0.747869318182,259,0.0919744318182,19,0.00674715909091,295,0.104758522727,80,0.0284090909091,57,0.0202414772727,276,40,33,269,309,17,0.00603693181818,276,0.0980113636364,177,0.0628551136364,2639,0.937144886364,2025,0.719105113636,DM,Orange,37135DM
Orange,2740,2234,0.815328467153,219,0.0799270072993,11,0.00401459854015,196,0.0715328467153,32,0.0116788321168,48,0.0175182481752,234,17,16,233,250,15,0.00547445255474,234,0.085401459854,123,0.0448905109489,2617,0.955109489051,2145,0.782846715328,EA,Orange,37135EA
Orange,1980,1619,0.817676767677,267,0.134848484848,9,0.00454545454545,14,0.00707070707071,51,0.0257575757576,20,0.010101010101,270,19,18,269,288,3,0.00151515151515,270,0.136363636364,106,0.0535353535354,1874,0.946464646465,1577,0.796464646465,EF,Orange,37135EF
Orange,2224,1777,0.799010791367,168,0.0755395683453,0,0.0,221,0.0993705035971,18,0.00809352517986,40,0.0179856115108,180,9,6,177,186,12,0.00539568345324,180,0.0809352517986,78,0.035071942446,2146,0.964928057554,1722,0.77428057554,EH,Orange,37135EH
Orange,3193,2524,0.790479173191,203,0.0635765737551,31,0.00970873786408,28,0.00876918258691,329,0.103037895396,78,0.0244284372064,222,70,62,214,284,19,0.0059505167554,222,0.0695270905105,518,0.162229877858,2675,0.837770122142,2389,0.748199185719,ENO,Orange,37135ENO
Orange,1793,1228,0.684885666481,214,0.119353039598,3,0.00167317345231,242,0.134969325153,83,0.0462911321807,23,0.0128276631344,221,7,6,220,227,7,0.00390407138873,221,0.123257110987,133,0.0741773563859,1660,0.925822643614,1180,0.658114891244,ES,Orange,37135ES
Orange,3996,3017,0.755005005005,603,0.150900900901,36,0.00900900900901,79,0.0197697697698,194,0.0485485485485,67,0.0167667667668,621,79,69,611,690,18,0.0045045045045,621,0.155405405405,403,0.100850850851,3593,0.899149149149,2848,0.712712712713,GB,Orange,37135GB
Orange,2315,1960,0.846652267819,83,0.0358531317495,11,0.00475161987041,196,0.0846652267819,24,0.0103671706263,41,0.0177105831533,94,24,20,90,114,11,0.00475161987041,94,0.0406047516199,94,0.0406047516199,2221,0.95939524838,1893,0.817710583153,GL,Orange,37135GL
Orange,2754,2335,0.847857661583,181,0.0657225853304,11,0.0039941902687,149,0.0541031227306,20,0.00726216412491,58,0.0210602759622,201,22,21,200,222,20,0.00726216412491,201,0.0729847494553,91,0.0330428467683,2663,0.966957153232,2270,0.824255628177,GR,Orange,37135GR
Orange,1072,773,0.721082089552,257,0.23973880597,9,0.00839552238806,4,0.00373134328358,19,0.017723880597,10,0.00932835820896,262,11,11,262,273,5,0.00466417910448,262,0.244402985075,57,0.053171641791,1015,0.946828358209,740,0.690298507463,H,Orange,37135H
Orange,2853,2163,0.758149316509,324,0.11356466877,9,0.00315457413249,239,0.0837714686295,65,0.0227830354013,53,0.018576936558,338,45,34,327,372,14,0.00490711531721,338,0.118471784087,194,0.0679985979671,2659,0.932001402033,2063,0.723098492815,HF,Orange,37135HF
Orange,1732,1548,0.89376443418,90,0.0519630484988,4,0.00230946882217,52,0.0300230946882,20,0.0115473441109,18,0.0103926096998,95,11,7,91,102,5,0.00288683602771,95,0.0548498845266,60,0.0346420323326,1672,0.965357967667,1508,0.870669745958,KM,Orange,37135KM
Orange,2883,2036,0.706208810267,410,0.142212972598,11,0.00381546999653,189,0.0655567117586,172,0.0596600763094,65,0.0225459590704,431,21,17,427,448,21,0.00728407908429,431,0.149497051682,332,0.115157821713,2551,0.884842178287,1897,0.657995143947,LC,Orange,37135LC
Orange,2706,2168,0.80118255728,288,0.106430155211,7,0.00258684405026,138,0.0509977827051,48,0.0177383592018,57,0.0210643015521,311,23,15,303,326,23,0.00849963045085,311,0.114929785661,94,0.0347376201035,2612,0.965262379897,2126,0.785661492979,LI,Orange,37135LI
Orange,3396,2239,0.659305064782,492,0.144876325088,13,0.00382803297998,534,0.157243816254,50,0.0147232037691,68,0.020023557126,517,27,23,513,540,25,0.00736160188457,517,0.152237926973,155,0.0456419316843,3241,0.954358068316,2136,0.628975265018,MF,Orange,37135MF
Orange,2002,1797,0.897602397602,34,0.016983016983,1,0.0004995004995,133,0.0664335664336,11,0.00549450549451,26,0.012987012987,40,11,10,39,50,6,0.002997002997,40,0.01998001998,65,0.0324675324675,1937,0.967532467532,1747,0.872627372627,NC,Orange,37135NC
Orange,2681,1969,0.734427452443,523,0.195076464006,6,0.00223797090638,82,0.0305856023872,52,0.0193957478553,49,0.0182767624021,534,20,17,531,551,11,0.00410294666169,534,0.199179410668,140,0.0522193211488,2541,0.947780678851,1890,0.704960835509,NS,Orange,37135NS
Orange,3351,2967,0.885407341092,206,0.0614741868099,3,0.000895255147717,32,0.00954938824232,99,0.0295434198747,44,0.0131304088332,215,31,28,212,243,9,0.00268576544315,215,0.0641599522531,162,0.0483437779767,3189,0.951656222023,2909,0.868099074903,OG,Orange,37135OG
Orange,3273,1828,0.558509013138,501,0.153070577452,25,0.00763825236786,282,0.0861594867094,536,0.163764130767,101,0.0308585395661,537,47,42,532,579,36,0.0109990834097,537,0.164069660862,958,0.292697830736,2315,0.707302169264,1461,0.446379468378,OW,Orange,37135OW
Orange,4442,3221,0.7251238181,258,0.0580819450698,16,0.0036019810896,692,0.155785682125,196,0.0441242683476,59,0.0132823052679,272,36,28,264,300,14,0.0031517334534,272,0.0612336785232,311,0.0700135074291,4131,0.929986492571,3125,0.703511931562,PA,Orange,37135PA
Orange,2044,1525,0.746086105675,273,0.133561643836,12,0.00587084148728,144,0.0704500978474,49,0.0239726027397,41,0.0200587084149,285,25,20,280,305,12,0.00587084148728,285,0.139432485323,122,0.059686888454,1922,0.940313111546,1463,0.715753424658,RF,Orange,37135RF
Orange,2455,1811,0.737678207739,449,0.182892057026,5,0.0020366598778,63,0.0256619144603,101,0.0411405295316,26,0.0105906313646,460,13,10,457,470,11,0.00448065173116,460,0.187372708758,166,0.067617107943,2289,0.932382892057,1754,0.714460285132,SJ,Orange,37135SJ
Orange,2437,2127,0.872794419368,223,0.0915059499384,7,0.00287238407879,18,0.00738613048831,25,0.0102585145671,37,0.0151826015593,233,29,21,225,254,10,0.00410340582684,233,0.0956093557653,68,0.0279031596225,2369,0.972096840378,2097,0.860484201888,SM,Orange,37135SM
Orange,1999,1389,0.694847423712,249,0.124562281141,12,0.00600300150075,110,0.0550275137569,208,0.104052026013,31,0.0155077538769,256,21,17,252,273,7,0.00350175087544,256,0.128064032016,285,0.142571285643,1714,0.857428714357,1310,0.655327663832,TH,Orange,37135TH
Orange,1410,1019,0.722695035461,332,0.235460992908,6,0.00425531914894,8,0.00567375886525,28,0.0198581560284,17,0.0120567375887,337,14,12,335,349,5,0.00354609929078,337,0.239007092199,41,0.0290780141844,1369,0.970921985816,1005,0.712765957447,TO,Orange,37135TO
Orange,1854,1469,0.792340884574,303,0.163430420712,8,0.00431499460626,3,0.00161812297735,43,0.0231930960086,28,0.0151024811219,308,24,20,304,328,5,0.00269687162891,308,0.166127292341,124,0.066882416397,1730,0.933117583603,1405,0.757820927724,WC,Orange,37135WC
Orange,3538,2568,0.725833804409,259,0.0732052006783,7,0.00197851893725,446,0.126059920859,201,0.0568117580554,57,0.0161107970605,276,20,13,269,289,17,0.0048049745619,276,0.0780101752402,318,0.0898812888638,3220,0.910118711136,2463,0.69615602035,WD,Orange,37135WD
Orange,2610,1354,0.51877394636,1094,0.419157088123,18,0.00689655172414,28,0.0107279693487,74,0.0283524904215,42,0.016091954023,1108,48,40,1100,1148,14,0.00536398467433,1108,0.424521072797,132,0.0505747126437,2478,0.949425287356,1308,0.501149425287,WH,Orange,37135WH
Orange,1814,1330,0.733186328556,133,0.0733186328556,2,0.00110253583241,182,0.10033076075,131,0.0722160970232,36,0.0198456449835,148,15,8,141,156,15,0.00826901874311,148,0.0815876515987,206,0.113561190739,1608,0.886438809261,1263,0.69625137817,WW,Orange,37135WW
Pamlico,1721,1482,0.861127251598,182,0.105752469494,7,0.00406740267286,9,0.00522951772225,33,0.0191748983149,8,0.00464846019756,184,13,13,184,197,2,0.00116211504939,184,0.106914584544,47,0.0273097036607,1674,0.972690296339,1474,0.8564787914,1AL,Pamlico,371371AL
Pamlico,1428,1255,0.878851540616,149,0.104341736695,8,0.00560224089636,5,0.00350140056022,8,0.00560224089636,3,0.00210084033613,149,11,11,149,160,0,0.0,149,0.104341736695,18,0.0126050420168,1410,0.987394957983,1248,0.873949579832,1RB,Pamlico,371371RB
Pamlico,1859,1637,0.880580957504,202,0.108660570199,4,0.00215169445939,0,0.0,5,0.00268961807423,11,0.00591715976331,209,9,7,207,216,7,0.00376546530393,209,0.112426035503,23,0.0123722431415,1836,0.987627756859,1619,0.870898332437,2OT,Pamlico,371372OT
Pamlico,608,439,0.722039473684,149,0.245065789474,2,0.00328947368421,3,0.00493421052632,6,0.00986842105263,9,0.0148026315789,152,8,6,150,158,3,0.00493421052632,152,0.25,18,0.0296052631579,590,0.970394736842,428,0.703947368421,2SW,Pamlico,371372SW
Pamlico,2105,1089,0.517339667458,966,0.45890736342,20,0.00950118764846,9,0.00427553444181,11,0.00522565320665,10,0.00475059382423,967,23,22,966,989,1,0.000475059382423,967,0.459382422803,48,0.0228028503563,2057,0.977197149644,1054,0.500712589074,3BY,Pamlico,371373BY
Pamlico,302,295,0.976821192053,2,0.00662251655629,0,0.0,1,0.00331125827815,1,0.00331125827815,3,0.00993377483444,2,2,2,2,4,0,0.0,2,0.00662251655629,3,0.00993377483444,299,0.990066225166,294,0.973509933775,4HB,Pamlico,371374HB
Pamlico,500,230,0.46,252,0.504,2,0.004,3,0.006,12,0.024,1,0.002,252,2,2,252,254,0,0.0,252,0.504,13,0.026,487,0.974,228,0.456,4VM,Pamlico,371374VM
Pamlico,2267,1881,0.829730921923,308,0.13586237318,20,0.0088222320247,16,0.00705778561976,20,0.0088222320247,22,0.00970445522717,311,27,26,310,337,3,0.00132333480371,311,0.137185707984,80,0.0352889280988,2187,0.964711071901,1828,0.806352007058,5AP,Pamlico,371375AP
Pasquotank,1684,894,0.530878859857,715,0.42458432304,4,0.00237529691211,7,0.0041567695962,38,0.0225653206651,26,0.0154394299287,727,16,10,721,737,12,0.00712589073634,727,0.431710213777,83,0.0492874109264,1601,0.950712589074,851,0.505344418052,1-A,Pasquotank,371391-A
Pasquotank,1731,1131,0.653379549393,530,0.306181398036,7,0.00404390525708,32,0.0184864240324,11,0.00635470826112,20,0.0115540150202,542,18,10,534,552,12,0.00693240901213,542,0.313113807048,35,0.0202195262854,1696,0.979780473715,1109,0.640670132871,1-B,Pasquotank,371391-B
Pasquotank,1731,1044,0.603119584055,583,0.336799537839,6,0.00346620450607,46,0.0265742345465,35,0.0202195262854,17,0.00982091276719,594,10,8,592,602,11,0.00635470826112,594,0.343154246101,105,0.0606585788562,1626,0.939341421144,979,0.56556903524,2-A,Pasquotank,371392-A
Pasquotank,1409,660,0.468417317246,641,0.454932576295,3,0.00212916962385,11,0.00780695528744,70,0.0496806245564,24,0.0170333569908,656,12,9,653,665,15,0.0106458481192,656,0.465578424414,104,0.0738112136267,1305,0.926188786373,640,0.454222853087,2-B,Pasquotank,371392-B
Pasquotank,1694,799,0.471664698937,806,0.475796930342,5,0.00295159386068,41,0.0242030696576,24,0.0141676505313,19,0.0112160566706,816,13,10,813,826,10,0.00590318772137,816,0.481700118064,61,0.0360094451004,1633,0.9639905549,771,0.455135773318,3-A,Pasquotank,371393-A
Pasquotank,1548,158,0.102067183463,1307,0.844315245478,6,0.00387596899225,6,0.00387596899225,45,0.0290697674419,26,0.0167958656331,1327,17,10,1320,1337,20,0.0129198966408,1327,0.857235142119,61,0.0394056847545,1487,0.960594315245,148,0.0956072351421,3-B,Pasquotank,371393-B
Pasquotank,1466,288,0.196452933151,1087,0.741473396999,9,0.00613915416098,19,0.0129604365621,47,0.0320600272851,16,0.0109140518417,1100,12,11,1099,1111,13,0.00886766712142,1100,0.75034106412,89,0.0607094133697,1377,0.93929058663,254,0.173260572988,4-A,Pasquotank,371394-A
Pasquotank,2840,863,0.303873239437,1875,0.660211267606,9,0.00316901408451,13,0.00457746478873,40,0.0140845070423,40,0.0140845070423,1896,20,14,1890,1910,21,0.00739436619718,1896,0.667605633803,65,0.0228873239437,2775,0.977112676056,851,0.299647887324,4-B,Pasquotank,371394-B
Pasquotank,3961,2714,0.685180509972,1079,0.272405958091,16,0.00403938399394,47,0.0118656904822,46,0.0116132289826,59,0.0148952284777,1099,41,36,1094,1135,20,0.00504922999243,1099,0.277455188084,105,0.0265084574602,3856,0.97349154254,2674,0.675082049987,MH,Pasquotank,37139MH
Pasquotank,2111,1236,0.585504500237,824,0.390336333491,4,0.00189483657035,6,0.00284225485552,10,0.00473709142586,31,0.0146849834202,836,17,16,835,852,12,0.00568450971104,836,0.396020843202,30,0.0142112742776,2081,0.985788725722,1231,0.583135954524,NEW,Pasquotank,37139NEW
Pasquotank,3729,2920,0.783051756503,655,0.175650308394,14,0.00375435773666,47,0.0126039152588,49,0.0131402520783,44,0.0117994100295,671,28,23,666,694,16,0.00429069455618,671,0.17994100295,98,0.0262805041566,3631,0.973719495843,2869,0.769375167605,NIX,Pasquotank,37139NIX
Pasquotank,6253,4457,0.712777866624,1552,0.248200863585,27,0.00431792739485,73,0.0116743962898,70,0.0111946265792,74,0.0118343195266,1579,60,49,1568,1628,27,0.00431792739485,1579,0.25251879098,179,0.0286262593955,6074,0.971373740605,4368,0.698544698545,PRO,Pasquotank,37139PRO
Pasquotank,1305,1097,0.84061302682,180,0.137931034483,0,0.0,12,0.00919540229885,8,0.00613026819923,8,0.00613026819923,182,4,4,182,186,2,0.00153256704981,182,0.139463601533,19,0.0145593869732,1286,0.985440613027,1085,0.831417624521,SAL,Pasquotank,37139SAL
Pender,3288,2798,0.85097323601,313,0.0951946472019,22,0.00669099756691,11,0.00334549878345,81,0.0246350364964,63,0.0191605839416,328,58,53,323,381,15,0.00456204379562,328,0.0997566909976,172,0.0523114355231,3116,0.947688564477,2721,0.827554744526,CF11,Pender,37141CF11
Pender,1725,707,0.409855072464,898,0.520579710145,6,0.00347826086957,2,0.00115942028986,96,0.055652173913,16,0.00927536231884,904,17,11,898,915,6,0.00347826086957,904,0.524057971014,125,0.0724637681159,1600,0.927536231884,687,0.398260869565,CL05,Pender,37141CL05
Pender,1108,777,0.701263537906,272,0.245487364621,2,0.00180505415162,3,0.00270758122744,39,0.0351985559567,15,0.0135379061372,276,9,5,272,281,4,0.00361010830325,276,0.249097472924,68,0.0613718411552,1040,0.938628158845,756,0.682310469314,CS04,Pender,37141CS04
Pender,297,173,0.582491582492,110,0.37037037037,1,0.003367003367,0,0.0,10,0.03367003367,3,0.010101010101,113,2,1,112,114,3,0.010101010101,113,0.380471380471,10,0.03367003367,287,0.96632996633,173,0.582491582492,CT03,Pender,37141CT03
Pender,1828,1135,0.620897155361,606,0.331509846827,17,0.00929978118162,2,0.00109409190372,35,0.0191466083151,33,0.0180525164114,609,41,41,609,650,3,0.00164113785558,609,0.333150984683,60,0.0328227571116,1768,0.967177242888,1118,0.611597374179,GR06,Pender,37141GR06
Pender,1739,1354,0.77860839563,324,0.186313973548,11,0.00632547441058,5,0.00287521564117,32,0.0184013801035,13,0.00747556066705,331,19,15,327,346,7,0.00402530189764,331,0.190339275446,92,0.0529039677976,1647,0.947096032202,1297,0.74583093732,LC09,Pender,37141LC09
Pender,3058,2829,0.925114453891,147,0.0480706344016,5,0.00163505559189,16,0.00523217789405,37,0.01209941138,24,0.00784826684107,152,17,16,151,168,5,0.00163505559189,152,0.0497056899935,83,0.0271419228254,2975,0.972858077175,2780,0.909090909091,LT18,Pender,37141LT18
Pender,1331,1062,0.797896318557,213,0.160030052592,3,0.0022539444027,3,0.0022539444027,38,0.0285499624343,12,0.00901577761082,216,11,11,216,227,3,0.0022539444027,216,0.162283996995,68,0.0510894064613,1263,0.948910593539,1041,0.782118707739,LU16,Pender,37141LU16
Pender,430,396,0.920930232558,19,0.0441860465116,5,0.0116279069767,1,0.00232558139535,7,0.0162790697674,2,0.0046511627907,19,7,7,19,26,0,0.0,19,0.0441860465116,8,0.0186046511628,422,0.981395348837,396,0.920930232558,MH07,Pender,37141MH07
Pender,2494,2243,0.899358460305,195,0.0781876503609,10,0.00400962309543,18,0.00721732157177,8,0.00320769847634,20,0.00801924619086,199,18,17,198,216,4,0.00160384923817,199,0.079791499599,38,0.0152365677626,2456,0.984763432237,2214,0.887730553328,MT19,Pender,37141MT19
Pender,2904,1895,0.652548209366,873,0.300619834711,31,0.0106749311295,4,0.00137741046832,72,0.0247933884298,29,0.00998622589532,888,52,41,877,929,15,0.0051652892562,888,0.305785123967,150,0.051652892562,2754,0.948347107438,1827,0.629132231405,NB01,Pender,37141NB01
Pender,496,436,0.879032258065,57,0.114919354839,0,0.0,0,0.0,1,0.00201612903226,2,0.00403225806452,57,2,2,57,59,0,0.0,57,0.114919354839,6,0.0120967741935,490,0.987903225806,431,0.868951612903,PL10,Pender,37141PL10
Pender,2711,1692,0.624123939506,554,0.204352637403,24,0.00885282183696,7,0.00258207303578,373,0.137587606049,61,0.0225009221689,569,68,58,559,627,15,0.0055330136481,569,0.209885651051,529,0.19513094799,2182,0.80486905201,1561,0.575802286979,RP20,Pender,37141RP20
Pender,3655,2383,0.651983584131,1074,0.293844049248,14,0.00383036935705,15,0.00410396716826,130,0.0355677154583,39,0.0106703146375,1091,40,32,1083,1123,17,0.0046511627907,1091,0.298495212038,221,0.0604651162791,3434,0.939534883721,2301,0.629548563611,SB02,Pender,37141SB02
Pender,3004,2756,0.917443408788,156,0.051930758988,15,0.00499334221039,26,0.008655126498,22,0.00732356857523,29,0.00965379494008,163,27,26,162,189,7,0.00233022636485,163,0.0542609853529,69,0.0229693741678,2935,0.977030625832,2716,0.904127829561,SC13,Pender,37141SC13
Pender,1599,1564,0.978111319575,15,0.0093808630394,1,0.000625390869293,11,0.00687929956223,0,0.0,8,0.00500312695435,17,6,6,17,23,2,0.00125078173859,17,0.010631644778,15,0.0093808630394,1584,0.990619136961,1549,0.968730456535,SH12,Pender,37141SH12
Pender,2905,2613,0.899483648881,222,0.0764199655766,15,0.00516351118761,11,0.00378657487091,11,0.00378657487091,33,0.0113597246127,230,38,34,226,264,8,0.00275387263339,230,0.07917383821,53,0.0182444061962,2852,0.981755593804,2571,0.885025817556,SP15,Pender,37141SP15
Pender,763,234,0.306684141547,518,0.678899082569,3,0.00393184796855,0,0.0,3,0.00393184796855,5,0.00655307994758,522,7,4,519,526,4,0.00524246395806,522,0.684141546527,10,0.0131061598952,753,0.986893840105,232,0.304062909567,UH08,Pender,37141UH08
Pender,3564,3401,0.954264870932,73,0.0204826038159,21,0.00589225589226,24,0.00673400673401,16,0.00448933782267,29,0.00813692480359,80,37,34,77,114,7,0.00196408529742,80,0.0224466891134,69,0.0193602693603,3495,0.98063973064,3351,0.940235690236,UT14,Pender,37141UT14
Pender,1429,855,0.598320503849,465,0.325402379286,3,0.00209937018894,5,0.00349895031491,75,0.0524842547236,26,0.0181945416375,477,10,7,474,484,12,0.00839748075577,477,0.333799860042,114,0.0797760671798,1315,0.92022393282,834,0.583624912526,UU17,Pender,37141UU17
Perquimans,766,609,0.795039164491,152,0.198433420366,0,0.0,1,0.00130548302872,1,0.00130548302872,3,0.00391644908616,153,2,2,153,155,1,0.00130548302872,153,0.199738903394,5,0.0065274151436,761,0.993472584856,606,0.791122715405,BELVID,Perquimans,37143BELVID
Perquimans,2971,2548,0.857623695725,365,0.122854257826,13,0.00437563110064,6,0.00201952204645,17,0.00572197913161,22,0.00740491417031,369,25,25,369,394,4,0.00134634803097,369,0.124200605857,27,0.00908784920902,2944,0.990912150791,2540,0.854930999663,BETHEL,Perquimans,37143BETHEL
Perquimans,1143,542,0.474190726159,570,0.498687664042,2,0.00174978127734,5,0.00437445319335,17,0.0148731408574,7,0.00612423447069,573,6,4,571,577,3,0.00262467191601,573,0.501312335958,25,0.0218722659668,1118,0.978127734033,536,0.468941382327,EAST-H,Perquimans,37143EAST-H
Perquimans,2400,1920,0.8,427,0.177916666667,12,0.005,9,0.00375,12,0.005,20,0.00833333333333,437,21,17,433,454,10,0.00416666666667,437,0.182083333333,34,0.0141666666667,2366,0.985833333333,1903,0.792916666667,NEW-HO,Perquimans,37143NEW-HO
Perquimans,268,210,0.783582089552,50,0.186567164179,0,0.0,1,0.00373134328358,3,0.0111940298507,4,0.0149253731343,50,1,1,50,51,0,0.0,50,0.186567164179,5,0.0186567164179,263,0.981343283582,210,0.783582089552,NICANO,Perquimans,37143NICANO
Perquimans,2058,1354,0.657920310982,665,0.323129251701,1,0.000485908649174,8,0.00388726919339,11,0.00534499514091,19,0.00923226433431,668,12,10,666,678,3,0.00145772594752,668,0.324586977648,21,0.0102040816327,2037,0.989795918367,1345,0.653547133139,PARKVI,Perquimans,37143PARKVI
Perquimans,1078,751,0.696660482375,273,0.253246753247,4,0.00371057513915,2,0.00185528756957,44,0.0408163265306,4,0.00371057513915,273,7,7,273,280,0,0.0,273,0.253246753247,63,0.0584415584416,1015,0.941558441558,739,0.685528756957,WEST-H,Perquimans,37143WEST-H
Person,2328,1524,0.654639175258,756,0.324742268041,11,0.00472508591065,3,0.00128865979381,25,0.0107388316151,9,0.00386597938144,761,16,15,760,776,5,0.00214776632302,761,0.326890034364,40,0.0171821305842,2288,0.982817869416,1509,0.648195876289,ALVI,Person,37145ALVI
Person,1251,1013,0.809752198241,194,0.155075939249,6,0.00479616306954,0,0.0,29,0.0231814548361,9,0.00719424460432,197,12,11,196,208,3,0.00239808153477,197,0.157474020783,39,0.031175059952,1212,0.968824940048,1002,0.800959232614,BFRK,Person,37145BFRK
Person,2066,1561,0.755566311713,463,0.224104549855,4,0.00193610842207,6,0.00290416263311,22,0.0106485963214,10,0.00484027105518,467,12,8,463,475,4,0.00193610842207,467,0.226040658277,40,0.0193610842207,2026,0.980638915779,1545,0.747821878025,CUCL,Person,37145CUCL
Person,5425,4529,0.834838709677,748,0.137880184332,28,0.00516129032258,18,0.00331797235023,57,0.0105069124424,45,0.00829493087558,767,57,48,758,815,19,0.00350230414747,767,0.141382488479,104,0.0191705069124,5321,0.980829493088,4487,0.827096774194,FLRI,Person,37145FLRI
Person,1178,891,0.75636672326,209,0.177419354839,66,0.0560271646859,1,0.000848896434635,4,0.00339558573854,7,0.00594227504244,212,69,68,211,280,3,0.0025466893039,212,0.179966044143,12,0.0101867572156,1166,0.989813242784,888,0.753820033956,HLWY,Person,37145HLWY
Person,819,591,0.721611721612,198,0.241758241758,0,0.0,1,0.001221001221,20,0.02442002442,9,0.010989010989,204,5,1,200,205,6,0.00732600732601,204,0.249084249084,40,0.04884004884,779,0.95115995116,571,0.697191697192,HUML,Person,37145HUML
Person,2544,2131,0.837657232704,343,0.134827044025,12,0.00471698113208,11,0.00432389937107,28,0.0110062893082,19,0.00746855345912,349,23,21,347,370,6,0.00235849056604,349,0.137185534591,47,0.0184748427673,2497,0.981525157233,2114,0.830974842767,MTTZ,Person,37145MTTZ
Person,1743,1463,0.839357429719,246,0.141135972461,7,0.00401606425703,4,0.00229489386116,12,0.00688468158348,11,0.00631095811819,248,11,11,248,259,2,0.00114744693058,248,0.142283419392,33,0.0189328743546,1710,0.981067125645,1444,0.828456683878,OLHI,Person,37145OLHI
Person,2519,1087,0.431520444621,1279,0.50774116713,9,0.00357284636761,4,0.00158793171894,116,0.0460500198491,24,0.00952759031362,1293,21,16,1288,1309,14,0.00555776101628,1293,0.513298928146,203,0.080587534736,2316,0.919412465264,1014,0.40254069075,ROX1,Person,37145ROX1
Person,2557,1669,0.65271802894,749,0.292921392257,20,0.00782166601486,30,0.0117324990223,64,0.0250293312476,25,0.00977708251858,762,31,26,757,788,13,0.00508408290966,762,0.298005475166,107,0.0418459131795,2450,0.95815408682,1632,0.638247946813,ROX2,Person,37145ROX2
Person,2684,1346,0.501490312966,1203,0.448211624441,17,0.00633383010432,6,0.00223546944858,85,0.0316691505216,27,0.0100596125186,1218,25,21,1214,1239,15,0.00558867362146,1218,0.453800298063,145,0.0540238450075,2539,0.945976154993,1299,0.483979135618,ROX3,Person,37145ROX3
Person,1808,1094,0.605088495575,662,0.366150442478,6,0.0033185840708,6,0.0033185840708,31,0.0171460176991,9,0.00497787610619,667,10,8,665,675,5,0.00276548672566,667,0.368915929204,77,0.0425884955752,1731,0.957411504425,1051,0.581305309735,ROX4,Person,37145ROX4
Person,2284,1718,0.752189141856,520,0.227670753065,6,0.00262697022767,9,0.00394045534151,24,0.0105078809107,7,0.00306479859895,522,7,7,522,529,2,0.000875656742557,522,0.228546409807,50,0.0218914185639,2234,0.978108581436,1693,0.741243432574,RX1A,Person,37145RX1A
Person,1144,673,0.588286713287,433,0.378496503497,8,0.00699300699301,3,0.00262237762238,19,0.0166083916084,8,0.00699300699301,436,13,13,436,449,3,0.00262237762238,436,0.381118881119,31,0.0270979020979,1113,0.972902097902,666,0.582167832168,WDSD,Person,37145WDSD
Pitt,3766,2132,0.566117896973,1500,0.398300584174,9,0.00238980350505,17,0.00451407328731,51,0.0135422198619,57,0.0151354221986,1519,32,26,1513,1545,19,0.00504514073287,1519,0.403345724907,111,0.0294742432289,3655,0.970525756771,2090,0.554965480616,0101,Pitt,371470101
Pitt,2982,2168,0.727028839705,670,0.224681421865,24,0.00804828973843,12,0.00402414486922,82,0.027498323273,26,0.00871898054997,684,42,36,678,720,14,0.00469483568075,684,0.229376257545,143,0.0479543930248,2839,0.952045606975,2118,0.710261569416,0200A,Pitt,371470200A
Pitt,2725,1260,0.462385321101,1376,0.50495412844,5,0.00183486238532,5,0.00183486238532,58,0.0212844036697,21,0.00770642201835,1390,12,9,1387,1399,14,0.0051376146789,1390,0.510091743119,87,0.0319266055046,2638,0.968073394495,1239,0.454678899083,0200B,Pitt,371470200B
Pitt,5622,2081,0.370152970473,2720,0.48381358947,26,0.00462468872287,45,0.00800426894344,658,0.117040199217,92,0.0163642831732,2750,45,38,2743,2788,30,0.00533617929562,2750,0.489149768766,916,0.16293134116,4706,0.83706865884,1909,0.339558875845,0301,Pitt,371470301
Pitt,1924,824,0.428274428274,1041,0.54106029106,11,0.00571725571726,5,0.00259875259875,30,0.0155925155925,13,0.00675675675676,1049,19,14,1044,1063,8,0.004158004158,1049,0.545218295218,44,0.022869022869,1880,0.977130977131,815,0.423596673597,0401,Pitt,371470401
Pitt,1569,996,0.634799235182,491,0.312938177183,10,0.006373486297,4,0.0025493945188,52,0.0331421287444,16,0.0101975780752,499,13,11,497,510,8,0.0050987890376,499,0.318036966221,80,0.050987890376,1489,0.949012109624,986,0.628425748885,0501,Pitt,371470501
Pitt,4839,4069,0.840876214094,540,0.111593304402,13,0.00268650547634,35,0.00723289935937,138,0.0285182889027,44,0.00909278776607,552,32,27,547,579,12,0.00247985120893,552,0.114073155611,219,0.0452572845629,4620,0.954742715437,4004,0.827443686712,0601,Pitt,371470601
Pitt,1986,1442,0.726082578046,460,0.231621349446,3,0.00151057401813,37,0.0186304128902,23,0.0115810674723,21,0.0105740181269,469,8,4,465,473,9,0.00453172205438,469,0.236153071501,62,0.031218529708,1924,0.968781470292,1407,0.708459214502,0701,Pitt,371470701
Pitt,2715,1507,0.555064456722,1077,0.396685082873,6,0.00220994475138,10,0.0036832412523,101,0.0372007366483,14,0.00515653775322,1081,9,8,1080,1089,4,0.00147329650092,1081,0.398158379374,162,0.0596685082873,2553,0.940331491713,1457,0.53664825046,0800A,Pitt,371470800A
Pitt,2237,1246,0.556995976755,937,0.418864550738,3,0.00134108180599,8,0.00357621814931,27,0.0120697362539,16,0.00715243629861,948,9,5,944,953,11,0.0049172999553,948,0.423781850693,55,0.0245864997765,2182,0.975413500224,1217,0.544032185963,0800B,Pitt,371470800B
Pitt,1053,689,0.654320987654,336,0.319088319088,0,0.0,0,0.0,13,0.0123456790123,15,0.014245014245,345,8,3,340,348,9,0.00854700854701,345,0.327635327635,20,0.0189933523267,1033,0.981006647673,688,0.653371320038,0901,Pitt,371470901
Pitt,3628,2366,0.652149944873,1060,0.29217199559,14,0.00385887541345,14,0.00385887541345,142,0.0391400220507,32,0.00882028665932,1069,22,20,1067,1089,9,0.00248070562293,1069,0.294652701213,266,0.0733186328556,3362,0.926681367144,2274,0.626791620728,1001,Pitt,371471001
Pitt,1516,937,0.618073878628,504,0.332453825858,4,0.00263852242744,3,0.00197889182058,56,0.0369393139842,12,0.00791556728232,509,12,8,505,517,5,0.0032981530343,509,0.335751978892,72,0.0474934036939,1444,0.952506596306,920,0.606860158311,1101,Pitt,371471101
Pitt,2843,2147,0.755188181498,578,0.203306366514,13,0.00457263454098,27,0.00949701020049,56,0.0196975026381,22,0.00773830460781,587,24,19,582,606,9,0.00316567006683,587,0.206472036581,97,0.0341188884981,2746,0.965881111502,2109,0.741822018994,1102A,Pitt,371471102A
Pitt,3758,2948,0.784459819053,589,0.156732304417,7,0.00186269292177,35,0.00931346460883,157,0.0417775412453,22,0.00585417775412,594,18,16,592,610,5,0.00133049494412,594,0.158062799361,249,0.0662586482171,3509,0.933741351783,2859,0.760777009047,1102B,Pitt,371471102B
Pitt,6035,3604,0.597183098592,1945,0.322286661143,18,0.0029826014913,65,0.0107705053853,325,0.0538525269263,78,0.0129246064623,1986,44,32,1974,2018,41,0.00679370339685,1986,0.32908036454,476,0.0788732394366,5559,0.921126760563,3489,0.578127589064,1201,Pitt,371471201
Pitt,1283,1151,0.897116134061,107,0.0833982852689,0,0.0,3,0.00233826968044,13,0.0101325019486,9,0.00701480904131,113,4,1,110,114,6,0.00467653936087,113,0.0880748246298,49,0.0381917381138,1234,0.961808261886,1115,0.869056897896,1301,Pitt,371471301
Pitt,3188,2329,0.730552070263,639,0.200439146801,16,0.00501882057716,80,0.0250941028858,83,0.026035131744,41,0.012860727729,651,31,28,648,679,12,0.00376411543287,651,0.204203262233,138,0.043287327478,3050,0.956712672522,2286,0.717063989962,1402A,Pitt,371471402A
Pitt,2978,2336,0.784419073203,461,0.154801880457,8,0.00268636668905,41,0.0137676292814,83,0.0278710543989,49,0.0164539959704,474,33,27,468,501,13,0.00436534586971,474,0.159167226326,149,0.0500335795836,2829,0.949966420416,2280,0.76561450638,1402B,Pitt,371471402B
Pitt,5688,3974,0.698663853727,1454,0.255625879044,22,0.00386779184248,66,0.0116033755274,106,0.0186357243319,66,0.0116033755274,1487,44,34,1477,1521,33,0.00580168776371,1487,0.261427566807,214,0.0376230661041,5474,0.962376933896,3892,0.684247538678,1403A,Pitt,371471403A
Pitt,4655,3295,0.707841031149,1152,0.247475832438,14,0.00300751879699,127,0.0272824919441,24,0.00515574650913,43,0.00923737916219,1168,26,17,1159,1185,16,0.00343716433942,1168,0.250912996778,104,0.0223415682062,4551,0.977658431794,3226,0.693018259936,1403B,Pitt,371471403B
Pitt,1803,259,0.1436494731,1384,0.767609539656,3,0.00166389351082,1,0.000554631170272,129,0.0715474209651,27,0.0149750415973,1395,11,8,1392,1403,11,0.00610094287299,1395,0.773710482529,165,0.0915141430948,1638,0.908485856905,245,0.135884636717,1501,Pitt,371471501
Pitt,3170,922,0.290851735016,2086,0.658044164038,17,0.00536277602524,62,0.0195583596215,24,0.00757097791798,59,0.0186119873817,2127,45,21,2103,2148,41,0.0129337539432,2127,0.670977917981,66,0.0208201892744,3104,0.979179810726,903,0.284858044164,1503,Pitt,371471503
Pitt,7468,2766,0.370380289234,4313,0.577530798072,23,0.00307980717729,212,0.028387787895,55,0.00736475629352,99,0.0132565613283,4366,51,33,4348,4399,53,0.00709694697375,4366,0.584627745046,165,0.0220942688806,7303,0.977905731119,2691,0.360337439743,1504,Pitt,371471504
Pitt,3889,1549,0.398302905631,2094,0.538441758807,21,0.00539984571869,105,0.0269992285935,78,0.0200565698123,42,0.0107996914374,2118,37,29,2110,2147,24,0.00617125224994,2118,0.544613011057,203,0.052198508614,3686,0.947801491386,1439,0.370017999486,1505A,Pitt,371471505A
Pitt,3014,379,0.125746516257,2517,0.835102853351,10,0.00331785003318,16,0.00530856005309,58,0.0192435301924,34,0.0112806901128,2541,24,14,2531,2555,24,0.00796284007963,2541,0.843065693431,120,0.0398142003981,2894,0.960185799602,355,0.117783676178,1505B,Pitt,371471505B
Pitt,2562,1287,0.502341920375,1142,0.445745511319,6,0.00234192037471,39,0.0152224824356,37,0.0144418423107,51,0.019906323185,1173,18,13,1168,1186,31,0.012099921936,1173,0.457845433255,77,0.0300546448087,2485,0.969945355191,1258,0.491022638564,1506,Pitt,371471506
Pitt,5822,4206,0.722432153899,1288,0.221229817932,24,0.00412229474407,112,0.0192373754723,79,0.0135692201992,113,0.0194091377533,1341,48,32,1325,1373,53,0.00910340089316,1341,0.230333218825,170,0.0291995877705,5652,0.970800412229,4129,0.709206458262,1507,Pitt,371471507
Pitt,3305,2463,0.745234493192,629,0.190317700454,9,0.00272314674735,114,0.0344931921331,36,0.0108925869894,54,0.0163388804841,646,15,12,643,658,17,0.00514372163389,646,0.195461422088,102,0.0308623298033,3203,0.969137670197,2408,0.728593040847,1507B,Pitt,371471507B
Pitt,2160,1824,0.844444444444,248,0.114814814815,10,0.00462962962963,27,0.0125,17,0.00787037037037,34,0.0157407407407,263,18,15,260,278,15,0.00694444444444,263,0.121759259259,46,0.0212962962963,2114,0.978703703704,1798,0.832407407407,1508A,Pitt,371471508A
Pitt,2861,2456,0.858441104509,260,0.0908773156239,15,0.00524292205523,44,0.0153792380287,22,0.00768961901433,64,0.022369800769,283,31,24,276,307,23,0.00803914715135,283,0.0989164627753,40,0.0139811254806,2821,0.986018874519,2436,0.851450541769,1508B,Pitt,371471508B
Pitt,6417,4716,0.73492286115,1319,0.205547763753,28,0.004363409693,150,0.0233754090697,109,0.0169861305906,95,0.0148044257441,1374,45,37,1366,1411,55,0.00857098332554,1374,0.214118747078,232,0.0361539660277,6185,0.963846033972,4623,0.720430107527,1509,Pitt,371471509
Pitt,2335,1916,0.820556745182,259,0.110920770878,9,0.00385438972163,57,0.0244111349036,74,0.0316916488223,20,0.00856531049251,262,19,17,260,279,3,0.00128479657388,262,0.112205567452,124,0.0531049250535,2211,0.946895074946,1873,0.802141327623,1510A,Pitt,371471510A
Pitt,2806,2350,0.83749109052,330,0.11760513186,8,0.00285103349964,79,0.028153955809,9,0.0032074126871,30,0.0106913756237,345,20,15,340,360,15,0.00534568781183,345,0.122950819672,49,0.0174625801853,2757,0.982537419815,2321,0.827156094084,1510B,Pitt,371471510B
Pitt,3116,2504,0.803594351733,423,0.135750962773,5,0.00160462130937,125,0.0401155327343,23,0.00738125802311,36,0.0115532734275,439,19,8,428,447,16,0.00513478818999,439,0.140885750963,58,0.0186136071887,3058,0.981386392811,2472,0.793324775353,1511A,Pitt,371471511A
Pitt,5468,4180,0.764447695684,1010,0.184711046086,10,0.00182882223848,126,0.0230431602048,54,0.00987564008778,88,0.0160936356986,1041,27,18,1032,1059,31,0.00566934893928,1041,0.190380395026,162,0.0296269202634,5306,0.970373079737,4105,0.750731528895,1511B,Pitt,371471511B
Pitt,4644,2570,0.553402239449,1756,0.378122308355,15,0.00322997416021,128,0.0275624461671,98,0.0211024978467,77,0.0165805340224,1801,47,27,1781,1828,45,0.00968992248062,1801,0.387812230835,194,0.041774332472,4450,0.958225667528,2486,0.535314384152,1512A,Pitt,371471512A
Pitt,2520,1595,0.632936507937,739,0.293253968254,5,0.00198412698413,107,0.0424603174603,35,0.0138888888889,39,0.0154761904762,755,21,12,746,767,16,0.00634920634921,755,0.299603174603,72,0.0285714285714,2448,0.971428571429,1562,0.619841269841,1512B,Pitt,371471512B
Polk,1704,1632,0.957746478873,20,0.0117370892019,10,0.00586854460094,3,0.00176056338028,20,0.0117370892019,19,0.0111502347418,20,25,25,20,45,0,0.0,20,0.0117370892019,52,0.0305164319249,1652,0.969483568075,1601,0.93955399061,CG05,Polk,37149CG05
Polk,2562,2417,0.943403590945,26,0.0101483216237,3,0.00117096018735,8,0.00312256049961,77,0.0300546448087,31,0.012099921936,31,20,17,28,48,5,0.00195160031226,31,0.012099921936,130,0.0507416081187,2432,0.949258391881,2373,0.926229508197,CL07,Polk,37149CL07
Polk,2695,2552,0.94693877551,53,0.0196660482375,18,0.00667903525046,17,0.00630797773655,42,0.0155844155844,13,0.00482374768089,58,28,25,55,83,5,0.00185528756957,58,0.0215213358071,93,0.0345083487941,2602,0.965491651206,2518,0.934322820037,CL08,Polk,37149CL08
Polk,2814,2468,0.877043354655,254,0.09026297086,9,0.00319829424307,9,0.00319829424307,52,0.0184790334044,22,0.00781805259417,260,20,18,258,278,6,0.00213219616205,260,0.092395167022,121,0.0429992892679,2693,0.957000710732,2407,0.855366027008,GC09,Polk,37149GC09
Polk,1616,1576,0.975247524752,19,0.0117574257426,2,0.00123762376238,3,0.00185643564356,5,0.00309405940594,11,0.00680693069307,19,10,10,19,29,0,0.0,19,0.0117574257426,22,0.0136138613861,1594,0.986386138614,1561,0.965965346535,SA04,Polk,37149SA04
Polk,3217,2896,0.900217594032,259,0.0805097917314,3,0.000932545850171,9,0.00279763755051,32,0.00994715573516,18,0.00559527510103,266,15,11,262,277,7,0.00217594031707,266,0.0826857320485,91,0.0282872241219,3126,0.971712775878,2841,0.883120920112,TR123,Polk,37149TR123
Polk,1964,1787,0.909877800407,77,0.0392057026477,4,0.0020366598778,6,0.0030549898167,66,0.0336048879837,24,0.0122199592668,80,23,23,80,103,3,0.00152749490835,80,0.040733197556,128,0.0651731160896,1836,0.93482688391,1733,0.882382892057,WO06,Polk,37149WO06
Randolph,2563,2315,0.903238392509,71,0.0277019118221,15,0.00585251658213,113,0.044088958252,36,0.0140460397971,13,0.00507218103785,75,16,16,75,91,4,0.00156067108857,75,0.0292625829107,92,0.0358954350371,2471,0.964104564963,2263,0.882949668357,01,Randolph,3715101
Randolph,2267,2098,0.925452139391,79,0.0348478164976,10,0.00441111601235,49,0.0216144684605,14,0.00617556241729,17,0.007498897221,83,17,15,81,98,4,0.00176444640494,83,0.0366122629025,44,0.0194089104543,2223,0.980591089546,2068,0.912218791354,02,Randolph,3715102
Randolph,4122,3613,0.876516254246,204,0.0494905385735,25,0.00606501698205,184,0.0446385249879,54,0.0131004366812,42,0.0101892285298,221,44,43,220,264,17,0.00412421154779,221,0.0536147501213,145,0.0351770984959,3977,0.964822901504,3538,0.858321203299,03,Randolph,3715103
Randolph,2254,2038,0.904170363798,97,0.0430346051464,10,0.00443655723159,28,0.0124223602484,70,0.0310559006211,11,0.00488021295475,97,20,20,97,117,0,0.0,97,0.0430346051464,129,0.0572315882875,2125,0.942768411713,1987,0.881543921917,04,Randolph,3715104
Randolph,2956,1674,0.566305818674,912,0.308525033829,11,0.00372124492558,51,0.0172530446549,269,0.09100135318,39,0.0131935047361,927,28,25,924,952,15,0.00507442489851,927,0.313599458728,497,0.168132611637,2459,0.831867388363,1482,0.501353179973,05,Randolph,3715105
Randolph,2319,1924,0.829667960328,188,0.0810694264769,15,0.00646830530401,15,0.00646830530401,157,0.0677015955153,20,0.00862440707201,195,24,23,194,218,7,0.0030185424752,195,0.0840879689521,259,0.111686071583,2060,0.888313928417,1828,0.788270806382,06,Randolph,3715106
Randolph,2581,1987,0.769856644711,202,0.0782642386672,17,0.00658659434328,54,0.0209221232081,277,0.107322743123,44,0.0170476559473,206,29,27,204,233,4,0.0015497869043,206,0.0798140255715,429,0.166214645486,2152,0.833785354514,1864,0.722200697404,07,Randolph,3715107
Randolph,2565,1729,0.674074074074,269,0.104873294347,16,0.00623781676413,36,0.0140350877193,471,0.183625730994,44,0.0171539961014,285,28,23,280,308,16,0.00623781676413,285,0.111111111111,779,0.303703703704,1786,0.696296296296,1457,0.568031189084,08,Randolph,3715108
Randolph,2393,1855,0.775177601337,151,0.0631007104053,21,0.00877559548684,15,0.0062682824906,314,0.131216046803,37,0.0154617634768,166,29,26,163,192,15,0.0062682824906,166,0.0693689928959,580,0.242373589636,1813,0.757626410364,1629,0.680735478479,09,Randolph,3715109
Randolph,3445,2419,0.702177068215,296,0.0859216255443,36,0.0104499274311,70,0.0203193033382,570,0.165457184325,54,0.0156748911466,310,46,42,306,352,14,0.00406386066763,310,0.0899854862119,1109,0.321915820029,2336,0.678084179971,1953,0.566908563135,10,Randolph,3715110
Randolph,2439,1962,0.80442804428,248,0.10168101681,22,0.0090200902009,28,0.0114801148011,149,0.0610906109061,30,0.0123001230012,251,31,31,251,282,3,0.00123001230012,251,0.10291102911,240,0.0984009840098,2199,0.90159901599,1890,0.774907749077,11,Randolph,3715111
Randolph,1505,1312,0.871760797342,100,0.0664451827243,4,0.00265780730897,27,0.0179401993355,48,0.0318936877076,14,0.0093023255814,105,10,6,101,111,5,0.00332225913621,105,0.0697674418605,76,0.0504983388704,1429,0.94950166113,1292,0.858471760797,12,Randolph,3715112
Randolph,3366,3240,0.96256684492,35,0.0103980986334,14,0.00415923945336,12,0.00356506238859,40,0.0118835412953,25,0.00742721330957,38,30,30,38,68,3,0.000891265597148,38,0.0112893642305,123,0.0365418894831,3243,0.963458110517,3164,0.939988116459,13,Randolph,3715113
Randolph,1102,968,0.878402903811,108,0.0980036297641,1,0.000907441016334,5,0.00453720508167,12,0.010889292196,8,0.00725952813067,111,8,5,108,116,3,0.002722323049,111,0.100725952813,19,0.0172413793103,1083,0.98275862069,963,0.87386569873,14,Randolph,3715114
Randolph,3334,2789,0.836532693461,88,0.0263947210558,19,0.00569886022795,6,0.00179964007199,404,0.121175764847,28,0.00839832033593,90,23,23,90,113,2,0.000599880023995,90,0.0269946010798,649,0.194661067786,2685,0.805338932214,2576,0.772645470906,15,Randolph,3715115
Randolph,2443,2349,0.96152271797,42,0.0171919770774,13,0.00532132623823,15,0.00613999181334,10,0.00409332787556,14,0.00573065902579,43,21,20,42,63,1,0.000409332787556,43,0.0176013098649,53,0.0216946377405,2390,0.97830536226,2309,0.945149406467,16,Randolph,3715116
Randolph,1797,1681,0.935447968837,66,0.0367278797997,8,0.00445186421814,10,0.00556483027268,20,0.0111296605454,12,0.00667779632721,71,15,14,70,85,5,0.00278241513634,71,0.039510294936,53,0.0294936004452,1744,0.970506399555,1651,0.918753478019,17,Randolph,3715117
Randolph,1960,1892,0.965306122449,13,0.00663265306122,5,0.00255102040816,25,0.0127551020408,11,0.00561224489796,14,0.00714285714286,18,12,12,18,30,5,0.00255102040816,18,0.00918367346939,24,0.0122448979592,1936,0.987755102041,1879,0.958673469388,18,Randolph,3715118
Randolph,2633,2493,0.946828712495,41,0.0155715913407,16,0.00607671857197,12,0.00455753892898,54,0.0205089251804,17,0.00645651348272,45,25,23,43,68,4,0.00151917964299,45,0.0170907709837,94,0.0357007216103,2539,0.96429927839,2463,0.935434865173,19,Randolph,3715119
Randolph,2750,2393,0.870181818182,182,0.0661818181818,18,0.00654545454545,1,0.000363636363636,124,0.0450909090909,32,0.0116363636364,193,35,30,188,223,11,0.004,193,0.0701818181818,273,0.0992727272727,2477,0.900727272727,2261,0.822181818182,20,Randolph,3715120
Randolph,4404,3913,0.88851044505,191,0.0433696639419,26,0.00590372388738,23,0.00522252497729,224,0.0508628519528,27,0.00613079019074,195,40,40,195,235,4,0.000908265213442,195,0.0442779291553,400,0.0908265213442,4004,0.909173478656,3765,0.854904632153,21,Randolph,3715121
Randolph,3012,2665,0.884794156707,184,0.0610889774236,34,0.0112881806109,15,0.00498007968127,73,0.0242363877822,41,0.0136122177955,197,60,58,195,255,13,0.0043160690571,197,0.0654050464807,179,0.0594289508632,2833,0.940571049137,2574,0.854581673307,22,Randolph,3715122
Randolph,3224,2490,0.772332506203,523,0.162220843672,19,0.00589330024814,5,0.00155086848635,139,0.0431141439206,48,0.014888337469,540,45,41,536,581,17,0.0052729528536,540,0.167493796526,277,0.0859181141439,2947,0.914081885856,2378,0.737593052109,23,Randolph,3715123
Randolph,928,910,0.980603448276,9,0.00969827586207,0,0.0,1,0.0010775862069,7,0.00754310344828,1,0.0010775862069,9,0,0,9,9,0,0.0,9,0.00969827586207,16,0.0172413793103,912,0.98275862069,901,0.970905172414,24,Randolph,3715124
Randolph,2179,2023,0.928407526388,68,0.0312069756769,15,0.00688389169344,13,0.00596603946765,39,0.0178981184029,21,0.00963744837081,72,29,28,71,100,4,0.00183570445158,72,0.0330426801285,75,0.0344194584672,2104,0.965580541533,1992,0.914180816888,25,Randolph,3715125
Randolph,2938,2799,0.952688904016,28,0.00953029271613,34,0.0115724982982,19,0.00646698434309,32,0.0108917631042,26,0.00884955752212,28,52,52,28,80,0,0.0,28,0.00953029271613,63,0.0214431586113,2875,0.978556841389,2772,0.943498978897,26,Randolph,3715126
Randolph,457,449,0.98249452954,4,0.00875273522976,0,0.0,0,0.0,2,0.00437636761488,2,0.00437636761488,6,1,0,5,6,2,0.00437636761488,6,0.0131291028446,6,0.0131291028446,451,0.986870897155,446,0.975929978118,27,Randolph,3715127
Randolph,2561,2305,0.900039047247,109,0.0425614994143,21,0.00819992190551,27,0.0105427567357,80,0.0312377977353,19,0.00741897696212,115,27,25,113,140,6,0.00234283483014,115,0.0449043342444,161,0.0628660679422,2400,0.937133932058,2231,0.871144084342,28,Randolph,3715128
Randolph,3431,3285,0.957446808511,44,0.0128242494899,32,0.00932672690178,16,0.00466336345089,25,0.00728650539201,29,0.00845234625474,51,50,49,50,100,7,0.00204022150976,51,0.0148644709997,79,0.0230253570388,3352,0.976974642961,3241,0.944622559021,29,Randolph,3715129
Randolph,2546,2400,0.942655145326,53,0.0208169677926,28,0.0109976433621,4,0.00157109190888,37,0.0145326001571,24,0.00942655145326,59,43,41,57,100,6,0.00235663786332,59,0.0231736056559,65,0.0255302435192,2481,0.974469756481,2379,0.934406912804,30,Randolph,3715130
Randolph,3409,2647,0.776474039308,493,0.144617189792,24,0.00704018773834,27,0.00792021120563,184,0.0539747726606,34,0.00997359929598,506,43,39,502,545,13,0.00381343502493,506,0.148430624817,362,0.106189498387,3047,0.893810501613,2486,0.72924611323,31,Randolph,3715131
Randolph,4274,3785,0.885587271876,124,0.0290126345344,22,0.00514740290126,29,0.0067852129153,278,0.0650444548432,36,0.00842302292934,133,40,34,127,167,9,0.00210575573234,133,0.0311183902667,452,0.105755732335,3822,0.894244267665,3630,0.849321478708,32,Randolph,3715132
Randolph,1806,1510,0.836101882614,152,0.0841638981174,17,0.0094130675526,12,0.00664451827243,91,0.0503875968992,24,0.0132890365449,155,23,23,155,178,3,0.00166112956811,155,0.0858250276855,147,0.0813953488372,1659,0.918604651163,1471,0.814507198228,33,Randolph,3715133
Randolph,2880,2655,0.921875,130,0.0451388888889,7,0.00243055555556,6,0.00208333333333,51,0.0177083333333,31,0.0107638888889,135,30,28,133,163,5,0.00173611111111,135,0.046875,135,0.046875,2745,0.953125,2583,0.896875,34,Randolph,3715134
Randolph,2193,1922,0.8764249886,186,0.0848153214774,19,0.00866393068855,3,0.00136798905609,37,0.0168718650251,26,0.0118559051528,192,30,28,190,220,6,0.00273597811218,192,0.0875512995896,96,0.0437756497948,2097,0.956224350205,1877,0.855905152759,35,Randolph,3715135
Randolph,3384,3268,0.965721040189,31,0.00916075650118,26,0.00768321513002,2,0.000591016548463,28,0.00827423167849,29,0.00856973995272,37,41,41,37,78,6,0.00177304964539,37,0.0109338061466,65,0.0192080378251,3319,0.980791962175,3239,0.957151300236,36,Randolph,3715136
Randolph,2437,2217,0.90972507181,164,0.0672958555601,10,0.00410340582684,18,0.00738613048831,14,0.00574476815757,14,0.00574476815757,167,16,15,166,182,3,0.00123102174805,167,0.0685268773082,31,0.0127205580632,2406,0.987279441937,2202,0.903569963069,37,Randolph,3715137
Randolph,4333,4186,0.966074313409,64,0.0147703669513,26,0.00600046157397,19,0.00438495268867,18,0.00415416570505,20,0.00461573967228,65,40,39,64,104,1,0.000230786983614,65,0.0150011539349,56,0.0129240710824,4277,0.987075928918,4160,0.960073851835,38,Randolph,3715138
Randolph,3703,3543,0.95679179044,65,0.0175533351337,10,0.00270051309749,26,0.00702133405347,36,0.00972184715096,23,0.00621118012422,70,22,22,70,92,5,0.00135025654874,70,0.0189035916824,68,0.0183634890629,3635,0.981636510937,3513,0.948690251148,39,Randolph,3715139
Randolph,2145,2021,0.942191142191,18,0.00839160839161,20,0.00932400932401,11,0.00512820512821,64,0.0298368298368,11,0.00512820512821,19,29,29,19,48,1,0.0004662004662,19,0.00885780885781,122,0.0568764568765,2023,0.943123543124,1973,0.919813519814,40,Randolph,3715140
Richmond,5985,3022,0.50492898914,2411,0.402840434419,129,0.0215538847118,102,0.0170426065163,272,0.0454469507101,49,0.00818713450292,2429,159,149,2419,2578,18,0.00300751879699,2429,0.405847953216,412,0.0688387635756,5573,0.931161236424,2928,0.489223057644,01,Richmond,3715301
Richmond,5470,4169,0.762157221207,944,0.172577696527,83,0.0151736745887,81,0.0148080438757,126,0.0230347349177,67,0.0122486288848,967,123,115,959,1082,23,0.00420475319927,967,0.176782449726,193,0.0352833638026,5277,0.964716636197,4116,0.752468007313,02,Richmond,3715302
Richmond,965,758,0.785492227979,162,0.167875647668,19,0.019689119171,15,0.0155440414508,7,0.00725388601036,4,0.00414507772021,162,23,23,162,185,0,0.0,162,0.167875647668,18,0.0186528497409,947,0.981347150259,751,0.778238341969,03,Richmond,3715303
Richmond,2321,1502,0.647134855666,590,0.254200775528,72,0.0310211115898,9,0.00387763894873,108,0.0465316673847,40,0.0172339508832,600,89,87,598,687,10,0.00430848772081,600,0.258509263249,196,0.0844463593279,2125,0.915553640672,1442,0.621283929341,04,Richmond,3715304
Richmond,868,638,0.735023041475,156,0.179723502304,20,0.0230414746544,9,0.0103686635945,26,0.0299539170507,19,0.0218894009217,160,33,31,158,191,4,0.00460829493088,160,0.184331797235,45,0.0518433179724,823,0.948156682028,626,0.721198156682,05,Richmond,3715305
Richmond,1591,1342,0.843494657448,176,0.110622250157,28,0.0175989943432,25,0.0157133878064,9,0.00565681961031,11,0.00691389063482,176,38,38,176,214,0,0.0,176,0.110622250157,15,0.00942803268385,1576,0.990571967316,1337,0.840351979887,06,Richmond,3715306
Richmond,1081,646,0.597594819611,365,0.337650323774,36,0.0333024976873,2,0.00185013876041,16,0.0148011100833,16,0.0148011100833,373,49,44,368,417,8,0.00740055504163,373,0.345050878816,16,0.0148011100833,1065,0.985198889917,646,0.597594819611,07,Richmond,3715307
Richmond,4411,2220,0.503287236454,1941,0.440036272954,99,0.0224438902743,30,0.006801178871,32,0.00725459079574,89,0.0201768306506,1978,159,141,1960,2119,37,0.00838812060757,1978,0.448424393562,90,0.020403536613,4321,0.979596463387,2179,0.493992291997,08,Richmond,3715308
Richmond,5936,4121,0.694238544474,1378,0.232142857143,231,0.0389150943396,42,0.00707547169811,83,0.0139824797844,81,0.0136455525606,1398,299,287,1386,1685,20,0.0033692722372,1398,0.23551212938,143,0.024090296496,5793,0.975909703504,4083,0.687836927224,09,Richmond,3715309
Richmond,1877,811,0.432072456047,921,0.490676611614,32,0.0170484816196,14,0.00745871070858,79,0.0420884389984,20,0.0106553010123,927,44,42,925,969,6,0.00319659030368,927,0.493873201918,168,0.0895045285029,1709,0.910495471497,734,0.39104954715,10,Richmond,3715310
Richmond,1069,732,0.684752104771,318,0.297474275023,7,0.00654817586529,5,0.00467726847521,1,0.000935453695042,6,0.00561272217025,319,9,9,319,328,1,0.000935453695042,319,0.298409728718,7,0.00654817586529,1062,0.993451824135,729,0.681945743686,11,Richmond,3715311
Richmond,1974,1188,0.601823708207,572,0.289766970618,23,0.0116514690983,13,0.00658561296859,149,0.0754812563323,29,0.0146909827761,582,34,29,577,611,10,0.00506585612969,582,0.294832826748,204,0.103343465046,1770,0.896656534954,1149,0.582066869301,12,Richmond,3715312
Richmond,935,573,0.612834224599,246,0.263101604278,19,0.020320855615,5,0.00534759358289,82,0.0877005347594,10,0.0106951871658,252,24,21,249,273,6,0.00641711229947,252,0.269518716578,121,0.129411764706,814,0.870588235294,545,0.582887700535,13,Richmond,3715313
Richmond,164,70,0.426829268293,91,0.55487804878,0,0.0,0,0.0,2,0.0121951219512,1,0.00609756097561,91,0,0,91,91,0,0.0,91,0.55487804878,4,0.0243902439024,160,0.975609756098,68,0.414634146341,14,Richmond,3715314
Richmond,220,179,0.813636363636,34,0.154545454545,2,0.00909090909091,0,0.0,2,0.00909090909091,3,0.0136363636364,35,4,3,34,38,1,0.00454545454545,35,0.159090909091,3,0.0136363636364,217,0.986363636364,178,0.809090909091,15,Richmond,3715315
Richmond,392,369,0.941326530612,5,0.0127551020408,5,0.0127551020408,0,0.0,11,0.0280612244898,2,0.00510204081633,5,7,7,5,12,0,0.0,5,0.0127551020408,13,0.0331632653061,379,0.966836734694,367,0.936224489796,16,Richmond,3715316
Robeson,1561,200,0.128122998078,180,0.11531069827,1153,0.738629083921,0,0.0,14,0.00896860986547,14,0.00896860986547,181,1166,1165,180,1346,1,0.000640614990391,181,0.115951313261,26,0.0166559897502,1535,0.98334401025,199,0.127482383088,01,Robeson,3715501
Robeson,4313,635,0.147229306747,1376,0.319035474148,2127,0.493160213309,7,0.00162300023186,104,0.0241131463019,64,0.0148388592627,1400,2180,2164,1384,3564,24,0.00556457222351,1400,0.324600046371,190,0.0440528634361,4123,0.955947136564,572,0.13262230466,02,Robeson,3715502
Robeson,2509,1608,0.640892785971,465,0.185332801913,378,0.150657632523,9,0.00358708648864,17,0.00677560781188,32,0.0127540852929,474,404,398,468,872,9,0.00358708648864,474,0.188919888402,48,0.0191311279394,2461,0.980868872061,1589,0.633320047828,03,Robeson,3715503
Robeson,2732,230,0.0841874084919,111,0.0406295754026,2302,0.842606149341,9,0.00329428989751,49,0.0179355783309,31,0.0113469985359,114,2330,2327,111,2441,3,0.0010980966325,114,0.0417276720351,98,0.0358711566618,2634,0.964128843338,184,0.0673499267936,04,Robeson,3715504
Robeson,3136,1039,0.33131377551,1326,0.422831632653,687,0.219068877551,2,0.000637755102041,40,0.0127551020408,42,0.0133928571429,1348,717,704,1335,2052,22,0.00701530612245,1348,0.429846938776,66,0.0210459183673,3070,0.978954081633,1016,0.323979591837,05,Robeson,3715505
Robeson,1022,218,0.213307240705,516,0.504892367906,251,0.245596868885,1,0.000978473581213,26,0.0254403131115,10,0.00978473581213,518,259,257,516,775,2,0.00195694716243,518,0.506849315068,26,0.0254403131115,996,0.974559686888,218,0.213307240705,06,Robeson,3715506
Robeson,1103,226,0.204895738894,330,0.299184043518,476,0.431550317316,3,0.00271985494107,58,0.052583862194,10,0.0090661831369,334,486,482,330,816,4,0.00362647325476,334,0.302810516772,84,0.07615593835,1019,0.92384406165,211,0.191296464189,07,Robeson,3715507
Robeson,1842,1300,0.705754614549,242,0.131378935939,231,0.125407166124,5,0.00271444082519,39,0.0211726384365,25,0.013572204126,248,252,249,245,497,6,0.00325732899023,248,0.134636264929,48,0.0260586319218,1794,0.973941368078,1292,0.701411509229,08,Robeson,3715508
Robeson,1706,758,0.444314185229,491,0.287807737397,290,0.169988276671,14,0.00820633059789,127,0.0744431418523,26,0.0152403282532,502,300,298,500,800,11,0.00644783118406,502,0.294255568581,193,0.113130128957,1513,0.886869871043,710,0.416178194607,09,Robeson,3715509
Robeson,1815,660,0.363636363636,428,0.235812672176,491,0.270523415978,7,0.00385674931129,189,0.104132231405,40,0.0220385674931,437,518,511,430,948,9,0.00495867768595,437,0.240771349862,280,0.154269972452,1535,0.845730027548,597,0.328925619835,10,Robeson,3715510
Robeson,5757,3373,0.585895431648,596,0.103526142088,1375,0.238839673441,176,0.0305714782005,138,0.0239708181344,99,0.0171964564878,621,1442,1427,606,2048,25,0.00434253951711,621,0.107868681605,232,0.0402987667188,5525,0.959701233281,3322,0.577036651034,11,Robeson,3715511
Robeson,2738,1029,0.375821767714,931,0.340029218408,347,0.126734842951,60,0.0219138056976,323,0.117969320672,48,0.0175310445581,947,369,363,941,1310,16,0.00584368151936,947,0.345872899927,455,0.166179693207,2283,0.833820306793,954,0.348429510592,12,Robeson,3715512
Robeson,2148,1210,0.563314711359,592,0.275605214153,239,0.111266294227,28,0.0130353817505,44,0.0204841713222,35,0.0162942271881,602,263,259,598,861,10,0.00465549348231,602,0.280260707635,102,0.0474860335196,2046,0.95251396648,1177,0.547951582868,13,Robeson,3715513
Robeson,1995,974,0.488220551378,593,0.297243107769,264,0.132330827068,15,0.00751879699248,110,0.0551378446115,39,0.0195488721805,605,286,284,603,889,12,0.00601503759398,605,0.303258145363,199,0.0997493734336,1796,0.900250626566,917,0.459649122807,14,Robeson,3715514
Robeson,1574,321,0.203939008895,1012,0.642947903431,179,0.113722998729,16,0.010165184244,23,0.0146124523507,23,0.0146124523507,1020,198,193,1015,1213,8,0.00508259212198,1020,0.648030495553,37,0.0235069885642,1537,0.976493011436,319,0.202668360864,15,Robeson,3715515
Robeson,1466,42,0.0286493860846,1275,0.869713506139,120,0.0818553888131,6,0.00409276944065,5,0.00341064120055,18,0.012278308322,1286,134,126,1278,1412,11,0.0075034106412,1286,0.87721691678,10,0.00682128240109,1456,0.993178717599,42,0.0286493860846,16,Robeson,3715516
Robeson,726,148,0.203856749311,233,0.320936639118,331,0.455922865014,2,0.00275482093664,1,0.00137741046832,11,0.0151515151515,239,340,336,235,575,6,0.00826446280992,239,0.329201101928,8,0.0110192837466,718,0.988980716253,147,0.202479338843,17,Robeson,3715517
Robeson,2032,1334,0.656496062992,301,0.14812992126,144,0.0708661417323,153,0.0752952755906,71,0.0349409448819,29,0.0142716535433,315,157,151,309,466,14,0.00688976377953,315,0.155019685039,118,0.0580708661417,1914,0.941929133858,1296,0.637795275591,18A,Robeson,3715518A
Robeson,3955,534,0.135018963338,1682,0.425284450063,1664,0.420733249052,12,0.00303413400759,21,0.00530973451327,42,0.0106194690265,1693,1700,1694,1687,3387,11,0.00278128950695,1693,0.42806573957,44,0.0111251580278,3911,0.988874841972,517,0.130720606827,19,Robeson,3715519
Robeson,1366,783,0.573206442167,434,0.317715959004,115,0.0841874084919,1,0.000732064421669,11,0.00805270863836,22,0.0161054172767,442,136,128,434,570,8,0.00585651537335,442,0.323572474378,23,0.0168374816984,1343,0.983162518302,774,0.566617862372,20,Robeson,3715520
Robeson,2989,1657,0.554366008699,952,0.31850117096,237,0.0792907326865,15,0.00501840080294,70,0.0234192037471,58,0.0194044831047,967,271,263,959,1230,15,0.00501840080294,967,0.323519571763,143,0.0478420876547,2846,0.952157912345,1609,0.538307126129,21,Robeson,3715521
Robeson,5244,1092,0.20823798627,1233,0.235125858124,2600,0.495804729214,143,0.0272692601068,60,0.0114416475973,116,0.022120518688,1301,2654,2628,1275,3929,68,0.0129672006102,1301,0.248093058734,124,0.023646071701,5120,0.976353928299,1065,0.203089244851,22,Robeson,3715522
Robeson,4968,526,0.105877616747,285,0.0573671497585,4002,0.805555555556,26,0.00523349436393,33,0.00664251207729,96,0.0193236714976,304,4084,4072,292,4376,19,0.00382447665056,304,0.061191626409,88,0.0177133655395,4880,0.982286634461,504,0.101449275362,23,Robeson,3715523
Robeson,1666,223,0.133853541417,212,0.12725090036,1034,0.620648259304,6,0.00360144057623,163,0.0978391356543,28,0.0168067226891,212,1056,1056,212,1268,0,0.0,212,0.12725090036,222,0.133253301321,1444,0.866746698679,173,0.103841536615,24,Robeson,3715524
Robeson,2795,548,0.196064400716,425,0.152057245081,1614,0.577459749553,11,0.00393559928444,151,0.0540250447227,46,0.016457960644,436,1649,1643,430,2079,11,0.00393559928444,436,0.155992844365,197,0.0704830053667,2598,0.929516994633,515,0.184257602862,25,Robeson,3715525
Robeson,3225,694,0.21519379845,1325,0.410852713178,747,0.231627906977,10,0.0031007751938,352,0.109147286822,97,0.0300775193798,1350,772,768,1346,2118,25,0.0077519379845,1350,0.418604651163,555,0.172093023256,2670,0.827906976744,571,0.177054263566,26,Robeson,3715526
Robeson,1156,536,0.463667820069,398,0.344290657439,170,0.147058823529,6,0.00519031141869,28,0.0242214532872,18,0.0155709342561,405,182,176,399,581,7,0.0060553633218,405,0.350346020761,50,0.0432525951557,1106,0.956747404844,525,0.454152249135,27,Robeson,3715527
Robeson,2030,336,0.165517241379,215,0.105911330049,1118,0.550738916256,2,0.000985221674877,323,0.159113300493,36,0.0177339901478,219,1136,1134,217,1353,4,0.00197044334975,219,0.107881773399,556,0.273891625616,1474,0.726108374384,163,0.0802955665025,28,Robeson,3715528
Robeson,1890,386,0.204232804233,904,0.478306878307,566,0.299470899471,1,0.000529100529101,15,0.00793650793651,18,0.00952380952381,916,582,571,905,1487,12,0.00634920634921,916,0.484656084656,26,0.0137566137566,1864,0.986243386243,385,0.203703703704,29,Robeson,3715529
Robeson,3843,882,0.229508196721,268,0.0697371844913,2244,0.583918813427,16,0.00416341399948,350,0.0910746812386,83,0.0215977101223,276,2289,2284,271,2560,8,0.00208170699974,276,0.071818891491,626,0.16289357273,3217,0.83710642727,661,0.172001040853,30,Robeson,3715530
Robeson,3783,2018,0.533439069522,1108,0.292889241343,203,0.0536611155168,21,0.00555114988105,376,0.0993920169178,57,0.01506740682,1124,234,231,1121,1355,16,0.00422944752842,1124,0.297118688871,541,0.143008194555,3242,0.856991805445,1876,0.495902722707,31,Robeson,3715531
Robeson,2757,1237,0.448676097207,594,0.215451577802,431,0.156329343489,12,0.00435255712731,428,0.155241204207,55,0.0199492201668,604,456,454,602,1058,10,0.00362713093943,604,0.219078708741,530,0.19223793979,2227,0.80776206021,1185,0.429815016322,32,Robeson,3715532
Robeson,978,166,0.169734151329,134,0.137014314928,527,0.538854805726,1,0.00102249488753,121,0.123721881391,29,0.0296523517382,135,533,532,134,667,1,0.00102249488753,135,0.138036809816,243,0.248466257669,735,0.751533742331,77,0.0787321063395,33,Robeson,3715533
Robeson,2210,187,0.0846153846154,218,0.0986425339367,1760,0.796380090498,3,0.00135746606335,14,0.00633484162896,28,0.0126696832579,221,1783,1781,219,2002,3,0.00135746606335,221,0.1,44,0.0199095022624,2166,0.980090497738,174,0.0787330316742,34,Robeson,3715534
Robeson,2749,114,0.0414696253183,26,0.00945798472172,2563,0.932339032375,3,0.00109130592943,7,0.002546380502,36,0.0130956711531,32,2590,2589,31,2621,6,0.00218261185886,32,0.0116405965806,29,0.0105492906511,2720,0.989450709349,108,0.0392870134594,35,Robeson,3715535
Robeson,1544,514,0.332901554404,573,0.371113989637,416,0.269430051813,2,0.00129533678756,22,0.0142487046632,17,0.0110103626943,577,431,429,575,1006,4,0.00259067357513,577,0.373704663212,41,0.0265544041451,1503,0.973445595855,497,0.32189119171,36,Robeson,3715536
Robeson,754,600,0.79575596817,78,0.103448275862,57,0.0755968169761,0,0.0,13,0.0172413793103,6,0.0079575596817,81,61,60,80,141,3,0.00397877984085,81,0.107427055703,29,0.0384615384615,725,0.961538461538,586,0.777188328912,37,Robeson,3715537
Robeson,638,130,0.203761755486,93,0.145768025078,390,0.611285266458,0,0.0,11,0.0172413793103,14,0.0219435736677,97,403,399,93,496,4,0.00626959247649,97,0.152037617555,12,0.0188087774295,626,0.981191222571,130,0.203761755486,38,Robeson,3715538
Robeson,2175,220,0.101149425287,418,0.192183908046,1490,0.685057471264,8,0.00367816091954,14,0.0064367816092,25,0.0114942528736,427,1511,1505,421,1932,9,0.00413793103448,427,0.19632183908,27,0.0124137931034,2148,0.987586206897,216,0.0993103448276,39,Robeson,3715539
Robeson,828,395,0.477053140097,350,0.42270531401,49,0.0591787439614,1,0.0012077294686,28,0.0338164251208,5,0.006038647343,353,50,50,353,403,3,0.0036231884058,353,0.426328502415,40,0.048309178744,788,0.951690821256,390,0.471014492754,40,Robeson,3715540
Robeson,4523,2458,0.543444616405,709,0.156754366571,1105,0.244306875967,22,0.0048640282998,162,0.0358169356622,67,0.0148131770948,720,1162,1155,713,1875,11,0.0024320141499,720,0.159186380721,214,0.0473137298253,4309,0.952686270175,2438,0.539022772496,41,Robeson,3715541
Rockingham,5088,4491,0.88266509434,419,0.0823506289308,8,0.00157232704403,17,0.00334119496855,96,0.0188679245283,57,0.0112028301887,443,43,28,428,471,24,0.00471698113208,443,0.0870676100629,182,0.0357704402516,4906,0.964229559748,4413,0.86733490566,AV,Rockingham,37157AV
Rockingham,5627,2977,0.529056335525,2372,0.421539008353,20,0.00355429180736,17,0.00302114803625,162,0.0287897636396,79,0.0140394526391,2419,61,39,2397,2458,47,0.00835258574729,2419,0.4298915941,287,0.0510040874356,5340,0.948995912564,2870,0.510040874356,CO,Rockingham,37157CO
Rockingham,2914,2161,0.741592312972,621,0.213109128346,17,0.00583390528483,8,0.00274536719286,75,0.0257378174331,32,0.0109814687714,632,34,31,629,663,11,0.00377487989019,632,0.216884008236,166,0.0569663692519,2748,0.943033630748,2088,0.716540837337,DR,Rockingham,37157DR
Rockingham,5139,4057,0.789453201012,957,0.186223000584,12,0.00233508464682,39,0.00758902510216,32,0.00622689239152,42,0.00817279626386,975,31,25,969,1000,18,0.00350262697023,975,0.189725627554,141,0.0274372446001,4998,0.9725627554,3955,0.769604981514,EC,Rockingham,37157EC
Rockingham,5454,4272,0.783278327833,948,0.173817381738,29,0.00531719838651,42,0.00770077007701,114,0.020902090209,49,0.00898423175651,967,50,47,964,1014,19,0.0034836817015,967,0.17730106344,215,0.0394206087275,5239,0.960579391272,4194,0.76897689769,ED-1,Rockingham,37157ED-1
Rockingham,2114,1800,0.85146641438,252,0.119205298013,7,0.00331125827815,18,0.0085146641438,24,0.0113528855251,13,0.00614947965941,255,16,15,254,270,3,0.00141911069063,255,0.120624408704,55,0.0260170293283,2059,0.973982970672,1768,0.83632923368,HO,Rockingham,37157HO
Rockingham,4601,4194,0.911540969354,196,0.0425994349055,23,0.00499891327972,30,0.0065203216692,104,0.0226037817866,54,0.0117365790046,204,51,50,203,254,8,0.00173875244512,204,0.0443381873506,242,0.0525972614649,4359,0.947402738535,4076,0.885894370789,HU,Rockingham,37157HU
Rockingham,2675,2415,0.902803738318,180,0.0672897196262,13,0.00485981308411,6,0.00224299065421,40,0.014953271028,21,0.00785046728972,186,27,23,182,209,6,0.00224299065421,186,0.0695327102804,70,0.0261682242991,2605,0.973831775701,2387,0.892336448598,IR,Rockingham,37157IR
Rockingham,4457,3662,0.821628898362,664,0.148979133947,20,0.00448732331164,16,0.00358985864932,56,0.0125645052726,39,0.00875028045771,678,43,37,672,715,14,0.00314112631815,678,0.152120260265,96,0.0215391518959,4361,0.978460848104,3633,0.81512227956,LI,Rockingham,37157LI
Rockingham,3827,2902,0.758296315652,809,0.211392735824,7,0.00182910896263,10,0.00261301280376,63,0.0164619806637,36,0.00940684609355,825,28,23,820,848,16,0.00418082048602,825,0.21557355631,121,0.0316174549255,3706,0.968382545074,2856,0.746276456755,LK-2,Rockingham,37157LK-2
Rockingham,4835,3895,0.805584281282,604,0.124922440538,12,0.00248190279214,10,0.00206825232678,264,0.0546018614271,50,0.0103412616339,619,40,31,610,650,15,0.00310237849018,619,0.128024819028,374,0.0773526370217,4461,0.922647362978,3803,0.786556359876,MA,Rockingham,37157MA
Rockingham,4931,3493,0.708375583046,1231,0.249645102413,11,0.00223078483066,64,0.012979111742,92,0.0186574731292,40,0.00811194483878,1248,24,21,1245,1269,17,0.00344757655648,1248,0.25309267897,142,0.0287974041777,4789,0.971202595822,3458,0.701277631312,MC,Rockingham,37157MC
Rockingham,2870,2121,0.739024390244,661,0.23031358885,15,0.00522648083624,7,0.00243902439024,45,0.0156794425087,21,0.00731707317073,673,26,23,670,696,12,0.00418118466899,673,0.234494773519,87,0.0303135888502,2783,0.96968641115,2080,0.724738675958,MD,Rockingham,37157MD
Rockingham,3613,3387,0.937448104069,108,0.0298920564628,19,0.00525878771104,20,0.00553556601162,52,0.0143924716302,27,0.00747301411569,114,33,32,113,146,6,0.00166066980349,114,0.0315527262663,92,0.0254636036535,3521,0.974536396347,3351,0.927484085248,NB,Rockingham,37157NB
Rockingham,5383,4454,0.827419654468,796,0.147872933309,11,0.00204347018391,15,0.00278655025079,54,0.0100315809028,53,0.00984581088612,810,43,35,802,845,14,0.00260078023407,810,0.150473713543,137,0.0254504922905,5246,0.974549507709,4382,0.814044213264,RC,Rockingham,37157RC
Rockingham,1522,1056,0.6938239159,393,0.258212877792,7,0.00459921156373,2,0.00131406044678,44,0.0289093298292,20,0.0131406044678,402,21,13,394,415,9,0.00591327201051,402,0.264126149803,69,0.0453350854139,1453,0.954664914586,1035,0.680026281209,RD-1,Rockingham,37157RD-1
Rockingham,4362,2756,0.631820265933,1459,0.334479596515,7,0.00160476845484,22,0.00504355800092,79,0.018110958276,39,0.00894085281981,1479,20,16,1475,1495,20,0.00458505272811,1479,0.339064649243,146,0.0334708849152,4216,0.966529115085,2704,0.61989912884,VA,Rockingham,37157VA
Rockingham,3442,2255,0.655142359094,888,0.257989540965,15,0.00435793143521,4,0.00116211504939,240,0.0697269029634,40,0.0116211504939,900,39,33,894,933,12,0.00348634514817,900,0.261475886113,427,0.124055781522,3015,0.875944218478,2091,0.607495642069,WM,Rockingham,37157WM
Rowan,2123,2022,0.952425812529,29,0.0136599152143,11,0.00518134715026,19,0.00894959962317,23,0.0108337258596,19,0.00894959962317,32,21,21,32,53,3,0.00141309467734,32,0.0150730098917,34,0.0160150730099,2089,0.98398492699,2014,0.948657560057,01,Rowan,3715901
Rowan,1644,1083,0.658759124088,452,0.274939172749,3,0.00182481751825,6,0.0036496350365,83,0.0504866180049,17,0.0103406326034,460,13,8,455,468,8,0.00486618004866,460,0.279805352798,148,0.0900243309002,1496,0.9099756691,1028,0.625304136253,02,Rowan,3715902
Rowan,2577,2429,0.942568878541,53,0.0205665502522,8,0.00310438494373,17,0.00659681800543,53,0.0205665502522,17,0.00659681800543,56,20,19,55,75,3,0.0011641443539,56,0.0217306946061,83,0.0322079937912,2494,0.967792006209,2403,0.932479627474,03,Rowan,3715903
Rowan,4115,3916,0.951640340219,84,0.0204131227217,16,0.00388821385176,15,0.00364520048603,57,0.0138517618469,27,0.00656136087485,90,28,28,90,118,6,0.00145808019441,90,0.0218712029162,177,0.0430133657351,3938,0.956986634265,3805,0.924665856622,04,Rowan,3715904
Rowan,2775,2477,0.892612612613,113,0.0407207207207,15,0.00540540540541,49,0.0176576576577,93,0.0335135135135,28,0.0100900900901,125,28,23,120,148,12,0.00432432432432,125,0.045045045045,180,0.0648648648649,2595,0.935135135135,2399,0.864504504505,05,Rowan,3715905
Rowan,1972,1614,0.81845841785,215,0.109026369168,13,0.00659229208925,26,0.0131845841785,101,0.0512170385396,3,0.00152129817444,216,15,14,215,230,1,0.000507099391481,216,0.10953346856,137,0.0694726166329,1835,0.930527383367,1579,0.800709939148,06,Rowan,3715906
Rowan,2065,1523,0.737530266344,432,0.209200968523,6,0.00290556900726,20,0.00968523002421,53,0.0256658595642,31,0.0150121065375,441,22,18,437,459,9,0.0043583535109,441,0.213559322034,92,0.0445520581114,1973,0.955447941889,1496,0.724455205811,07,Rowan,3715907
Rowan,3717,3102,0.834543987086,292,0.0785579768631,7,0.00188323917137,45,0.0121065375303,222,0.0597255851493,49,0.0131826741996,311,23,21,309,332,19,0.00511164917945,311,0.0836696260425,368,0.0990045735808,3349,0.900995426419,2968,0.798493408663,08,Rowan,3715908
Rowan,2399,2256,0.940391829929,43,0.0179241350563,2,0.000833680700292,17,0.00708628595248,69,0.0287619841601,12,0.00500208420175,45,9,9,45,54,2,0.000833680700292,45,0.0187578157566,108,0.0450187578158,2291,0.954981242184,2222,0.926219258024,09,Rowan,3715909
Rowan,2598,2479,0.954195535027,68,0.0261739799846,0,0.0,26,0.0100076982294,19,0.00731331793687,6,0.00230946882217,72,3,2,71,74,4,0.00153964588145,72,0.0277136258661,42,0.0161662817552,2556,0.983833718245,2457,0.945727482679,10,Rowan,3715910
Rowan,2576,2161,0.838897515528,280,0.108695652174,15,0.00582298136646,24,0.00931677018634,68,0.026397515528,28,0.0108695652174,284,25,24,283,308,4,0.00155279503106,284,0.110248447205,117,0.0454192546584,2459,0.954580745342,2124,0.824534161491,11,Rowan,3715911
Rowan,1781,1193,0.669848399775,483,0.271195957327,5,0.00280741156654,17,0.00954519932622,62,0.034811903425,21,0.0117911285794,491,16,14,489,505,8,0.00449185850646,491,0.275687815834,108,0.0606400898372,1673,0.939359910163,1159,0.650758001123,12,Rowan,3715912
Rowan,2347,2201,0.937792927141,52,0.022155943758,8,0.003408606732,7,0.0029825308905,51,0.0217298679165,28,0.011930123562,55,30,28,53,83,3,0.0012782275245,55,0.0234341712825,83,0.0353642948445,2264,0.964635705156,2169,0.924158500213,13,Rowan,3715913
Rowan,1952,1694,0.867827868852,205,0.105020491803,1,0.000512295081967,20,0.0102459016393,21,0.0107581967213,11,0.00563524590164,210,8,4,206,214,5,0.00256147540984,210,0.107581967213,48,0.0245901639344,1904,0.975409836066,1669,0.855020491803,14,Rowan,3715914
Rowan,3403,3040,0.893329415222,249,0.0731707317073,12,0.00352630032324,23,0.00675874228622,51,0.0149867763738,28,0.00822803408757,256,33,26,249,282,7,0.00205700852189,256,0.0752277402292,91,0.0267411107846,3312,0.973258889215,3002,0.882162797532,15,Rowan,3715915
Rowan,2705,1934,0.714972273567,357,0.131977818854,9,0.00332717190388,37,0.0136783733826,337,0.124584103512,31,0.01146025878,365,21,19,363,384,8,0.00295748613678,365,0.134935304991,469,0.173382624769,2236,0.826617375231,1844,0.681700554529,16,Rowan,3715916
Rowan,3150,2582,0.819682539683,294,0.0933333333333,12,0.00380952380952,35,0.0111111111111,183,0.0580952380952,44,0.0139682539683,307,30,28,305,335,13,0.00412698412698,307,0.0974603174603,327,0.10380952381,2823,0.89619047619,2460,0.780952380952,17,Rowan,3715917
Rowan,1194,179,0.149916247906,968,0.810720268007,9,0.00753768844221,2,0.00167504187605,16,0.0134003350084,20,0.0167504187605,985,18,11,978,996,17,0.0142378559464,985,0.824958123953,27,0.0226130653266,1167,0.977386934673,172,0.14405360134,18,Rowan,3715918
Rowan,2834,2539,0.895906845448,217,0.0765702187721,8,0.00282286520819,14,0.00494001411433,34,0.0119971771348,22,0.00776287932251,222,24,20,218,242,5,0.00176429075512,222,0.0783345095272,80,0.0282286520819,2754,0.971771347918,2498,0.881439661256,19,Rowan,3715919
Rowan,1640,1469,0.895731707317,84,0.0512195121951,13,0.00792682926829,12,0.00731707317073,53,0.0323170731707,9,0.00548780487805,86,14,14,86,100,2,0.00121951219512,86,0.0524390243902,131,0.0798780487805,1509,0.92012195122,1397,0.851829268293,20,Rowan,3715920
Rowan,2773,2239,0.807428777497,312,0.11251352326,11,0.00396682293545,24,0.00865488640462,158,0.0569780021637,29,0.0104579877389,326,23,23,326,349,14,0.00504868373603,326,0.117562206996,307,0.110710421926,2466,0.889289578074,2104,0.758745041471,21,Rowan,3715921
Rowan,891,866,0.971941638608,4,0.00448933782267,5,0.00561167227834,4,0.00448933782267,4,0.00448933782267,8,0.00897867564534,4,13,13,4,17,0,0.0,4,0.00448933782267,6,0.00673400673401,885,0.993265993266,864,0.969696969697,22,Rowan,3715922
Rowan,1771,1727,0.975155279503,13,0.00734048560136,5,0.00282326369283,1,0.000564652738566,13,0.00734048560136,12,0.00677583286279,15,13,12,14,27,2,0.00112930547713,15,0.00846979107849,25,0.0141163184641,1746,0.985883681536,1718,0.970073404856,23,Rowan,3715923
Rowan,1290,1192,0.924031007752,79,0.0612403100775,0,0.0,2,0.0015503875969,11,0.00852713178295,6,0.0046511627907,80,5,4,79,84,1,0.00077519379845,80,0.062015503876,21,0.0162790697674,1269,0.983720930233,1182,0.916279069767,24,Rowan,3715924
Rowan,3910,3778,0.966240409207,36,0.00920716112532,8,0.00204603580563,12,0.00306905370844,42,0.0107416879795,34,0.00869565217391,44,32,30,42,74,8,0.00204603580563,44,0.0112531969309,89,0.0227621483376,3821,0.977237851662,3731,0.954219948849,25,Rowan,3715925
Rowan,1831,1791,0.9781540142,18,0.00983069361005,7,0.00382304751502,4,0.00218459858001,5,0.00273074822501,6,0.00327689787002,18,11,11,18,29,0,0.0,18,0.00983069361005,25,0.0136537411251,1806,0.986346258875,1771,0.9672310213,26,Rowan,3715926
Rowan,1353,1120,0.827790096083,178,0.131559497413,3,0.00221729490022,5,0.00369549150037,39,0.0288248337029,8,0.00591278640059,183,5,5,183,188,5,0.00369549150037,183,0.135254988914,48,0.0354767184035,1305,0.964523281596,1114,0.823355506282,27,Rowan,3715927
Rowan,2596,1622,0.624807395994,797,0.307010785824,9,0.00346687211094,18,0.00693374422188,112,0.0431432973806,38,0.0146379044684,821,22,13,812,834,24,0.00924499229584,821,0.31625577812,189,0.0728043143297,2407,0.92719568567,1566,0.603235747304,28,Rowan,3715928
Rowan,1308,1164,0.889908256881,95,0.072629969419,3,0.00229357798165,2,0.00152905198777,38,0.0290519877676,6,0.0045871559633,98,6,5,97,103,3,0.00229357798165,98,0.0749235474006,118,0.0902140672783,1190,0.909785932722,1086,0.830275229358,29,Rowan,3715929
Rowan,4371,3023,0.691603752002,784,0.179363989934,22,0.00503317318691,69,0.015785861359,427,0.097689315946,46,0.0105239075726,791,40,38,789,829,7,0.00160146419584,791,0.180965454129,740,0.16929764356,3631,0.83070235644,2751,0.629375428964,30,Rowan,3715930
Rowan,1668,1498,0.898081534772,110,0.0659472422062,10,0.00599520383693,18,0.0107913669065,24,0.0143884892086,8,0.00479616306954,112,14,12,110,124,2,0.00119904076739,112,0.0671462829736,50,0.0299760191847,1618,0.970023980815,1478,0.886091127098,31,Rowan,3715931
Rowan,1638,1279,0.78083028083,249,0.152014652015,6,0.003663003663,15,0.00915750915751,80,0.04884004884,9,0.00549450549451,254,11,9,252,263,5,0.0030525030525,254,0.155067155067,105,0.0641025641026,1533,0.935897435897,1255,0.766178266178,32,Rowan,3715932
Rowan,1777,1727,0.971862689927,15,0.00844119302195,0,0.0,6,0.00337647720878,16,0.00900393922341,13,0.00731570061902,15,7,7,15,22,0,0.0,15,0.00844119302195,33,0.0185706246483,1744,0.981429375352,1713,0.963984243106,33,Rowan,3715933
Rowan,3415,2289,0.67027818448,836,0.244802342606,12,0.00351390922401,117,0.0342606149341,118,0.0345534407028,43,0.0125915080527,846,25,21,842,867,10,0.00292825768668,846,0.247730600293,249,0.0729136163982,3166,0.927086383602,2178,0.637774524158,34,Rowan,3715934
Rowan,1438,758,0.527121001391,526,0.36578581363,6,0.00417246175243,14,0.00973574408901,98,0.0681502086231,36,0.0250347705146,533,25,21,529,554,7,0.00486787204451,533,0.370653685675,161,0.111961057024,1277,0.888038942976,712,0.495132127955,35,Rowan,3715935
Rowan,3139,1641,0.522777954763,1232,0.392481682064,10,0.00318572793883,45,0.0143357757248,163,0.051927365403,48,0.0152914941064,1263,30,19,1252,1282,31,0.00987575661039,1263,0.402357438675,247,0.0786874800892,2892,0.921312519911,1566,0.498884995221,36,Rowan,3715936
Rowan,3300,1622,0.491515151515,1514,0.458787878788,12,0.00363636363636,27,0.00818181818182,85,0.0257575757576,40,0.0121212121212,1530,34,28,1524,1558,16,0.00484848484848,1530,0.463636363636,185,0.0560606060606,3115,0.943939393939,1538,0.466060606061,38,Rowan,3715938
Rowan,2596,1962,0.755778120185,501,0.192989214176,9,0.00346687211094,68,0.0261941448382,25,0.00963020030817,31,0.0119414483821,514,23,15,506,529,13,0.00500770416025,514,0.197996918336,72,0.0277349768875,2524,0.972265023112,1929,0.743066255778,39,Rowan,3715939
Rowan,2755,1801,0.653720508167,810,0.294010889292,11,0.00399274047187,24,0.00871143375681,65,0.0235934664247,44,0.0159709618875,828,32,26,822,854,18,0.0065335753176,828,0.30054446461,116,0.0421052631579,2639,0.957894736842,1759,0.638475499093,40,Rowan,3715940
Rowan,3018,1867,0.618621603711,906,0.300198807157,8,0.0026507620941,69,0.0228628230616,130,0.0430748840292,38,0.012591119947,925,26,20,919,945,19,0.00629555997349,925,0.306494367131,205,0.0679257786614,2813,0.932074221339,1810,0.599734923791,41,Rowan,3715941
Rowan,2001,90,0.0449775112444,1795,0.897051474263,4,0.00199900049975,1,0.000499750124938,97,0.0484757621189,14,0.00699650174913,1805,7,4,1802,1809,10,0.00499750124938,1805,0.902048975512,142,0.0709645177411,1859,0.929035482259,62,0.0309845077461,42,Rowan,3715942
Rowan,3106,2946,0.948486799742,63,0.0202833226014,16,0.00515132002576,13,0.00418544752093,46,0.0148100450741,22,0.00708306503542,69,25,24,68,93,6,0.00193174500966,69,0.0222150676111,96,0.0309079201545,3010,0.969092079845,2911,0.937218287186,44,Rowan,3715944
Rowan,1265,780,0.616600790514,412,0.325691699605,10,0.00790513833992,16,0.0126482213439,29,0.0229249011858,18,0.0142292490119,419,21,20,418,439,7,0.00553359683794,419,0.331225296443,37,0.0292490118577,1228,0.970750988142,774,0.61185770751,45,Rowan,3715945
Rowan,2709,2536,0.936138796604,99,0.0365448504983,11,0.00406053894426,21,0.0077519379845,32,0.0118124769288,10,0.00369139904024,102,19,17,100,119,3,0.00110741971207,102,0.0376522702104,79,0.0291620524179,2630,0.970837947582,2494,0.920634920635,46,Rowan,3715946
Rutherford,2261,2138,0.945599292349,88,0.0389208314905,3,0.00132684652808,4,0.00176912870411,10,0.00442282176028,18,0.00796107916851,89,11,11,89,100,1,0.000442282176028,89,0.0393631136665,33,0.0145953118089,2228,0.985404688191,2118,0.936753648828,03A,Rutherford,3716103A
Rutherford,2715,2445,0.900552486188,210,0.0773480662983,9,0.00331491712707,11,0.00405156537753,25,0.00920810313076,15,0.00552486187845,213,19,18,212,231,3,0.00110497237569,213,0.078453038674,52,0.019152854512,2663,0.980847145488,2419,0.890976058932,04A,Rutherford,3716104A
Rutherford,3934,3515,0.893492628368,271,0.0688866293849,18,0.0045754956787,3,0.000762582613116,77,0.0195729537367,50,0.0127097102186,280,53,49,276,329,9,0.00228774783935,280,0.0711743772242,158,0.0401626842908,3776,0.959837315709,3446,0.875953228266,05A,Rutherford,3716105A
Rutherford,2298,2082,0.906005221932,170,0.0739773716275,5,0.00217580504787,10,0.00435161009574,13,0.00565709312446,18,0.00783289817232,175,19,16,172,191,5,0.00217580504787,175,0.0761531766754,38,0.0165361183638,2260,0.983463881636,2055,0.894255874674,06A,Rutherford,3716106A
Rutherford,3990,3821,0.957644110276,100,0.0250626566416,11,0.00275689223058,2,0.000501253132832,28,0.00701754385965,28,0.00701754385965,107,29,29,107,136,7,0.00175438596491,107,0.0268170426065,83,0.0208020050125,3907,0.979197994987,3775,0.946115288221,09A,Rutherford,3716109A
Rutherford,1275,1255,0.98431372549,4,0.00313725490196,2,0.00156862745098,4,0.00313725490196,0,0.0,10,0.0078431372549,8,7,6,7,14,4,0.00313725490196,8,0.00627450980392,15,0.0117647058824,1260,0.988235294118,1243,0.974901960784,10A,Rutherford,3716110A
Rutherford,6578,6223,0.946032228641,258,0.0392216479173,13,0.00197628458498,15,0.00228032836728,30,0.00456065673457,39,0.00592885375494,274,35,28,267,302,16,0.00243235025844,274,0.0416539981757,62,0.00942535725144,6516,0.990574642749,6192,0.941319550015,11,Rutherford,3716111
Rutherford,4868,3463,0.711380443714,1158,0.237880032868,14,0.00287592440427,30,0.00616269515201,141,0.0289646672145,62,0.0127362366475,1181,51,39,1169,1220,23,0.00472473294988,1181,0.242604765818,273,0.0560805258833,4595,0.943919474117,3358,0.689811010682,13,Rutherford,3716113
Rutherford,3068,2429,0.791720990874,466,0.151890482399,8,0.0026075619296,23,0.00749674054759,103,0.0335723598435,39,0.0127118644068,481,23,21,479,502,15,0.00488917861799,481,0.156779661017,194,0.0632333767927,2874,0.936766623207,2345,0.764341590613,14,Rutherford,3716114
Rutherford,2809,2698,0.960484158063,75,0.0266998932004,7,0.00249199003204,4,0.00142399430402,6,0.00213599145603,19,0.00676397294411,81,16,14,79,95,6,0.00213599145603,81,0.0288358846565,26,0.00925596297615,2783,0.990744037024,2680,0.954076183695,16A,Rutherford,3716116A
Rutherford,2225,2041,0.917303370787,167,0.0750561797753,1,0.000449438202247,8,0.00359550561798,5,0.00224719101124,3,0.00134831460674,168,2,2,168,170,1,0.000449438202247,168,0.0755056179775,33,0.0148314606742,2192,0.985168539326,2013,0.904719101124,18,Rutherford,3716118
Rutherford,2401,2118,0.882132444815,203,0.0845481049563,5,0.00208246563932,9,0.00374843815077,55,0.0229071220325,11,0.0045814244065,203,13,13,203,216,0,0.0,203,0.0845481049563,100,0.0416493127863,2301,0.958350687214,2074,0.863806747189,19,Rutherford,3716119
Rutherford,3988,3484,0.873620862588,399,0.100050150451,14,0.00351053159478,39,0.00977933801404,22,0.00551654964895,30,0.00752256770311,414,28,23,409,437,15,0.00376128385155,414,0.103811434303,79,0.0198094282849,3909,0.980190571715,3431,0.860330992979,27,Rutherford,3716127
Rutherford,2079,1714,0.824434824435,265,0.127465127465,5,0.002405002405,17,0.00817700817701,45,0.021645021645,33,0.015873015873,271,27,21,265,292,6,0.002886002886,271,0.130351130351,83,0.039923039923,1996,0.960076960077,1683,0.809523809524,28,Rutherford,3716128
Rutherford,2423,2048,0.845233182006,280,0.115559224102,5,0.00206355757326,13,0.00536524969047,53,0.0218737102765,24,0.00990507635163,284,19,19,284,303,4,0.00165084605861,284,0.117210070161,106,0.043747420553,2317,0.956252579447,2002,0.826248452332,29,Rutherford,3716129
Rutherford,4236,3099,0.731586402266,1025,0.241973559962,13,0.00306893295562,29,0.00684608120869,31,0.00731822474032,39,0.00920679886686,1033,35,34,1032,1067,8,0.00188857412653,1033,0.243862134089,100,0.0236071765817,4136,0.976392823418,3043,0.718366383381,30,Rutherford,3716130
Rutherford,1438,1404,0.97635605007,14,0.00973574408901,5,0.00347705146036,3,0.00208623087622,3,0.00208623087622,9,0.00625869262865,15,10,10,15,25,1,0.000695410292072,15,0.0104311543811,9,0.00625869262865,1429,0.993741307371,1398,0.972183588317,34,Rutherford,3716134
Sampson,1998,1648,0.824824824825,175,0.0875875875876,25,0.0125125125125,1,0.000500500500501,134,0.0670670670671,15,0.00750750750751,179,33,30,176,209,4,0.002002002002,179,0.0895895895896,187,0.0935935935936,1811,0.906406406406,1604,0.802802802803,AUTR,Sampson,37163AUTR
Sampson,1230,171,0.139024390244,914,0.743089430894,18,0.0146341463415,12,0.00975609756098,79,0.0642276422764,36,0.0292682926829,931,35,23,919,954,17,0.0138211382114,931,0.756910569106,114,0.0926829268293,1116,0.907317073171,152,0.123577235772,CLCE,Sampson,37163CLCE
Sampson,3034,1120,0.369149637442,1620,0.533948582729,18,0.00593276203032,8,0.00263678312459,235,0.0774555042848,33,0.0108767303889,1638,28,21,1631,1659,18,0.00593276203032,1638,0.539881344759,351,0.115688859591,2683,0.884311140409,1035,0.341133816744,CLEA,Sampson,37163CLEA
Sampson,1824,1227,0.672697368421,243,0.133223684211,74,0.0405701754386,14,0.00767543859649,241,0.132127192982,25,0.0137061403509,246,83,82,245,328,3,0.00164473684211,246,0.134868421053,320,0.175438596491,1504,0.824561403509,1174,0.643640350877,CLEM,Sampson,37163CLEM
Sampson,2443,1816,0.743348342202,393,0.16086778551,26,0.0106426524765,36,0.014735980352,140,0.0573065902579,32,0.0130986492018,406,39,33,400,439,13,0.00532132623823,406,0.166189111748,200,0.0818665575113,2243,0.918133442489,1769,0.724109701187,CLNE,Sampson,37163CLNE
Sampson,2251,1310,0.581963571746,537,0.238560639716,176,0.0781874722346,20,0.00888494002665,180,0.0799644602399,28,0.0124389160373,545,199,192,538,737,8,0.00355397601066,545,0.242114615726,253,0.112394491337,1998,0.887605508663,1247,0.553976010662,CLSW,Sampson,37163CLSW
Sampson,2708,1671,0.6170605613,776,0.286558345643,45,0.0166174298375,19,0.00701624815362,183,0.0675775480059,14,0.00516986706056,784,53,47,778,831,8,0.00295420974889,784,0.289512555391,231,0.0853028064993,2477,0.914697193501,1607,0.593426883309,CLWE,Sampson,37163CLWE
Sampson,1491,721,0.483568075117,618,0.414486921529,8,0.00536552649229,4,0.00268276324614,118,0.0791415157612,22,0.0147551978538,633,26,13,620,646,15,0.010060362173,633,0.424547283702,147,0.0985915492958,1344,0.901408450704,696,0.466800804829,GARL,Sampson,37163GARL
Sampson,1841,785,0.426398696361,576,0.312873438349,26,0.0141227593699,1,0.000543183052689,422,0.229223248235,31,0.0168386746334,582,39,34,577,616,6,0.00325909831613,582,0.316132536665,580,0.315046170559,1261,0.684953829441,674,0.366105377512,GIDD,Sampson,37163GIDD
Sampson,2008,696,0.346613545817,1142,0.568725099602,14,0.00697211155378,4,0.00199203187251,131,0.0652390438247,21,0.0104581673307,1158,22,15,1151,1173,16,0.00796812749004,1158,0.576693227092,175,0.0871513944223,1833,0.912848605578,660,0.328685258964,HARR,Sampson,37163HARR
Sampson,823,726,0.882138517618,49,0.0595382746051,14,0.0170109356015,1,0.00121506682868,29,0.0352369380316,4,0.0048602673147,49,18,18,49,67,0,0.0,49,0.0595382746051,42,0.0510328068044,781,0.948967193196,713,0.866342648846,HERR,Sampson,37163HERR
Sampson,1722,734,0.4262485482,543,0.315331010453,6,0.00348432055749,13,0.0075493612079,399,0.231707317073,27,0.0156794425087,554,21,15,548,569,11,0.00638792102207,554,0.321718931475,527,0.306039488966,1195,0.693960511034,638,0.37049941928,INGO,Sampson,37163INGO
Sampson,1601,1180,0.737039350406,221,0.138038725796,21,0.0131168019988,9,0.00562148657089,150,0.0936914428482,20,0.0124921923798,226,29,27,224,253,5,0.00312304809494,226,0.141161773891,214,0.133666458463,1387,0.866333541537,1131,0.706433479076,KEEN,Sampson,37163KEEN
Sampson,2083,1226,0.588574171867,492,0.236197791647,215,0.103216514642,9,0.00432069131061,111,0.0532885261642,30,0.0144023043687,505,233,227,499,732,13,0.00624099855977,505,0.242438790206,186,0.0892942870859,1897,0.910705712914,1167,0.560249639942,KFRK,Sampson,37163KFRK
Sampson,3233,1429,0.442004330343,1557,0.481596040829,31,0.00958861738324,6,0.00185586142901,182,0.0562944633467,28,0.00866068666873,1572,44,37,1565,1609,15,0.00463965357253,1572,0.486235694401,252,0.0779461800186,2981,0.922053819981,1378,0.426229508197,LAKE,Sampson,37163LAKE
Sampson,2875,1986,0.690782608696,495,0.172173913043,58,0.0201739130435,5,0.00173913043478,300,0.104347826087,31,0.0107826086957,505,68,65,502,570,10,0.00347826086957,505,0.175652173913,435,0.151304347826,2440,0.848695652174,1887,0.656347826087,MING,Sampson,37163MING
Sampson,1962,1315,0.670234454638,335,0.170744138634,17,0.00866462793068,4,0.00203873598369,274,0.139653414883,17,0.00866462793068,338,20,19,337,357,3,0.00152905198777,338,0.172273190622,378,0.192660550459,1584,0.807339449541,1227,0.625382262997,NGRV,Sampson,37163NGRV
Sampson,3050,2426,0.795409836066,348,0.114098360656,45,0.0147540983607,22,0.0072131147541,179,0.0586885245902,30,0.00983606557377,355,58,56,353,411,7,0.00229508196721,355,0.116393442623,248,0.0813114754098,2802,0.91868852459,2368,0.776393442623,PLVW,Sampson,37163PLVW
Sampson,1987,1559,0.784599899346,254,0.127830900856,27,0.0135883241067,11,0.00553598389532,106,0.0533467539004,30,0.0150981378963,262,48,46,260,308,8,0.00402617010569,262,0.131857070961,143,0.0719677906392,1844,0.928032209361,1531,0.770508303976,ROSE,Sampson,37163ROSE
Sampson,2318,1225,0.528472821398,574,0.247627264884,33,0.0142364106989,4,0.00172562553926,445,0.191975841242,37,0.0159620362381,584,39,35,580,619,10,0.00431406384814,584,0.251941328732,572,0.246764452114,1746,0.753235547886,1131,0.487920621225,ROWA,Sampson,37163ROWA
Sampson,1126,814,0.722912966252,167,0.148312611012,26,0.0230905861456,1,0.00088809946714,101,0.0896980461812,17,0.0150976909414,174,37,32,169,206,7,0.00621669626998,174,0.154529307282,133,0.11811722913,993,0.88188277087,789,0.700710479574,SBRG,Sampson,37163SBRG
Sampson,1625,810,0.498461538462,593,0.364923076923,5,0.00307692307692,9,0.00553846153846,189,0.116307692308,19,0.0116923076923,597,11,10,596,607,4,0.00246153846154,597,0.367384615385,240,0.147692307692,1385,0.852307692308,777,0.478153846154,TURK,Sampson,37163TURK
Sampson,1921,1494,0.777719937533,187,0.0973451327434,26,0.0135346173868,10,0.00520562207184,180,0.0937011972931,24,0.0124934929724,191,37,36,190,227,4,0.00208224882874,191,0.0994273815721,255,0.132743362832,1666,0.867256637168,1436,0.747527329516,WBRK,Sampson,37163WBRK
Scotland,3286,756,0.2300669507,2221,0.675897748022,227,0.0690809494827,7,0.00213024954352,36,0.0109555690809,39,0.011868533171,2235,264,250,2221,2485,14,0.00426049908704,2235,0.680158247109,51,0.0155203895313,3235,0.984479610469,743,0.226110772976,1,Scotland,371651
Scotland,2671,1471,0.550730063647,779,0.291651067016,323,0.120928491202,25,0.0093597903407,30,0.0112317484088,43,0.016098839386,785,359,357,783,1142,6,0.00224634968177,785,0.293897416698,44,0.0164732309996,2627,0.983526769,1463,0.547734930738,10,Scotland,3716510
Scotland,2189,634,0.289629968022,1332,0.608497030608,155,0.0708085883965,12,0.0054819552307,25,0.011420740064,31,0.0141617176793,1345,179,170,1336,1515,13,0.00593878483326,1345,0.614435815441,40,0.0182731841023,2149,0.981726815898,631,0.288259479214,2,Scotland,371652
Scotland,3372,2112,0.626334519573,990,0.29359430605,155,0.0459667852906,51,0.0151245551601,22,0.00652431791222,42,0.0124555160142,1006,187,175,994,1181,16,0.00474495848161,1006,0.298339264531,46,0.0136417556346,3326,0.986358244365,2094,0.620996441281,3,Scotland,371653
Scotland,4308,2986,0.69312906221,974,0.2260909935,211,0.0489786443825,59,0.013695450325,27,0.00626740947075,51,0.0118384401114,980,247,247,980,1227,6,0.00139275766017,980,0.227483751161,68,0.0157845868152,4240,0.984215413185,2956,0.686165273909,4,Scotland,371654
Scotland,1755,966,0.550427350427,262,0.149287749288,496,0.282621082621,7,0.0039886039886,4,0.0022792022792,20,0.011396011396,263,514,514,263,777,1,0.000569800569801,263,0.149857549858,17,0.00968660968661,1738,0.990313390313,961,0.547578347578,5,Scotland,371655
Scotland,1780,705,0.39606741573,852,0.478651685393,184,0.103370786517,3,0.00168539325843,22,0.0123595505618,14,0.00786516853933,859,194,190,855,1049,7,0.00393258426966,859,0.482584269663,75,0.0421348314607,1705,0.957865168539,652,0.366292134831,6,Scotland,371656
Scotland,3703,1415,0.382122603295,1740,0.469889278963,436,0.11774237105,23,0.00621118012422,25,0.00675128274372,64,0.0172832838239,1760,481,472,1751,2232,20,0.00540102619498,1760,0.475290305158,58,0.0156629759654,3645,0.984337024035,1395,0.3767215771,7,Scotland,371657
Scotland,1627,1036,0.636754763368,358,0.220036877689,185,0.113706207744,2,0.00122925629994,16,0.00983405039951,30,0.0184388444991,361,211,210,360,571,3,0.00184388444991,361,0.221880762139,28,0.0172095881991,1599,0.982790411801,1033,0.634910878918,8,Scotland,371658
Scotland,2393,1562,0.652737150021,480,0.200585039699,274,0.114500626828,6,0.00250731299624,22,0.00919348098621,49,0.0204763894693,487,311,306,482,793,7,0.00292519849561,487,0.203510238195,50,0.0208942749687,2343,0.979105725031,1552,0.648558295027,9,Scotland,371659
Stanly,1811,1475,0.814467145224,215,0.118718939812,9,0.00496963003865,54,0.0298177802319,43,0.0237437879625,15,0.00828271673109,220,16,16,220,236,5,0.00276090557703,220,0.121479845389,75,0.0414135836554,1736,0.958586416345,1448,0.799558255108,0002,Stanly,371670002
Stanly,2193,1885,0.859553123575,228,0.103967168263,1,0.000455996352029,22,0.0100319197446,30,0.0136798905609,27,0.0123119015048,244,15,8,237,252,16,0.00729594163247,244,0.111263109895,56,0.0255357957136,2137,0.974464204286,1865,0.850433196534,0003,Stanly,371670003
Stanly,2341,1887,0.806065783853,321,0.137120888509,13,0.00555318240068,78,0.0333190944041,30,0.0128150363093,12,0.00512601452371,323,17,17,323,340,2,0.000854335753951,323,0.137975224263,63,0.0269115762495,2278,0.973088423751,1856,0.792823579667,0007,Stanly,371670007
Stanly,2070,538,0.259903381643,1424,0.687922705314,8,0.00386473429952,16,0.00772946859903,68,0.0328502415459,16,0.00772946859903,1435,15,10,1430,1445,11,0.00531400966184,1435,0.693236714976,120,0.0579710144928,1950,0.942028985507,498,0.240579710145,0008,Stanly,371670008
Stanly,1725,1473,0.853913043478,141,0.0817391304348,7,0.00405797101449,50,0.0289855072464,42,0.024347826087,12,0.00695652173913,144,10,10,144,154,3,0.00173913043478,144,0.0834782608696,73,0.0423188405797,1652,0.95768115942,1445,0.83768115942,0010,Stanly,371670010
Stanly,1549,1396,0.901226597805,78,0.0503550677857,3,0.00193673337637,55,0.0355067785668,7,0.00451904454487,10,0.00645577792124,83,7,7,83,90,5,0.00322788896062,83,0.0535829567463,21,0.0135571336346,1528,0.986442866365,1384,0.8934796643,0011,Stanly,371670011
Stanly,1236,1143,0.924757281553,40,0.0323624595469,7,0.00566343042071,33,0.0266990291262,6,0.00485436893204,7,0.00566343042071,42,11,11,42,53,2,0.00161812297735,42,0.0339805825243,8,0.00647249190939,1228,0.993527508091,1140,0.922330097087,0012,Stanly,371670012
Stanly,2042,1913,0.936826640548,52,0.0254652301665,4,0.00195886385896,40,0.0195886385896,20,0.00979431929481,13,0.00636630754163,53,9,9,53,62,1,0.00048971596474,53,0.0259549461312,34,0.0166503428012,2008,0.983349657199,1901,0.930950048972,0013,Stanly,371670013
Stanly,1177,1117,0.949022939677,24,0.0203908241291,3,0.00254885301614,23,0.0195412064571,2,0.0016992353441,8,0.00679694137638,26,7,7,26,33,2,0.0016992353441,26,0.0220900594732,7,0.00594732370433,1170,0.994052676296,1111,0.943925233645,0014,Stanly,371670014
Stanly,2217,1373,0.619305367614,727,0.327920613442,17,0.00766801984664,23,0.0103743797925,71,0.0320252593595,6,0.00270635994587,728,22,21,727,749,1,0.000451059990979,728,0.328371673433,128,0.0577356788453,2089,0.942264321155,1318,0.59449706811,0015,Stanly,371670015
Stanly,1368,1018,0.744152046784,305,0.222953216374,10,0.00730994152047,26,0.0190058479532,3,0.00219298245614,6,0.00438596491228,307,16,14,305,321,2,0.00146198830409,307,0.224415204678,14,0.0102339181287,1354,0.989766081871,1012,0.739766081871,0016,Stanly,371670016
Stanly,1985,1798,0.905793450882,138,0.0695214105793,5,0.00251889168766,32,0.016120906801,8,0.00403022670025,4,0.00201511335013,141,5,5,141,146,3,0.00151133501259,141,0.0710327455919,23,0.0115869017632,1962,0.988413098237,1787,0.900251889169,0017,Stanly,371670017
Stanly,1806,1601,0.886489479513,131,0.0725359911406,10,0.00553709856035,30,0.0166112956811,13,0.00719822812846,21,0.0116279069767,142,13,13,142,155,11,0.00609080841639,142,0.078626799557,34,0.0188261351052,1772,0.981173864895,1583,0.876522702104,0018,Stanly,371670018
Stanly,1699,1646,0.968805179517,7,0.00412007062978,5,0.0029429075927,28,0.0164802825191,9,0.00529723366686,4,0.00235432607416,7,8,8,7,15,0,0.0,7,0.00412007062978,17,0.0100058858152,1682,0.989994114185,1639,0.964685108888,0019,Stanly,371670019
Stanly,2457,2375,0.966625966626,10,0.00407000407,4,0.001628001628,49,0.019943019943,7,0.002849002849,12,0.004884004884,12,14,13,11,25,2,0.000814000814001,12,0.004884004884,15,0.00610500610501,2442,0.993894993895,2368,0.963776963777,0020,Stanly,371670020
Stanly,1357,1328,0.978629329403,6,0.00442151805453,1,0.000736919675755,10,0.00736919675755,4,0.00294767870302,8,0.00589535740604,8,7,7,8,15,2,0.00147383935151,8,0.00589535740604,11,0.00810611643331,1346,0.991893883567,1321,0.973470891673,0021,Stanly,371670021
Stanly,2017,1709,0.847297967278,189,0.0937035200793,11,0.00545364402578,20,0.00991571641051,71,0.0352007932573,17,0.00842835894893,190,21,21,190,211,1,0.000495785820526,190,0.0941993058999,98,0.0485870104115,1919,0.951412989588,1688,0.836886465047,0022,Stanly,371670022
Stanly,3094,2939,0.949903038138,47,0.0151906916613,11,0.00355526826115,12,0.00387847446671,66,0.0213316095669,19,0.00614091790562,48,20,20,48,68,1,0.000323206205559,48,0.0155138978668,104,0.0336134453782,2990,0.966386554622,2910,0.940530058177,0023,Stanly,371670023
Stanly,2883,2784,0.965660770031,27,0.00936524453694,7,0.00242802636143,13,0.00450919181408,42,0.0145681581686,10,0.00346860908776,30,12,12,30,42,3,0.00104058272633,30,0.0104058272633,99,0.0343392299688,2784,0.965660770031,2730,0.946930280957,0024,Stanly,371670024
Stanly,3401,3224,0.947956483387,32,0.00940899735372,11,0.00323434284034,24,0.00705674801529,89,0.02616877389,21,0.00617465451338,37,20,19,36,56,5,0.00147015583652,37,0.0108791531902,144,0.0423404880917,3257,0.957659511908,3192,0.938547486034,0025,Stanly,371670025
Stanly,1875,1720,0.917333333333,87,0.0464,2,0.00106666666667,56,0.0298666666667,5,0.00266666666667,5,0.00266666666667,87,4,4,87,91,0,0.0,87,0.0464,11,0.00586666666667,1864,0.994133333333,1714,0.914133333333,0026,Stanly,371670026
Stanly,2623,2308,0.879908501716,256,0.0975981700343,6,0.00228745711018,6,0.00228745711018,38,0.0144872283645,9,0.00343118566527,257,10,10,257,267,1,0.000381242851697,257,0.097979412886,50,0.0190621425848,2573,0.980937857415,2294,0.874571101792,0027,Stanly,371670027
Stanly,1926,1401,0.727414330218,434,0.22533748702,8,0.00415368639668,18,0.00934579439252,51,0.0264797507788,14,0.00726895119418,441,15,14,440,455,7,0.00363447559709,441,0.228971962617,67,0.0347871235722,1859,0.965212876428,1393,0.723260643821,0028,Stanly,371670028
Stokes,1004,965,0.961155378486,15,0.0149402390438,5,0.00498007968127,1,0.000996015936255,7,0.00697211155378,11,0.0109561752988,17,11,11,17,28,2,0.00199203187251,17,0.0169322709163,15,0.0149402390438,989,0.985059760956,960,0.956175298805,01,Stokes,3716901
Stokes,2198,2098,0.954504094631,33,0.0150136487716,3,0.00136487716106,1,0.000454959053685,52,0.0236578707916,11,0.00500454959054,40,6,6,40,46,7,0.0031847133758,40,0.0181983621474,79,0.0359417652411,2119,0.964058234759,2071,0.942220200182,02,Stokes,3716902
Stokes,1602,1561,0.974406991261,8,0.00499375780275,3,0.00187265917603,0,0.0,20,0.0124843945069,10,0.00624219725343,12,9,9,12,21,4,0.00249687890137,12,0.00749063670412,48,0.0299625468165,1554,0.970037453184,1532,0.956304619226,03,Stokes,3716903
Stokes,2310,2243,0.970995670996,19,0.00822510822511,7,0.0030303030303,5,0.0021645021645,17,0.00735930735931,19,0.00822510822511,24,18,17,23,41,5,0.0021645021645,24,0.0103896103896,43,0.0186147186147,2267,0.981385281385,2221,0.961471861472,04,Stokes,3716904
Stokes,811,756,0.932182490752,39,0.0480887792848,8,0.0098643649815,0,0.0,3,0.00369913686806,5,0.00616522811344,39,11,11,39,50,0,0.0,39,0.0480887792848,11,0.0135635018496,800,0.98643649815,751,0.926017262639,05,Stokes,3716905
Stokes,772,732,0.948186528497,30,0.0388601036269,0,0.0,2,0.00259067357513,6,0.00777202072539,2,0.00259067357513,30,2,2,30,32,0,0.0,30,0.0388601036269,15,0.0194300518135,757,0.980569948187,723,0.936528497409,06,Stokes,3716906
Stokes,761,667,0.876478318003,79,0.103810775296,2,0.00262812089356,0,0.0,8,0.0105124835742,5,0.0065703022339,82,6,4,80,86,3,0.00394218134034,82,0.107752956636,9,0.011826544021,752,0.988173455979,666,0.875164257556,07,Stokes,3716907
Stokes,1446,1383,0.95643153527,27,0.0186721991701,3,0.00207468879668,5,0.00345781466113,11,0.0076071922545,17,0.0117565698479,30,14,14,30,44,3,0.00207468879668,30,0.0207468879668,18,0.0124481327801,1428,0.98755186722,1377,0.952282157676,08,Stokes,3716908
Stokes,2459,2333,0.948759658398,84,0.0341602277349,8,0.00325335502237,5,0.00203334688898,15,0.00610004066694,14,0.00569337128914,86,20,19,85,105,2,0.000813338755592,86,0.0349735664904,32,0.0130134200895,2427,0.986986579911,2315,0.941439609597,09,Stokes,3716909
Stokes,3341,3229,0.966477102664,41,0.0122717749177,8,0.00239449266687,23,0.00688416641724,21,0.00628554325052,19,0.00568692008381,44,21,21,44,65,3,0.000897934750075,44,0.0131697096678,71,0.0212511224184,3270,0.978748877582,3174,0.950014965579,10,Stokes,3716910
Stokes,4513,4296,0.951916685132,78,0.017283403501,12,0.002658985154,12,0.002658985154,73,0.0161754930202,42,0.009306448039,84,29,29,84,113,6,0.001329492577,84,0.018612896078,136,0.0301351650787,4377,0.969864834921,4249,0.941502326612,11,Stokes,3716911
Stokes,2147,2083,0.970190964136,15,0.00698649278062,13,0.00605496040987,5,0.00232883092687,13,0.00605496040987,18,0.00838379133675,20,25,25,20,45,5,0.00232883092687,20,0.0093153237075,34,0.0158360503027,2113,0.984163949697,2064,0.961341406614,12,Stokes,3716912
Stokes,1984,1915,0.965221774194,24,0.0120967741935,6,0.00302419354839,10,0.00504032258065,12,0.00604838709677,17,0.0085685483871,33,11,10,32,43,9,0.00453629032258,33,0.0166330645161,44,0.0221774193548,1940,0.977822580645,1886,0.95060483871,13,Stokes,3716913
Stokes,2683,2604,0.97055534849,18,0.00670890793887,11,0.00409988818487,7,0.00260901975401,28,0.010436079016,15,0.00559075661573,20,21,21,20,41,2,0.00074543421543,20,0.0074543421543,58,0.0216175922475,2625,0.978382407753,2576,0.960119269474,14,Stokes,3716914
Stokes,1493,1463,0.979906229069,12,0.0080375083724,3,0.0020093770931,0,0.0,11,0.00736771600804,4,0.00267916945747,13,5,5,13,18,1,0.000669792364367,13,0.00870730073677,24,0.0160750167448,1469,0.983924983255,1449,0.970529135968,15,Stokes,3716915
Stokes,1870,1469,0.785561497326,378,0.202139037433,1,0.000534759358289,3,0.00160427807487,6,0.00320855614973,13,0.00695187165775,385,7,5,383,390,7,0.00374331550802,385,0.205882352941,14,0.00748663101604,1856,0.992513368984,1463,0.782352941176,16,Stokes,3716916
Stokes,2071,1828,0.882665379044,190,0.0917431192661,4,0.00193143408981,7,0.00338000965717,21,0.0101400289715,21,0.0101400289715,197,18,15,194,212,7,0.00338000965717,197,0.0951231289232,38,0.0183486238532,2033,0.981651376147,1812,0.874939642685,17,Stokes,3716917
Stokes,543,246,0.453038674033,274,0.504604051565,5,0.00920810313076,1,0.00184162062615,2,0.0036832412523,15,0.0276243093923,277,17,15,275,292,3,0.00552486187845,277,0.510128913444,8,0.0147329650092,535,0.985267034991,244,0.449355432781,18,Stokes,3716918
Stokes,1192,1040,0.872483221477,122,0.102348993289,5,0.00419463087248,3,0.00251677852349,9,0.00755033557047,13,0.0109060402685,127,16,13,124,140,5,0.00419463087248,127,0.106543624161,12,0.010067114094,1180,0.989932885906,1037,0.869966442953,19,Stokes,3716919
Stokes,1680,1569,0.933928571429,65,0.0386904761905,7,0.00416666666667,5,0.00297619047619,19,0.0113095238095,15,0.00892857142857,66,19,19,66,85,1,0.000595238095238,66,0.0392857142857,30,0.0178571428571,1650,0.982142857143,1555,0.925595238095,20,Stokes,3716920
Surry,2114,2021,0.95600756859,11,0.00520340586566,10,0.00473036896878,4,0.00189214758751,56,0.0264900662252,12,0.00567644276254,16,15,14,15,30,5,0.00236518448439,16,0.00756859035005,113,0.0534531693472,2001,0.946546830653,1965,0.929517502365,01,Surry,3717101
Surry,1122,898,0.800356506239,55,0.0490196078431,12,0.0106951871658,2,0.0017825311943,148,0.131907308378,7,0.00623885918004,58,14,14,58,72,3,0.00267379679144,58,0.0516934046346,251,0.223707664884,871,0.776292335116,809,0.721033868093,02,Surry,3717102
Surry,3071,2775,0.903614457831,39,0.0126994464344,10,0.00325626831651,1,0.000325626831651,230,0.0748941712797,16,0.00521002930641,40,17,17,40,57,1,0.000325626831651,40,0.013025073266,370,0.120481927711,2701,0.879518072289,2646,0.861608596548,03,Surry,3717103
Surry,2458,2153,0.875915378356,40,0.0162733930024,12,0.00488201790073,6,0.00244100895037,218,0.0886899918633,29,0.0117982099268,46,17,13,42,59,6,0.00244100895037,46,0.0187144019528,388,0.157851912124,2070,0.842148087876,2023,0.823026851098,04,Surry,3717104
Surry,2790,2618,0.93835125448,22,0.0078853046595,8,0.00286738351254,3,0.0010752688172,116,0.0415770609319,23,0.00824372759857,24,18,18,24,42,2,0.000716845878136,24,0.00860215053763,181,0.0648745519713,2609,0.935125448029,2561,0.917921146953,05,Surry,3717105
Surry,1593,1331,0.8355304457,69,0.0433145009416,5,0.00313873195229,17,0.0106716886378,155,0.097300690521,16,0.0100439422473,74,15,13,72,87,5,0.00313873195229,74,0.0464532328939,218,0.13684871312,1375,0.86315128688,1298,0.814814814815,06,Surry,3717106
Surry,1510,1221,0.808609271523,123,0.0814569536424,0,0.0,8,0.00529801324503,142,0.0940397350993,16,0.0105960264901,127,7,7,127,134,4,0.00264900662252,127,0.0841059602649,189,0.125165562914,1321,0.874834437086,1179,0.780794701987,07,Surry,3717107
Surry,1793,1692,0.943669827105,48,0.026770775237,1,0.000557724484105,10,0.00557724484105,28,0.0156162855549,14,0.00780814277747,51,7,6,50,57,3,0.00167317345231,51,0.0284439486893,44,0.0245398773006,1749,0.975460122699,1682,0.938092582264,08,Surry,3717108
Surry,1782,1692,0.949494949495,25,0.0140291806958,4,0.00224466891134,5,0.00280583613917,36,0.020202020202,20,0.0112233445567,30,17,15,28,45,5,0.00280583613917,30,0.016835016835,73,0.0409652076319,1709,0.959034792368,1656,0.929292929293,09,Surry,3717109
Surry,1227,1173,0.955990220049,13,0.0105949470253,0,0.0,4,0.00325998370008,30,0.0244498777506,7,0.00570497147514,15,2,2,15,17,2,0.00162999185004,15,0.0122249388753,51,0.041564792176,1176,0.958435207824,1155,0.941320293399,10,Surry,3717110
Surry,1832,1431,0.781113537118,69,0.0376637554585,9,0.00491266375546,0,0.0,301,0.164301310044,22,0.0120087336245,73,18,17,72,90,4,0.00218340611354,73,0.0398471615721,454,0.247816593886,1378,0.752183406114,1289,0.703602620087,11,Surry,3717111
Surry,3344,2845,0.850777511962,262,0.0783492822967,17,0.00508373205742,31,0.00927033492823,136,0.0406698564593,53,0.0158492822967,281,45,39,275,320,19,0.00568181818182,281,0.0840311004785,242,0.0723684210526,3102,0.927631578947,2753,0.823265550239,12,Surry,3717112
Surry,1367,1197,0.875640087783,111,0.0811997073884,1,0.000731528895391,19,0.0138990490124,27,0.0197512801756,12,0.0087783467447,119,4,2,117,121,8,0.00585223116313,119,0.0870519385516,40,0.0292611558157,1327,0.970738844184,1184,0.866130212143,13,Surry,3717113
Surry,1730,1446,0.835838150289,180,0.104046242775,4,0.00231213872832,32,0.0184971098266,47,0.0271676300578,21,0.0121387283237,187,13,10,184,197,7,0.00404624277457,187,0.108092485549,66,0.0381502890173,1664,0.961849710983,1430,0.826589595376,14,Surry,3717114
Surry,2535,2180,0.859960552268,209,0.0824457593688,7,0.00276134122288,9,0.00355029585799,110,0.043392504931,20,0.00788954635108,212,17,17,212,229,3,0.00118343195266,212,0.0836291913215,156,0.0615384615385,2379,0.938461538462,2142,0.844970414201,15,Surry,3717115
Surry,1747,1608,0.920435031483,32,0.0183171150544,8,0.00457927876359,2,0.0011448196909,83,0.0475100171723,14,0.00801373783629,37,18,14,33,51,5,0.00286204922725,37,0.0211791642816,118,0.067544361763,1629,0.932455638237,1576,0.902117916428,16,Surry,3717116
Surry,1325,1253,0.945660377358,12,0.00905660377358,2,0.00150943396226,18,0.0135849056604,35,0.0264150943396,5,0.00377358490566,13,6,5,12,18,1,0.000754716981132,13,0.00981132075472,50,0.0377358490566,1275,0.962264150943,1240,0.935849056604,17,Surry,3717117
Surry,2490,2315,0.929718875502,54,0.021686746988,2,0.000803212851406,13,0.00522088353414,87,0.0349397590361,19,0.00763052208835,57,10,9,56,66,3,0.00120481927711,57,0.0228915662651,155,0.0622489959839,2335,0.937751004016,2252,0.904417670683,18,Surry,3717118
Surry,2791,2416,0.865639555715,213,0.076316732354,2,0.000716589036188,11,0.00394123969903,120,0.0429953421713,29,0.0103905410247,223,20,14,217,237,10,0.00358294518094,223,0.0798996775349,175,0.0627015406664,2616,0.937298459334,2365,0.847366535292,19,Surry,3717119
Surry,1121,1003,0.894736842105,77,0.0686886708296,3,0.00267618198037,13,0.0115967885816,15,0.0133809099019,10,0.00892060660125,78,8,8,78,86,1,0.000892060660125,78,0.0695807314897,31,0.0276538804639,1090,0.972346119536,988,0.881355932203,20,Surry,3717120
Surry,2029,1927,0.949728930508,44,0.0216855593889,3,0.00147856086742,9,0.00443568260227,31,0.0152784622967,15,0.00739280433711,49,5,5,49,54,5,0.00246426811237,49,0.0241498275012,52,0.0256283883687,1977,0.974371611631,1911,0.941843272548,21,Surry,3717121
Surry,1421,1312,0.923293455313,28,0.0197044334975,4,0.00281491907108,2,0.00140745953554,70,0.0492610837438,5,0.00351864883885,30,5,5,30,35,2,0.00140745953554,30,0.0211118930331,103,0.0724841660802,1318,0.92751583392,1282,0.90218156228,22,Surry,3717122
Surry,1589,1526,0.960352422907,30,0.0188797986155,9,0.00566393958464,0,0.0,16,0.0100692259283,8,0.00503461296413,36,12,10,34,46,6,0.0037759597231,36,0.0226557583386,35,0.0220264317181,1554,0.977973568282,1508,0.949024543738,23,Surry,3717123
Surry,872,856,0.981651376147,0,0.0,5,0.00573394495413,2,0.00229357798165,7,0.00802752293578,2,0.00229357798165,1,5,5,1,6,1,0.00114678899083,1,0.00114678899083,15,0.0172018348624,857,0.982798165138,850,0.974770642202,24,Surry,3717124
Surry,2301,2166,0.941329856584,32,0.0139069969578,6,0.0026075619296,1,0.000434593654933,62,0.0269448066058,34,0.0147761842677,36,21,21,36,57,4,0.00173837461973,36,0.0156453715776,121,0.0525858322468,2180,0.947414167753,2123,0.922642329422,25,Surry,3717125
Surry,3220,3081,0.956832298137,34,0.0105590062112,2,0.000621118012422,6,0.00186335403727,78,0.0242236024845,19,0.00590062111801,36,13,13,36,49,2,0.000621118012422,36,0.0111801242236,103,0.0319875776398,3117,0.96801242236,3062,0.950931677019,26,Surry,3717126
Surry,1967,1815,0.922724961871,94,0.047788510422,5,0.00254194204372,1,0.000508388408744,40,0.0203355363498,12,0.00610066090493,100,11,7,96,107,6,0.00305033045247,100,0.0508388408744,57,0.0289781392984,1910,0.971021860702,1802,0.916115912557,27,Surry,3717127
Surry,1646,1513,0.919198055893,38,0.0230862697448,10,0.00607533414338,5,0.00303766707169,76,0.0461725394897,4,0.00243013365735,39,12,12,39,51,1,0.000607533414338,39,0.0236938031592,99,0.0601458080194,1547,0.939854191981,1491,0.905832320778,28,Surry,3717128
Surry,1669,1484,0.889155182744,120,0.0718993409227,1,0.000599161174356,23,0.0137807070102,27,0.0161773517076,14,0.00838825644098,126,6,5,125,131,6,0.00359496704614,126,0.0754943079688,53,0.0317555422409,1616,0.968244457759,1466,0.878370281606,33,Surry,3717133
Swain,760,728,0.957894736842,0,0.0,14,0.0184210526316,2,0.00263157894737,0,0.0,16,0.0210526315789,0,28,28,0,28,0,0.0,0,0.0,2,0.00263157894737,758,0.997368421053,726,0.955263157895,ALARKA,Swain,37173ALARKA
Swain,1204,1166,0.968438538206,2,0.00166112956811,18,0.014950166113,3,0.00249169435216,3,0.00249169435216,12,0.00996677740864,2,30,30,2,32,0,0.0,2,0.00166112956811,14,0.0116279069767,1190,0.988372093023,1158,0.961794019934,ALMOND,Swain,37173ALMOND
Swain,2389,2194,0.918375889494,5,0.00209292591042,119,0.0498116366681,9,0.00376726663876,17,0.00711594809544,45,0.0188363331938,8,157,156,7,164,3,0.00125575554625,8,0.00334868145668,51,0.0213478442863,2338,0.978652155714,2169,0.907911259941,BC1,Swain,37173BC1
Swain,2433,2210,0.908343608714,17,0.00698725852857,117,0.0480887792848,22,0.00904233456638,32,0.013152486642,35,0.0143855322647,22,147,142,17,164,5,0.00205507603781,22,0.00904233456638,56,0.0230168516235,2377,0.976983148376,2194,0.901767365393,BC2,Swain,37173BC2
Swain,3926,1303,0.33188996434,44,0.0112073357106,2259,0.575394803872,12,0.0030565461029,65,0.0165562913907,243,0.0618950585838,54,2495,2487,46,2541,10,0.00254712175242,54,0.0137544574631,170,0.0433010697911,3756,0.956698930209,1271,0.323739174733,WHCH,Swain,37173WHCH
Transylvania,2085,1959,0.939568345324,76,0.0364508393285,5,0.00239808153477,16,0.00767386091127,14,0.00671462829736,15,0.00719424460432,79,12,12,79,91,3,0.00143884892086,79,0.0378896882494,32,0.0153477218225,2053,0.984652278177,1942,0.931414868106,B1,Transylvania,37175B1
Transylvania,1906,1413,0.741343126967,394,0.206715634837,3,0.00157397691501,8,0.00419727177335,41,0.0215110178384,47,0.0246589716684,420,31,19,408,439,26,0.0136411332634,420,0.220356768101,83,0.0435466946485,1823,0.956453305352,1377,0.722455403987,B2,Transylvania,37175B2
Transylvania,1902,1737,0.913249211356,102,0.0536277602524,4,0.00210304942166,8,0.00420609884332,23,0.0120925341746,28,0.0147213459516,113,23,17,107,130,11,0.00578338590957,113,0.0594111461619,59,0.0310199789695,1843,0.96898002103,1702,0.894847528917,B3,Transylvania,37175B3
Transylvania,1943,1780,0.916109109624,84,0.0432321152856,4,0.00205867215646,26,0.013381369017,36,0.0185280494081,13,0.00669068450849,86,9,9,86,95,2,0.00102933607823,86,0.0442614513639,81,0.0416881111683,1862,0.958311888832,1736,0.893463715903,B4,Transylvania,37175B4
Transylvania,2970,2756,0.927946127946,138,0.0464646464646,9,0.0030303030303,6,0.0020202020202,29,0.00976430976431,32,0.0107744107744,146,30,28,144,174,8,0.0026936026936,146,0.0491582491582,77,0.0259259259259,2893,0.974074074074,2708,0.911784511785,BD,Transylvania,37175BD
Transylvania,579,565,0.975820379965,2,0.00345423143351,1,0.00172711571675,0,0.0,0,0.0,11,0.0189982728843,2,10,10,2,12,0,0.0,2,0.00345423143351,4,0.00690846286701,575,0.993091537133,561,0.968911917098,BG,Transylvania,37175BG
Transylvania,2584,2504,0.969040247678,16,0.0061919504644,15,0.00580495356037,6,0.00232198142415,20,0.0077399380805,23,0.00890092879257,21,24,23,20,44,5,0.00193498452012,21,0.00812693498452,43,0.0166408668731,2541,0.983359133127,2480,0.959752321981,CC,Transylvania,37175CC
Transylvania,754,740,0.981432360743,1,0.00132625994695,1,0.00132625994695,5,0.00663129973475,3,0.00397877984085,4,0.0053050397878,1,3,3,1,4,0,0.0,1,0.00132625994695,20,0.026525198939,734,0.973474801061,724,0.960212201592,CM,Transylvania,37175CM
Transylvania,2376,2337,0.983585858586,7,0.00294612794613,6,0.00252525252525,10,0.00420875420875,3,0.00126262626263,13,0.00547138047138,11,14,14,11,25,4,0.0016835016835,11,0.00462962962963,15,0.00631313131313,2361,0.993686868687,2325,0.978535353535,DR,Transylvania,37175DR
Transylvania,980,963,0.982653061224,0,0.0,2,0.00204081632653,3,0.0030612244898,6,0.00612244897959,6,0.00612244897959,1,6,6,1,7,1,0.00102040816327,1,0.00102040816327,12,0.0122448979592,968,0.987755102041,955,0.974489795918,EF,Transylvania,37175EF
Transylvania,443,428,0.966139954853,0,0.0,0,0.0,2,0.00451467268623,2,0.00451467268623,11,0.0248306997743,0,10,10,0,10,0,0.0,0,0.0,2,0.00451467268623,441,0.995485327314,428,0.966139954853,GL,Transylvania,37175GL
Transylvania,1541,1512,0.981181051265,14,0.00908500973394,1,0.00064892926671,3,0.00194678780013,2,0.00129785853342,9,0.00584036340039,16,6,6,16,22,2,0.00129785853342,16,0.0103828682674,13,0.00843608046723,1528,0.991563919533,1501,0.974042829332,LR,Transylvania,37175LR
Transylvania,619,599,0.967689822294,1,0.0016155088853,0,0.0,3,0.0048465266559,0,0.0,16,0.0258481421648,2,13,12,1,14,1,0.0016155088853,2,0.0032310177706,3,0.0048465266559,616,0.995153473344,598,0.966074313409,LT,Transylvania,37175LT
Transylvania,1729,1552,0.897628687102,132,0.0763447079237,5,0.00289184499711,5,0.00289184499711,21,0.0121457489879,14,0.0080971659919,139,11,10,138,149,7,0.00404858299595,139,0.0803932909196,83,0.048004626952,1646,0.951995373048,1496,0.865240023135,PF,Transylvania,37175PF
Transylvania,684,617,0.902046783626,0,0.0,2,0.00292397660819,1,0.00146198830409,60,0.0877192982456,4,0.00584795321637,0,5,5,0,5,0,0.0,0,0.0,66,0.0964912280702,618,0.90350877193,612,0.894736842105,QB,Transylvania,37175QB
Transylvania,2020,1963,0.971782178218,6,0.0029702970297,10,0.0049504950495,5,0.00247524752475,18,0.00891089108911,18,0.00891089108911,8,24,24,8,32,2,0.000990099009901,8,0.0039603960396,44,0.0217821782178,1976,0.978217821782,1939,0.959900990099,RE,Transylvania,37175RE
Transylvania,544,525,0.965073529412,8,0.0147058823529,3,0.00551470588235,1,0.00183823529412,6,0.0110294117647,1,0.00183823529412,8,4,4,8,12,0,0.0,8,0.0147058823529,16,0.0294117647059,528,0.970588235294,516,0.948529411765,SW,Transylvania,37175SW
Transylvania,1599,1582,0.989368355222,8,0.00500312695435,1,0.000625390869293,0,0.0,4,0.00250156347717,4,0.00250156347717,8,4,4,8,12,0,0.0,8,0.00500312695435,14,0.00875547217011,1585,0.99124452783,1573,0.983739837398,WC,Transylvania,37175WC
Tyrrell,279,58,0.207885304659,214,0.767025089606,0,0.0,6,0.0215053763441,0,0.0,1,0.00358422939068,215,0,0,215,215,1,0.00358422939068,215,0.770609318996,1,0.00358422939068,278,0.996415770609,58,0.207885304659,01,Tyrrell,3717701
Tyrrell,2414,1353,0.56048053024,891,0.369096934548,8,0.003314001657,57,0.0236122618061,94,0.0389395194698,11,0.00455675227838,893,14,12,891,905,2,0.00082850041425,893,0.369925434963,122,0.0505385252693,2292,0.949461474731,1331,0.551367025684,02,Tyrrell,3717702
Tyrrell,275,177,0.643636363636,95,0.345454545455,0,0.0,0,0.0,0,0.0,3,0.0109090909091,97,2,1,96,98,2,0.00727272727273,97,0.352727272727,0,0.0,275,1.0,177,0.643636363636,03,Tyrrell,3717703
Tyrrell,72,65,0.902777777778,5,0.0694444444444,0,0.0,0,0.0,0,0.0,2,0.0277777777778,7,0,0,7,7,2,0.0277777777778,7,0.0972222222222,0,0.0,72,1.0,65,0.902777777778,14,Tyrrell,3717714
Tyrrell,532,308,0.578947368421,207,0.389097744361,2,0.00375939849624,5,0.0093984962406,5,0.0093984962406,5,0.0093984962406,207,4,4,207,211,0,0.0,207,0.389097744361,13,0.0244360902256,519,0.975563909774,301,0.565789473684,15,Tyrrell,3717715
Tyrrell,40,30,0.75,9,0.225,0,0.0,0,0.0,1,0.025,0,0.0,9,0,0,9,9,0,0.0,9,0.225,1,0.025,39,0.975,30,0.75,16,Tyrrell,3717716
Union,2506,1055,0.4209896249,605,0.241420590583,28,0.0111731843575,41,0.0163607342378,722,0.288108539505,55,0.0219473264166,620,39,33,614,653,15,0.00598563447725,620,0.24740622506,1105,0.440941739824,1401,0.559058260176,734,0.292897047087,001,Union,37179001
Union,2125,1025,0.482352941176,677,0.318588235294,14,0.00658823529412,10,0.00470588235294,363,0.170823529412,36,0.0169411764706,691,27,23,687,714,14,0.00658823529412,691,0.325176470588,551,0.259294117647,1574,0.740705882353,860,0.404705882353,002,Union,37179002
Union,1961,1157,0.590005099439,432,0.220295767466,7,0.00356960734319,9,0.00458949515553,333,0.169811320755,23,0.0117287098419,437,11,10,436,447,5,0.00254971953085,437,0.222845486996,562,0.286588475268,1399,0.713411524732,961,0.49005609383,003,Union,37179003
Union,2620,669,0.25534351145,971,0.370610687023,14,0.00534351145038,3,0.00114503816794,868,0.331297709924,95,0.0362595419847,1005,39,25,991,1030,34,0.0129770992366,1005,0.38358778626,1277,0.487404580153,1343,0.512595419847,344,0.131297709924,004,Union,37179004
Union,3410,2773,0.813196480938,385,0.112903225806,22,0.00645161290323,34,0.0099706744868,144,0.0422287390029,52,0.0152492668622,398,31,29,396,427,13,0.00381231671554,398,0.116715542522,399,0.117008797654,3011,0.882991202346,2565,0.75219941349,005,Union,37179005
Union,2004,1737,0.866766467066,130,0.064870259481,14,0.00698602794411,37,0.0184630738523,68,0.0339321357285,18,0.00898203592814,134,20,19,133,153,4,0.00199600798403,134,0.0668662674651,147,0.0733532934132,1857,0.926646706587,1670,0.833333333333,006,Union,37179006
Union,3431,2698,0.786359661906,445,0.129699795978,9,0.00262314194113,18,0.00524628388225,219,0.063829787234,42,0.0122413290586,462,29,25,458,487,17,0.00495482366657,462,0.134654619644,358,0.104342757214,3073,0.895657242786,2573,0.749927134946,007,Union,37179007
Union,3716,2209,0.594456404736,1113,0.299515608181,18,0.0048439181916,35,0.00941872981701,320,0.0861141011841,21,0.0056512378902,1121,23,21,1119,1142,8,0.0021528525296,1121,0.30166846071,474,0.127556512379,3242,0.872443487621,2039,0.548708288482,008,Union,37179008
Union,1717,871,0.507280139779,750,0.436808386721,13,0.00757134536983,5,0.00291205591147,65,0.0378567268492,13,0.00757134536983,757,17,14,754,771,7,0.00407687827606,757,0.440885264997,171,0.0995923121724,1546,0.900407687828,792,0.461269656377,009,Union,37179009
Union,1620,688,0.424691358025,551,0.34012345679,7,0.00432098765432,6,0.0037037037037,337,0.208024691358,31,0.0191358024691,568,10,9,567,577,17,0.0104938271605,568,0.350617283951,448,0.276543209877,1172,0.723456790123,608,0.375308641975,010,Union,37179010
Union,2524,2410,0.954833597464,32,0.0126782884311,9,0.00356576862124,10,0.00396196513471,51,0.020206022187,12,0.00475435816165,36,14,13,35,49,4,0.00158478605388,36,0.0142630744849,76,0.0301109350238,2448,0.969889064976,2386,0.945324881141,011,Union,37179011
Union,2328,2290,0.983676975945,19,0.00816151202749,3,0.00128865979381,3,0.00128865979381,8,0.00343642611684,5,0.00214776632302,20,6,6,20,26,1,0.000429553264605,20,0.0085910652921,17,0.00730240549828,2311,0.992697594502,2283,0.980670103093,012,Union,37179012
Union,2624,2549,0.971417682927,16,0.00609756097561,5,0.00190548780488,9,0.00342987804878,24,0.00914634146341,21,0.00800304878049,19,17,17,19,36,3,0.00114329268293,19,0.00724085365854,50,0.0190548780488,2574,0.980945121951,2529,0.963795731707,013,Union,37179013
Union,1751,1505,0.859508852085,102,0.0582524271845,18,0.0102798400914,11,0.00628212450029,80,0.0456881781839,35,0.0199885779555,107,32,32,107,139,5,0.00285551113649,107,0.061107938321,150,0.0856653340948,1601,0.914334665905,1447,0.826384922901,014,Union,37179014
Union,4273,3695,0.864732038381,320,0.0748888368828,32,0.00748888368828,97,0.0227006786801,85,0.019892347297,44,0.0102972150714,338,52,42,328,380,18,0.00421249707465,338,0.0791013339574,297,0.0695062017318,3976,0.930493798268,3494,0.817692487714,015,Union,37179015
Union,3793,3335,0.879251252307,253,0.0667018191405,25,0.00659108884788,64,0.0168731874506,65,0.0171368310045,51,0.0134458212497,271,47,43,267,314,18,0.00474558397047,271,0.071447403111,178,0.0469285525969,3615,0.953071447403,3234,0.852623253361,016,Union,37179016
Union,3154,2770,0.878249841471,240,0.0760938490805,11,0.00348763474952,48,0.0152187698161,61,0.0193405199746,24,0.00760938490805,244,20,18,242,262,4,0.00126823081801,244,0.0773620798985,225,0.071337983513,2929,0.928662016487,2618,0.830057070387,017A,Union,37179017A
Union,3118,2792,0.895445798589,184,0.0590121872996,3,0.00096215522771,86,0.0275817831944,21,0.00673508659397,32,0.0102629890956,194,17,13,190,207,10,0.00320718409237,194,0.0622193713919,131,0.04201411161,2987,0.95798588839,2688,0.862091084028,017B,Union,37179017B
Union,2157,1997,0.925822902179,80,0.0370885489105,1,0.000463606861382,51,0.0236439499305,12,0.00556328233658,16,0.0074177097821,85,7,5,83,90,5,0.00231803430691,85,0.0394065832174,52,0.0241075567918,2105,0.975892443208,1958,0.907742234585,018,Union,37179018
Union,3918,3357,0.856814701378,395,0.100816743236,10,0.00255232261358,43,0.0109749872384,71,0.0181214905564,42,0.010719754977,406,34,30,402,436,11,0.00280755487494,406,0.103624298111,200,0.0510464522716,3718,0.948953547728,3241,0.827207759061,019,Union,37179019
Union,3079,2504,0.813251055538,427,0.138681390062,8,0.00259824618383,31,0.0100682039623,58,0.0188372848327,51,0.0165638194219,446,24,20,442,466,19,0.00617083468659,446,0.144852224748,182,0.059110100682,2897,0.940889899318,2396,0.778174732056,020A,Union,37179020A
Union,2454,2265,0.922982885086,97,0.0395273023635,7,0.00285248573757,32,0.0130399348003,18,0.00733496332518,35,0.0142624286879,107,22,22,107,129,10,0.0040749796251,107,0.0436022819886,85,0.0346373268134,2369,0.965362673187,2212,0.901385493073,020B,Union,37179020B
Union,2454,2250,0.916870415648,116,0.0472697636512,8,0.00325998370008,9,0.00366748166259,39,0.0158924205379,32,0.0130399348003,119,28,26,117,145,3,0.00122249388753,119,0.0484922575387,66,0.0268948655257,2388,0.973105134474,2229,0.908312958435,021,Union,37179021
Union,2397,2262,0.943679599499,60,0.0250312891114,7,0.002920317063,30,0.0125156445557,24,0.0100125156446,14,0.00584063412599,68,12,11,67,79,8,0.00333750521485,68,0.0283687943262,49,0.020442219441,2348,0.979557780559,2234,0.931998331247,022,Union,37179022
Union,2225,1885,0.847191011236,202,0.0907865168539,11,0.00494382022472,10,0.00449438202247,80,0.0359550561798,37,0.0166292134831,220,26,18,212,238,18,0.00808988764045,220,0.0988764044944,157,0.0705617977528,2068,0.929438202247,1830,0.822471910112,023,Union,37179023
Union,2552,2321,0.909482758621,164,0.064263322884,11,0.00431034482759,8,0.00313479623824,41,0.016065830721,7,0.00274294670846,165,16,16,165,181,1,0.000391849529781,165,0.0646551724138,64,0.025078369906,2488,0.974921630094,2301,0.901645768025,024,Union,37179024
Union,2211,1904,0.861148801447,201,0.0909090909091,10,0.00452284034374,15,0.0067842605156,59,0.026684758028,22,0.00995024875622,207,19,19,207,226,6,0.00271370420624,207,0.0936227951153,126,0.0569877883311,2085,0.943012211669,1843,0.833559475351,025,Union,37179025
Union,2149,1827,0.85016286645,220,0.102373196836,21,0.00977198697068,14,0.00651465798046,37,0.0172173103769,30,0.0139599813867,229,34,32,227,261,9,0.00418799441601,229,0.106561191252,95,0.0442066077245,2054,0.955793392275,1785,0.830618892508,026,Union,37179026
Union,2103,1808,0.859724203519,245,0.116500237756,8,0.0038040893961,1,0.000475511174513,35,0.0166428911079,6,0.00285306704708,245,14,14,245,259,0,0.0,245,0.116500237756,57,0.0271041369472,2046,0.972895863053,1791,0.851640513552,027,Union,37179027
Union,11747,10029,0.85374989359,865,0.073635821912,25,0.00212820294543,608,0.0517578956329,84,0.00715076189665,136,0.0115774240232,913,62,49,900,962,48,0.00408614965523,913,0.0777219715672,479,0.0407763684345,11268,0.959223631566,9657,0.822082233762,028,Union,37179028
Union,3815,2953,0.774049803408,557,0.146002621232,15,0.00393184796855,90,0.0235910878113,137,0.0359108781127,63,0.0165137614679,586,27,22,581,608,29,0.00760157273919,586,0.153604193971,433,0.113499344692,3382,0.886500655308,2687,0.704325032765,029A,Union,37179029A
Union,1600,1416,0.885,113,0.070625,3,0.001875,30,0.01875,28,0.0175,10,0.00625,118,8,6,116,124,5,0.003125,118,0.07375,91,0.056875,1509,0.943125,1353,0.845625,029B,Union,37179029B
Union,2168,1931,0.890682656827,140,0.0645756457565,12,0.00553505535055,26,0.0119926199262,38,0.0175276752768,21,0.00968634686347,145,25,25,145,170,5,0.00230627306273,145,0.0668819188192,103,0.0475092250923,2065,0.952490774908,1867,0.861162361624,029C,Union,37179029C
Union,4710,3588,0.76178343949,688,0.146072186837,22,0.00467091295117,85,0.0180467091295,257,0.0545647558386,70,0.0148619957537,714,37,32,709,746,26,0.00552016985138,714,0.151592356688,556,0.11804670913,4154,0.88195329087,3338,0.708704883227,030,Union,37179030
Union,3443,2760,0.801626488527,406,0.11792041824,21,0.00609933197793,54,0.0156839965147,157,0.0455997676445,45,0.0130699970956,425,34,30,421,455,19,0.00551844321812,425,0.123438861458,358,0.103979088005,3085,0.896020911995,2581,0.749636944525,031,Union,37179031
Union,2972,2639,0.887954239569,201,0.0676312247645,5,0.00168236877524,81,0.0272543741588,28,0.00942126514132,18,0.00605652759085,205,12,11,204,216,4,0.00134589502019,205,0.0689771197847,89,0.0299461641992,2883,0.970053835801,2586,0.870121130552,032,Union,37179032
Union,2430,2095,0.862139917695,254,0.104526748971,3,0.00123456790123,14,0.00576131687243,22,0.00905349794239,42,0.0172839506173,261,28,27,260,288,7,0.00288065843621,261,0.107407407407,53,0.0218106995885,2377,0.978189300412,2067,0.850617283951,033,Union,37179033
Union,3245,2658,0.819106317411,413,0.127272727273,6,0.00184899845917,22,0.00677966101695,129,0.0397534668721,17,0.00523882896764,418,15,13,416,431,5,0.00154083204931,418,0.128813559322,201,0.0619414483821,3044,0.938058551618,2597,0.80030816641,034,Union,37179034
Union,1797,1716,0.954924874791,45,0.025041736227,2,0.00111296605454,17,0.00946021146355,6,0.00333889816361,11,0.00612131329994,47,8,8,47,55,2,0.00111296605454,47,0.0261547022816,43,0.0239287701725,1754,0.976071229827,1681,0.935447968837,035,Union,37179035
Union,2351,1859,0.790727350064,397,0.168864313058,5,0.00212675457252,7,0.00297745640153,61,0.0259464057848,22,0.0093577201191,407,20,16,403,423,10,0.00425350914504,407,0.173117822203,114,0.0484900042535,2237,0.951509995746,1808,0.769034453424,036,Union,37179036
Union,4162,3442,0.827006246997,399,0.095867371456,27,0.00648726573763,133,0.0319557904853,100,0.0240269101394,61,0.014656415185,418,52,43,409,461,19,0.00456511292648,418,0.100432484383,339,0.0814512253724,3823,0.918548774628,3233,0.776790004805,037A,Union,37179037A
Union,1276,1176,0.921630094044,60,0.0470219435737,2,0.00156739811912,23,0.0180250783699,11,0.00862068965517,4,0.00313479623824,61,4,3,60,64,1,0.000783699059561,61,0.0478056426332,26,0.0203761755486,1250,0.979623824451,1158,0.907523510972,037B,Union,37179037B
Union,4219,3136,0.743304100498,509,0.120644702536,22,0.00521450580706,85,0.0201469542546,410,0.0971794264044,57,0.0135103105001,525,43,37,519,562,16,0.00379236785968,525,0.124437070396,710,0.168286323773,3509,0.831713676227,2863,0.678596823892,038A,Union,37179038A
Union,2455,2174,0.885539714868,156,0.0635437881874,11,0.00448065173116,49,0.0199592668024,34,0.013849287169,31,0.0126272912424,164,20,18,162,182,8,0.00325865580448,164,0.0668024439919,113,0.0460285132383,2342,0.953971486762,2104,0.857026476578,038B,Union,37179038B
Union,2103,1913,0.909652876843,133,0.0632429862102,11,0.00523062291964,19,0.00903471231574,16,0.0076081787922,11,0.00523062291964,136,16,14,134,150,3,0.00142653352354,136,0.0646695197337,54,0.0256776034237,2049,0.974322396576,1878,0.893009985735,039,Union,37179039
Union,3224,2887,0.89547146402,175,0.0542803970223,8,0.00248138957816,92,0.0285359801489,27,0.0083746898263,35,0.0108560794045,182,28,24,178,206,7,0.00217121588089,182,0.0564516129032,82,0.0254342431762,3142,0.974565756824,2834,0.879032258065,040,Union,37179040
Union,2546,2298,0.90259230165,112,0.0439905734485,6,0.00235663786332,72,0.0282796543598,35,0.0137470542027,23,0.00903377847604,118,9,8,117,126,6,0.00235663786332,118,0.0463472113119,90,0.0353495679497,2456,0.96465043205,2245,0.881775333857,041,Union,37179041
Union,2154,1728,0.802228412256,200,0.0928505106778,13,0.00603528319406,16,0.00742804085422,165,0.0766016713092,32,0.0148560817084,207,28,25,204,232,7,0.00324976787372,207,0.0961002785515,269,0.124883936862,1885,0.875116063138,1637,0.759981429898,042,Union,37179042
Union,1621,408,0.251696483652,814,0.502159161012,8,0.00493522516965,1,0.000616903146206,370,0.228254164096,20,0.0123380629241,824,10,9,823,833,10,0.00616903146206,824,0.508328192474,488,0.301048735349,1133,0.698951264651,315,0.194324491055,043,Union,37179043
Vance,2145,1314,0.612587412587,737,0.34358974359,11,0.00512820512821,15,0.00699300699301,53,0.0247086247086,15,0.00699300699301,747,16,12,743,759,10,0.004662004662,747,0.348251748252,72,0.0335664335664,2073,0.966433566434,1300,0.606060606061,DABN,Vance,37181DABN
Vance,2298,281,0.12228024369,1872,0.814621409922,7,0.00304612706701,2,0.000870322019147,119,0.0517841601393,17,0.00739773716275,1883,16,9,1876,1892,11,0.00478677110531,1883,0.819408181027,191,0.0831157528285,2107,0.916884247171,225,0.097911227154,EH1,Vance,37181EH1
Vance,988,323,0.326923076923,504,0.51012145749,8,0.0080971659919,3,0.00303643724696,127,0.128542510121,23,0.0232793522267,506,9,9,506,515,2,0.00202429149798,506,0.512145748988,180,0.182186234818,808,0.817813765182,289,0.292510121457,EH2,Vance,37181EH2
Vance,937,365,0.389541088581,537,0.57310565635,0,0.0,8,0.008537886873,13,0.0138740661686,14,0.0149413020277,541,1,0,540,541,4,0.0042689434365,541,0.577374599787,36,0.0384204909285,901,0.961579509072,346,0.369263607257,HTOP,Vance,37181HTOP
Vance,4333,2644,0.610200784676,1513,0.349180706208,21,0.0048465266559,7,0.0016155088853,126,0.0290791599354,22,0.00507731363951,1521,30,30,1521,1551,8,0.00184629586891,1521,0.351027002077,188,0.0433879529195,4145,0.956612047081,2603,0.600738518348,KITT,Vance,37181KITT
Vance,2875,1468,0.510608695652,1346,0.468173913043,2,0.000695652173913,9,0.00313043478261,24,0.00834782608696,26,0.00904347826087,1364,22,9,1351,1373,18,0.00626086956522,1364,0.474434782609,44,0.0153043478261,2831,0.984695652174,1455,0.506086956522,MIDD,Vance,37181MIDD
Vance,2565,359,0.139961013645,2128,0.82962962963,5,0.00194931773879,11,0.00428849902534,20,0.00779727095517,42,0.0163742690058,2168,31,6,2143,2174,40,0.0155945419103,2168,0.84522417154,51,0.0198830409357,2514,0.980116959064,345,0.134502923977,NH1,Vance,37181NH1
Vance,916,465,0.507641921397,432,0.471615720524,2,0.00218340611354,4,0.00436681222707,9,0.00982532751092,4,0.00436681222707,435,5,3,433,438,3,0.00327510917031,435,0.474890829694,24,0.0262008733624,892,0.973799126638,453,0.494541484716,NH2,Vance,37181NH2
Vance,4829,2727,0.564713191137,1873,0.387864982398,16,0.00331331538621,7,0.00144957548147,168,0.0347898115552,38,0.00786912404224,1888,30,23,1881,1911,15,0.00310623317457,1888,0.390971215573,331,0.0685442120522,4498,0.931455787948,2599,0.538206668047,SCRK,Vance,37181SCRK
Vance,2587,772,0.298415152687,1609,0.621955933514,11,0.00425202937766,6,0.00231928875145,166,0.0641669887901,23,0.00889060688056,1625,27,18,1616,1643,16,0.00618477000387,1625,0.628140703518,300,0.115964437572,2287,0.884035562428,668,0.258214147661,SH1,Vance,37181SH1
Vance,1188,587,0.494107744108,450,0.378787878788,3,0.00252525252525,3,0.00252525252525,125,0.105218855219,20,0.016835016835,456,14,13,455,469,6,0.00505050505051,456,0.383838383838,185,0.155723905724,1003,0.844276094276,541,0.455387205387,SH2,Vance,37181SH2
Vance,1089,530,0.48668503214,537,0.493112947658,0,0.0,2,0.00183654729109,11,0.010101010101,9,0.00826446280992,543,5,3,541,546,6,0.00550964187328,543,0.498622589532,13,0.0119375573921,1076,0.988062442608,528,0.484848484848,TWNS,Vance,37181TWNS
Vance,504,483,0.958333333333,18,0.0357142857143,0,0.0,2,0.00396825396825,1,0.00198412698413,0,0.0,18,0,0,18,18,0,0.0,18,0.0357142857143,3,0.00595238095238,501,0.994047619048,481,0.954365079365,WATK,Vance,37181WATK
Vance,2930,1989,0.678839590444,844,0.288054607509,8,0.00273037542662,40,0.0136518771331,25,0.00853242320819,24,0.00819112627986,856,20,14,850,870,12,0.00409556313993,856,0.292150170648,42,0.0143344709898,2888,0.98566552901,1977,0.674744027304,WH1,Vance,37181WH1
Vance,1220,573,0.469672131148,592,0.485245901639,6,0.00491803278689,25,0.0204918032787,9,0.00737704918033,15,0.0122950819672,602,10,8,600,610,10,0.00819672131148,602,0.493442622951,15,0.0122950819672,1205,0.987704918033,570,0.467213114754,WH2,Vance,37181WH2
Vance,2477,1147,0.463060153411,1261,0.509083568833,2,0.000807428340735,4,0.00161485668147,31,0.0125151392814,32,0.0129188534518,1284,11,6,1279,1290,23,0.00928542591845,1284,0.518368994752,57,0.0230117077109,2420,0.976988292289,1135,0.458215583367,WMSB,Vance,37181WMSB
Wake,2313,1853,0.80112408128,307,0.132728058798,12,0.00518806744488,66,0.0285343709468,38,0.0164288802421,37,0.0159965412884,321,25,20,316,341,14,0.00605274535236,321,0.13878080415,99,0.0428015564202,2214,0.95719844358,1804,0.779939472546,01-01,Wake,3718301-01
Wake,3005,2716,0.903826955075,168,0.0559068219634,6,0.00199667221298,54,0.0179700499168,18,0.00599001663894,43,0.014309484193,182,16,14,180,196,14,0.00465890183028,182,0.0605657237937,85,0.0282861896839,2920,0.971713810316,2657,0.884193011647,01-02,Wake,3718301-02
Wake,1901,1830,0.962651236191,30,0.0157811678064,5,0.0026301946344,15,0.00789058390321,5,0.0026301946344,16,0.00841662283009,34,14,12,32,46,4,0.00210415570752,34,0.0178853235139,25,0.013150973172,1876,0.986849026828,1815,0.954760652288,01-03,Wake,3718301-03
Wake,1187,1142,0.962089300758,16,0.0134793597304,1,0.000842459983151,6,0.0050547598989,11,0.00926705981466,11,0.00926705981466,23,6,2,19,25,7,0.00589721988206,23,0.0193765796125,20,0.016849199663,1167,0.983150800337,1131,0.952822240944,01-04,Wake,3718301-04
Wake,1084,999,0.921586715867,74,0.0682656826568,1,0.000922509225092,5,0.00461254612546,0,0.0,5,0.00461254612546,77,3,2,76,79,3,0.00276752767528,77,0.0710332103321,9,0.00830258302583,1075,0.991697416974,990,0.913284132841,01-05,Wake,3718301-05
Wake,2760,2578,0.934057971014,85,0.0307971014493,7,0.00253623188406,43,0.0155797101449,12,0.00434782608696,35,0.0126811594203,96,21,13,88,109,11,0.00398550724638,96,0.0347826086957,61,0.0221014492754,2699,0.977898550725,2536,0.91884057971,01-06,Wake,3718301-06
Wake,1921,1514,0.788131181676,301,0.156689224362,6,0.0031233732431,49,0.025507548152,19,0.00989068193649,32,0.0166579906299,311,20,15,306,326,10,0.00520562207184,311,0.161894846434,64,0.0333159812598,1857,0.96668401874,1474,0.767308693389,01-07,Wake,3718301-07
Wake,1146,1100,0.959860383944,15,0.0130890052356,2,0.00174520069808,11,0.00959860383944,6,0.00523560209424,12,0.0104712041885,17,5,5,17,22,2,0.00174520069808,17,0.0148342059337,16,0.0139616055846,1130,0.986038394415,1092,0.952879581152,01-09,Wake,3718301-09
Wake,1321,1289,0.975775927328,17,0.0128690386071,3,0.00227100681302,7,0.00529901589705,0,0.0,5,0.00378501135503,18,3,3,18,21,1,0.000757002271007,18,0.0136260408781,14,0.0105980317941,1307,0.989401968206,1276,0.965934897805,01-10,Wake,3718301-10
Wake,1862,1825,0.980128893663,9,0.00483351235231,0,0.0,14,0.00751879699248,1,0.000537056928034,13,0.00698174006445,17,5,1,13,18,8,0.00429645542427,17,0.00912996777658,23,0.0123523093448,1839,0.987647690655,1802,0.967776584318,01-11,Wake,3718301-11
Wake,1890,1567,0.829100529101,226,0.119576719577,6,0.0031746031746,13,0.00687830687831,60,0.031746031746,18,0.00952380952381,235,10,7,232,242,9,0.0047619047619,235,0.124338624339,118,0.0624338624339,1772,0.937566137566,1514,0.801058201058,01-12,Wake,3718301-12
Wake,1664,1176,0.706730769231,408,0.245192307692,8,0.00480769230769,17,0.0102163461538,36,0.0216346153846,19,0.0114182692308,417,17,15,415,432,9,0.00540865384615,417,0.250600961538,66,0.0396634615385,1598,0.960336538462,1153,0.692908653846,01-13,Wake,3718301-13
Wake,3503,2598,0.741650014273,737,0.210391093349,13,0.00371110476734,46,0.0131316014844,57,0.0162717670568,52,0.0148444190694,763,36,22,749,785,26,0.00742220953468,763,0.217813302883,142,0.0405366828433,3361,0.959463317157,2528,0.721667142449,01-14,Wake,3718301-14
Wake,1485,1320,0.888888888889,100,0.0673400673401,1,0.000673400673401,29,0.0195286195286,16,0.0107744107744,19,0.0127946127946,112,11,6,107,118,12,0.00808080808081,112,0.0754208754209,35,0.023569023569,1450,0.976430976431,1297,0.873400673401,01-15,Wake,3718301-15
Wake,3230,2304,0.713312693498,467,0.144582043344,22,0.00681114551084,128,0.0396284829721,233,0.0721362229102,76,0.0235294117647,503,42,31,492,534,36,0.0111455108359,503,0.15572755418,424,0.131269349845,2806,0.868730650155,2169,0.671517027864,01-16,Wake,3718301-16
Wake,1130,1076,0.952212389381,19,0.016814159292,4,0.00353982300885,19,0.016814159292,1,0.000884955752212,11,0.00973451327434,27,8,4,23,31,8,0.0070796460177,27,0.0238938053097,18,0.0159292035398,1112,0.98407079646,1059,0.937168141593,01-17,Wake,3718301-17
Wake,4124,2547,0.617604267701,818,0.198351115422,27,0.00654704170708,131,0.0317652764306,511,0.123908826382,90,0.0218234723569,857,58,46,845,903,39,0.00945683802134,857,0.207807953443,1046,0.253637245393,3078,0.746362754607,2089,0.506547041707,01-18,Wake,3718301-18
Wake,2167,237,0.109367789571,1664,0.767881864329,5,0.00230733733272,15,0.00692201199815,221,0.101984310106,25,0.0115366866636,1677,17,12,1672,1689,13,0.00599907706507,1677,0.773880941394,355,0.163820950623,1812,0.836179049377,129,0.0595293031841,01-19,Wake,3718301-19
Wake,2860,630,0.22027972028,2125,0.743006993007,10,0.0034965034965,14,0.0048951048951,47,0.0164335664336,34,0.0118881118881,2149,24,15,2140,2164,24,0.00839160839161,2149,0.751398601399,134,0.0468531468531,2726,0.953146853147,569,0.198951048951,01-20,Wake,3718301-20
Wake,5231,2620,0.500860256165,1648,0.315044924489,41,0.00783788950487,110,0.0210284840375,693,0.132479449436,119,0.0227489963678,1696,63,51,1684,1747,48,0.0091760657618,1696,0.32422099025,1141,0.21812272988,4090,0.78187727012,2263,0.432613267062,01-21,Wake,3718301-21
Wake,3791,332,0.0875758375099,2995,0.790029016091,17,0.00448430493274,34,0.00896860986547,356,0.0939066209443,57,0.0150356106568,3035,37,21,3019,3056,40,0.0105513057241,3035,0.800580321815,602,0.158797151147,3189,0.841202848853,165,0.0435241361118,01-22,Wake,3718301-22
Wake,12065,8689,0.720182345628,1969,0.163199336925,28,0.00232076253626,967,0.0801491918773,132,0.0109407376709,280,0.0232076253626,2075,100,66,2041,2141,106,0.00878574388728,2075,0.171985080812,403,0.0334024036469,11662,0.966597596353,8476,0.702527973477,01-23,Wake,3718301-23
Wake,868,102,0.117511520737,715,0.823732718894,2,0.00230414746544,1,0.00115207373272,19,0.0218894009217,29,0.0334101382488,742,15,3,730,745,27,0.0311059907834,742,0.854838709677,50,0.0576036866359,818,0.942396313364,89,0.102534562212,01-25,Wake,3718301-25
Wake,4854,1206,0.248454882571,3369,0.694066749073,40,0.0082406262876,16,0.00329625051504,159,0.0327564894932,64,0.0131850020602,3417,66,45,3396,3462,48,0.00988875154512,3417,0.703955500618,307,0.0632468067573,4547,0.936753193243,1120,0.230737536053,01-26,Wake,3718301-26
Wake,2472,1454,0.588187702265,712,0.288025889968,27,0.0109223300971,22,0.0088996763754,213,0.0861650485437,44,0.0177993527508,723,40,37,720,760,11,0.0044498381877,723,0.292475728155,383,0.154935275081,2089,0.845064724919,1326,0.53640776699,01-27,Wake,3718301-27
Wake,3996,1347,0.337087087087,2383,0.596346346346,14,0.0035035035035,32,0.00800800800801,142,0.0355355355355,78,0.0195195195195,2431,50,25,2406,2456,48,0.012012012012,2431,0.608358358358,271,0.0678178178178,3725,0.932182182182,1250,0.312812812813,01-28,Wake,3718301-28
Wake,2139,2071,0.968209443665,37,0.0172978027115,2,0.000935016362786,11,0.00514258999532,10,0.00467508181393,8,0.00374006545115,40,5,3,38,43,3,0.00140252454418,40,0.0187003272557,35,0.0163627863488,2104,0.983637213651,2048,0.957456755493,01-29,Wake,3718301-29
Wake,1198,1134,0.946577629382,49,0.0409015025042,0,0.0,7,0.00584307178631,2,0.0016694490818,6,0.00500834724541,50,0,0,50,50,1,0.000834724540902,50,0.0417362270451,9,0.00751252086811,1189,0.992487479132,1129,0.942404006678,01-30,Wake,3718301-30
Wake,6803,3460,0.508599147435,1531,0.225047773041,32,0.00470380714391,1147,0.168602087314,429,0.063060414523,204,0.0299867705424,1593,90,64,1567,1657,62,0.00911362634132,1593,0.234161399383,745,0.109510510069,6058,0.890489489931,3252,0.478024401,01-31,Wake,3718301-31
Wake,3516,2371,0.674345847554,654,0.186006825939,24,0.00682593856655,130,0.0369738339022,232,0.06598407281,105,0.0298634812287,703,58,49,694,752,49,0.01393629124,703,0.199943117179,402,0.11433447099,3114,0.88566552901,2253,0.640784982935,01-32,Wake,3718301-32
Wake,1638,1302,0.794871794872,92,0.0561660561661,3,0.0018315018315,217,0.132478632479,6,0.003663003663,18,0.010989010989,96,7,5,94,101,4,0.002442002442,96,0.0586080586081,35,0.0213675213675,1603,0.978632478632,1274,0.777777777778,01-33,Wake,3718301-33
Wake,2607,208,0.0797851937092,2305,0.884158036057,9,0.00345224395857,4,0.00153433064825,31,0.011891062524,50,0.0191791331032,2353,32,10,2331,2363,48,0.0184119677791,2353,0.902570003836,93,0.0356731875719,2514,0.964326812428,179,0.0686612965094,01-34,Wake,3718301-34
Wake,3252,294,0.090405904059,2346,0.721402214022,26,0.0079950799508,4,0.00123001230012,503,0.15467404674,79,0.0242927429274,2392,49,32,2375,2424,46,0.0141451414514,2392,0.735547355474,790,0.242927429274,2462,0.757072570726,76,0.0233702337023,01-35,Wake,3718301-35
Wake,1829,1577,0.862219792236,161,0.0880262438491,1,0.000546746856206,28,0.0153089119738,32,0.0174958993986,30,0.0164024056862,170,11,8,167,178,9,0.00492072170585,170,0.0929469655549,69,0.0377255330782,1760,0.962274466922,1555,0.8501913614,01-36,Wake,3718301-36
Wake,1900,1679,0.883684210526,147,0.0773684210526,4,0.00210526315789,49,0.0257894736842,14,0.00736842105263,7,0.00368421052632,149,6,6,149,155,2,0.00105263157895,149,0.0784210526316,62,0.0326315789474,1838,0.967368421053,1633,0.859473684211,01-37,Wake,3718301-37
Wake,2810,1614,0.574377224199,718,0.255516014235,15,0.00533807829181,144,0.0512455516014,259,0.0921708185053,60,0.0213523131673,745,37,28,736,773,27,0.00960854092527,745,0.26512455516,427,0.151957295374,2383,0.848042704626,1485,0.52846975089,01-38,Wake,3718301-38
Wake,3068,2028,0.661016949153,823,0.268252933507,12,0.00391134289439,40,0.013037809648,77,0.0250977835724,88,0.0286831812256,875,34,21,862,896,52,0.0169491525424,875,0.28520208605,168,0.0547588005215,2900,0.945241199478,1967,0.641134289439,01-39,Wake,3718301-39
Wake,5942,864,0.145405587344,4179,0.703298552676,55,0.00925614271289,92,0.0154830023561,643,0.108212722989,109,0.0183439919219,4247,89,67,4225,4314,68,0.0114439582632,4247,0.714742510939,1151,0.193705822955,4791,0.806294177045,493,0.0829686974083,01-40,Wake,3718301-40
Wake,3791,2541,0.670271696122,381,0.100501187022,23,0.00606700079135,652,0.171986283303,122,0.0321814824585,72,0.0189923503034,414,52,35,397,449,33,0.00870482722237,414,0.109206014244,242,0.0638353996307,3549,0.936164600369,2450,0.6462674756,01-41,Wake,3718301-41
Wake,2766,2399,0.867317425886,190,0.0686912509038,10,0.00361532899494,115,0.0415762834418,28,0.0101229211858,24,0.00867678958785,196,17,14,193,210,6,0.00216919739696,196,0.0708604483008,79,0.02856109906,2687,0.97143890094,2353,0.850686912509,01-42,Wake,3718301-42
Wake,3220,2013,0.625155279503,772,0.239751552795,25,0.00776397515528,58,0.0180124223602,262,0.0813664596273,90,0.027950310559,817,47,39,809,856,45,0.0139751552795,817,0.253726708075,522,0.162111801242,2698,0.837888198758,1822,0.565838509317,01-43,Wake,3718301-43
Wake,4577,2696,0.589032117107,1225,0.267642560629,19,0.00415119073629,102,0.0222853397422,447,0.0976622241643,88,0.0192265676207,1258,48,34,1244,1292,33,0.00720996285777,1258,0.274852523487,706,0.154249508412,3871,0.845750491588,2517,0.549923530697,01-44,Wake,3718301-44
Wake,2586,1620,0.626450116009,487,0.188321732405,3,0.00116009280742,175,0.0676720804331,230,0.0889404485692,71,0.0274555297757,506,29,26,503,532,19,0.00734725444702,506,0.195668986852,416,0.16086620263,2170,0.83913379737,1458,0.563805104408,01-45,Wake,3718301-45
Wake,5226,1412,0.270187523919,2391,0.457520091848,54,0.0103329506315,199,0.0380788365863,997,0.190776884807,173,0.0331037122082,2493,100,74,2467,2567,102,0.0195177956372,2493,0.477037887486,1747,0.334290088021,3479,0.665709911979,915,0.175086107922,01-46,Wake,3718301-46
Wake,2126,1923,0.904515522107,123,0.0578551269991,5,0.00235183443086,51,0.0239887111947,8,0.00376293508937,16,0.00752587017874,128,12,10,126,138,5,0.00235183443086,128,0.0602069614299,42,0.0197554092192,2084,0.980244590781,1896,0.891815616181,01-47,Wake,3718301-47
Wake,2680,2062,0.769402985075,344,0.128358208955,16,0.00597014925373,106,0.039552238806,90,0.0335820895522,62,0.0231343283582,369,31,25,363,394,25,0.00932835820896,369,0.137686567164,224,0.0835820895522,2456,0.916417910448,1958,0.730597014925,01-48,Wake,3718301-48
Wake,3773,2146,0.568778160615,1004,0.266101245693,22,0.00583090379009,224,0.0593692022263,281,0.0744765438643,96,0.0254439438113,1044,45,31,1030,1075,40,0.0106016432547,1044,0.276702888948,450,0.119268486615,3323,0.880731513385,2012,0.533262655712,01-49,Wake,3718301-49
Wake,2451,207,0.0844553243574,2074,0.846185230518,18,0.00734394124847,41,0.0167278661771,86,0.0350877192982,25,0.0101999184007,2091,26,19,2084,2110,17,0.00693594451244,2091,0.853121175031,159,0.0648714810282,2292,0.935128518972,151,0.0616075071399,01-50,Wake,3718301-50
Wake,1187,1006,0.84751474305,129,0.108677337826,0,0.0,13,0.010951979781,18,0.0151642796967,21,0.0176916596462,133,7,5,131,138,4,0.0033698399326,133,0.112047177759,49,0.0412805391744,1138,0.958719460826,989,0.833192923336,01-51,Wake,3718301-51
Wake,3019,2650,0.877774097383,192,0.0635972176217,5,0.00165617754223,132,0.0437230871149,11,0.00364359059291,29,0.00960582974495,199,12,11,198,210,7,0.00231864855913,199,0.0659158661809,75,0.0248426631335,2944,0.975157336867,2591,0.858231202385,02-01,Wake,3718302-01
Wake,4735,4245,0.89651531151,288,0.0608236536431,7,0.00147835269271,112,0.0236536430834,30,0.00633579725449,53,0.0111932418163,296,29,24,291,320,8,0.00168954593453,296,0.0625131995776,144,0.0304118268215,4591,0.969588173178,4145,0.875395987328,02-02,Wake,3718302-02
Wake,2617,2432,0.929308368361,77,0.0294230034391,2,0.00076423385556,64,0.0244554833779,12,0.00458540313336,30,0.0114635078334,86,13,7,80,93,9,0.00343905235002,86,0.0328620557891,49,0.0187237294612,2568,0.981276270539,2398,0.916316392816,02-03,Wake,3718302-03
Wake,2191,2001,0.913281606572,76,0.0346873573711,4,0.00182565038795,80,0.036513007759,11,0.00502053856686,19,0.00867183934277,78,13,11,76,89,2,0.000912825193975,78,0.035600182565,43,0.0196257416705,2148,0.98037425833,1971,0.899589228663,02-04,Wake,3718302-04
Wake,937,849,0.906083244397,33,0.0352187833511,5,0.00533617929562,43,0.0458911419424,4,0.0042689434365,3,0.00320170757737,33,7,7,33,40,0,0.0,33,0.0352187833511,17,0.0181430096051,920,0.981856990395,838,0.894343649947,02-05,Wake,3718302-05
Wake,2382,2151,0.903022670025,102,0.0428211586902,5,0.00209907640638,90,0.0377833753149,11,0.00461796809404,23,0.00965575146935,106,10,7,103,113,4,0.0016792611251,106,0.0445004198153,44,0.0184718723762,2338,0.981528127624,2122,0.890848026868,02-06,Wake,3718302-06
Wake,2255,1747,0.774722838137,273,0.121064301552,21,0.00931263858093,111,0.0492239467849,42,0.0186252771619,61,0.0270509977827,303,50,30,283,333,30,0.0133037694013,303,0.134368070953,93,0.0412416851441,2162,0.958758314856,1710,0.758314855876,03-00,Wake,3718303-00
Wake,2451,1903,0.776417788658,291,0.118727050184,17,0.00693594451244,54,0.0220318237454,138,0.0563035495716,48,0.0195838433293,314,34,28,308,342,23,0.0093839249286,314,0.128110975112,289,0.117911056712,2162,0.882088943288,1779,0.72582619339,04-01,Wake,3718304-01
Wake,3764,2587,0.687300743889,294,0.0781083953241,50,0.0132837407014,174,0.0462274176408,589,0.156482465462,70,0.0185972369819,319,68,63,314,382,25,0.00664187035069,319,0.0847502656748,1196,0.317747077577,2568,0.682252922423,2067,0.549149840595,04-02,Wake,3718304-02
Wake,2616,1758,0.672018348624,465,0.177752293578,18,0.00688073394495,147,0.0561926605505,160,0.0611620795107,68,0.025993883792,491,45,38,484,529,26,0.00993883792049,491,0.187691131498,419,0.160168195719,2197,0.839831804281,1545,0.590596330275,04-03,Wake,3718304-03
Wake,2565,1552,0.605068226121,458,0.178557504873,11,0.00428849902534,93,0.0362573099415,362,0.141130604288,89,0.0346978557505,487,46,31,472,518,29,0.011306042885,487,0.189863547758,617,0.240545808967,1948,0.759454191033,1345,0.524366471735,04-04,Wake,3718304-04
Wake,2877,2223,0.77267987487,177,0.0615224191867,10,0.0034758428919,397,0.137990962808,20,0.0069516857838,50,0.0173792144595,186,22,20,184,206,9,0.00312825860271,186,0.0646506777894,104,0.0361487660758,2773,0.963851233924,2152,0.748001390337,04-05,Wake,3718304-05
Wake,3019,2636,0.873136800265,194,0.0642596886386,7,0.00231864855913,108,0.0357734349122,37,0.0122557138125,37,0.0122557138125,211,26,15,200,226,17,0.00563100364359,211,0.0698906922822,100,0.0331235508447,2919,0.966876449155,2578,0.853925140775,04-06,Wake,3718304-06
Wake,2548,2373,0.931318681319,36,0.0141287284144,6,0.00235478806907,106,0.041601255887,14,0.00549450549451,13,0.00510204081633,36,10,10,36,46,0,0.0,36,0.0141287284144,62,0.0243328100471,2486,0.975667189953,2324,0.912087912088,04-07,Wake,3718304-07
Wake,2491,1735,0.696507426736,347,0.139301485347,8,0.00321156162184,279,0.112003211562,62,0.0248896025692,60,0.0240867121638,372,30,20,362,392,25,0.0100361300682,372,0.149337615415,189,0.0758731433159,2302,0.924126856684,1621,0.650742673625,04-08,Wake,3718304-08
Wake,2649,2077,0.784069460174,158,0.0596451491129,7,0.00264250660627,345,0.130237825595,29,0.0109475273688,33,0.0124575311438,169,15,11,165,180,11,0.00415251038128,169,0.0637976594941,98,0.0369950924877,2551,0.963004907512,2001,0.755379388448,04-09,Wake,3718304-09
Wake,2890,2415,0.835640138408,147,0.0508650519031,8,0.00276816608997,257,0.0889273356401,26,0.00899653979239,37,0.0128027681661,154,21,17,150,171,7,0.00242214532872,154,0.0532871972318,124,0.0429065743945,2766,0.957093425606,2329,0.805882352941,04-10,Wake,3718304-10
Wake,1935,1300,0.671834625323,276,0.142635658915,34,0.0175710594315,159,0.0821705426357,122,0.0630490956072,44,0.0227390180879,290,48,46,288,336,14,0.00723514211886,290,0.149870801034,321,0.165891472868,1614,0.834108527132,1146,0.592248062016,04-11,Wake,3718304-11
Wake,2781,2474,0.889608054657,119,0.0427903631787,3,0.00107874865156,127,0.0456670262496,24,0.00862998921251,34,0.0122258180511,129,14,8,123,137,10,0.00359582883855,129,0.0463861920173,95,0.0341603739662,2686,0.965839626034,2408,0.865875584322,04-12,Wake,3718304-12
Wake,4279,3163,0.73919139986,232,0.054218275298,4,0.000934797849965,795,0.185791072681,35,0.00817948118719,50,0.0116849731246,243,13,10,240,253,11,0.0025706940874,243,0.0567889693854,142,0.0331853236738,4137,0.966814676326,3063,0.715821453611,04-13,Wake,3718304-13
Wake,1772,1593,0.898984198646,88,0.0496613995485,3,0.00169300225734,36,0.020316027088,24,0.0135440180587,28,0.0158013544018,96,20,16,92,112,8,0.00451467268623,96,0.0541760722348,97,0.0547404063205,1675,0.945259593679,1532,0.864559819413,04-14,Wake,3718304-14
Wake,2197,1846,0.840236686391,168,0.0764679107874,6,0.00273099681384,146,0.0664542558034,12,0.00546199362767,19,0.00864815657715,171,15,15,171,186,3,0.00136549840692,171,0.0778334091944,98,0.0446062812927,2099,0.955393718707,1769,0.805188893946,04-15,Wake,3718304-15
Wake,2215,1947,0.879006772009,115,0.0519187358916,14,0.00632054176072,85,0.038374717833,25,0.0112866817156,29,0.0130925507901,120,20,16,116,136,5,0.00225733634312,120,0.0541760722348,70,0.0316027088036,2145,0.968397291196,1909,0.861851015801,04-16,Wake,3718304-16
Wake,2110,1699,0.805213270142,204,0.096682464455,10,0.00473933649289,147,0.0696682464455,19,0.00900473933649,31,0.014691943128,212,19,16,209,228,8,0.00379146919431,212,0.100473933649,119,0.0563981042654,1991,0.943601895735,1619,0.767298578199,04-17,Wake,3718304-17
Wake,2874,2093,0.728253305498,265,0.0922059846903,7,0.00243562978427,423,0.147181628392,42,0.0146137787056,44,0.0153096729297,279,23,16,272,295,14,0.00487125956855,279,0.0970772442589,116,0.0403618649965,2758,0.959638135003,2024,0.704244954767,04-18,Wake,3718304-18
Wake,1747,1525,0.87292501431,50,0.0286204922725,2,0.0011448196909,131,0.0749856897539,11,0.00629650829994,28,0.0160274756726,53,9,8,52,61,3,0.00171722953635,53,0.0303377218088,62,0.0354894104179,1685,0.964510589582,1476,0.844876931883,04-19,Wake,3718304-19
Wake,3636,2648,0.728272827283,384,0.105610561056,21,0.00577557755776,282,0.0775577557756,228,0.0627062706271,73,0.0200770077008,408,41,31,398,439,24,0.00660066006601,408,0.112211221122,449,0.123487348735,3187,0.876512651265,2458,0.67601760176,04-20,Wake,3718304-20
Wake,2480,1501,0.605241935484,535,0.215725806452,20,0.00806451612903,224,0.0903225806452,116,0.0467741935484,84,0.0338709677419,567,53,40,554,607,32,0.0129032258065,567,0.228629032258,308,0.124193548387,2172,0.875806451613,1347,0.54314516129,04-21,Wake,3718304-21
Wake,4628,3217,0.695116681072,597,0.128997407087,23,0.00496974935177,631,0.136343993086,79,0.017070008643,81,0.0175021607606,629,53,40,616,669,32,0.00691443388073,629,0.135911840968,265,0.0572601555748,4363,0.942739844425,3055,0.660112359551,05-01,Wake,3718305-01
Wake,3321,2213,0.666365552544,289,0.0870219813309,14,0.00421559771153,715,0.21529659741,54,0.0162601626016,36,0.0108401084011,300,26,22,296,322,11,0.00331225534478,300,0.0903342366757,142,0.0427582053598,3179,0.95724179464,2131,0.64167419452,05-03,Wake,3718305-03
Wake,10250,5190,0.506341463415,1147,0.111902439024,25,0.00243902439024,3491,0.340585365854,166,0.0161951219512,231,0.0225365853659,1213,84,63,1192,1276,66,0.00643902439024,1213,0.118341463415,526,0.0513170731707,9724,0.948682926829,4877,0.475804878049,05-04,Wake,3718305-04
Wake,6911,4606,0.66647373752,1353,0.195774851686,19,0.00274924034148,675,0.0976703805527,96,0.0138908985675,162,0.0234408913327,1433,63,38,1408,1471,80,0.0115757488063,1433,0.207350600492,343,0.0496310230068,6568,0.950368976993,4403,0.637100274924,05-05,Wake,3718305-05
Wake,4796,3482,0.726021684737,193,0.0402418682235,4,0.000834028356964,1035,0.215804837364,23,0.00479566305254,59,0.0123019182652,202,10,10,202,212,9,0.00187656380317,202,0.0421184320267,130,0.0271059216013,4666,0.972894078399,3377,0.704128440367,05-06,Wake,3718305-06
Wake,7386,5754,0.779041429732,1176,0.159220146223,47,0.00636339019767,166,0.0224749526131,148,0.0200379095586,95,0.0128621716761,1212,70,63,1205,1275,36,0.00487408610885,1212,0.164094232331,448,0.0606552937991,6938,0.939344706201,5478,0.741673436231,06-01,Wake,3718306-01
Wake,2467,1754,0.710985002027,537,0.217673287394,4,0.00162140251317,46,0.0186461289015,85,0.0344548034049,41,0.01661937576,552,23,16,545,568,15,0.0060802594244,552,0.223753546818,188,0.0762059181192,2279,0.923794081881,1671,0.677340899878,06-04,Wake,3718306-04
Wake,2887,2671,0.925181849671,155,0.0536889504676,4,0.00138552130239,22,0.00762036716315,16,0.00554208520956,19,0.00658122618635,168,17,7,158,175,13,0.00450294423277,168,0.0581918947004,90,0.0311742293038,2797,0.968825770696,2601,0.900935226879,06-05,Wake,3718306-05
Wake,4304,3350,0.778345724907,544,0.126394052045,30,0.00697026022305,241,0.0559944237918,55,0.0127788104089,84,0.0195167286245,589,54,40,575,629,45,0.0104553903346,589,0.136849442379,215,0.0499535315985,4089,0.950046468401,3216,0.747211895911,06-06,Wake,3718306-06
Wake,3555,2703,0.760337552743,483,0.135864978903,12,0.00337552742616,232,0.0652601969058,89,0.025035161744,36,0.0101265822785,495,26,24,493,519,12,0.00337552742616,495,0.139240506329,251,0.0706047819972,3304,0.929395218003,2555,0.71870604782,06-07,Wake,3718306-07
Wake,2164,1573,0.726894639556,358,0.165434380776,16,0.00739371534196,38,0.0175600739372,142,0.0656192236599,37,0.0170979667283,374,31,23,366,397,16,0.00739371534196,374,0.172828096118,295,0.136321626617,1869,0.863678373383,1450,0.670055452865,07-01,Wake,3718307-01
Wake,1578,1117,0.707858048162,302,0.191381495564,13,0.00823827629911,43,0.0272496831432,73,0.0462610899873,30,0.0190114068441,312,21,16,307,328,10,0.0063371356147,312,0.197718631179,140,0.0887198986058,1438,0.911280101394,1066,0.675538656527,07-02,Wake,3718307-02
Wake,1592,1415,0.888819095477,97,0.0609296482412,1,0.000628140703518,32,0.0201005025126,27,0.016959798995,20,0.0125628140704,104,4,3,103,107,7,0.00439698492462,104,0.0653266331658,57,0.0358040201005,1535,0.964195979899,1391,0.873743718593,07-03,Wake,3718307-03
Wake,4834,3457,0.715142738933,1009,0.208729830368,22,0.0045510964005,111,0.0229623500207,150,0.0310302027307,85,0.0175837815474,1041,48,38,1031,1079,32,0.00661977658254,1041,0.215349606951,344,0.0711625982623,4490,0.928837401738,3322,0.687215556475,07-04,Wake,3718307-04
Wake,2023,1552,0.767177459219,328,0.162135442412,9,0.00444883835887,34,0.0168067226891,81,0.0400395452299,19,0.00939199209095,339,11,11,339,350,11,0.00543746910529,339,0.167572911518,163,0.0805734058329,1860,0.919426594167,1484,0.733564013841,07-05,Wake,3718307-05
Wake,3420,3031,0.886257309942,185,0.0540935672515,7,0.00204678362573,109,0.0318713450292,49,0.0143274853801,39,0.0114035087719,201,21,17,197,218,16,0.0046783625731,201,0.0587719298246,146,0.0426900584795,3274,0.95730994152,2938,0.859064327485,07-06,Wake,3718307-06
Wake,4501,3884,0.862919351255,382,0.0848700288825,6,0.00133303710287,129,0.0286602977116,53,0.0117751610753,47,0.0104421239725,402,18,13,397,415,20,0.00444345700955,402,0.089313485892,158,0.0351033103755,4343,0.964896689625,3789,0.84181293046,07-07,Wake,3718307-07
Wake,3748,2728,0.727854855923,419,0.111792956243,21,0.00560298826041,172,0.0458911419424,343,0.09151547492,65,0.0173425827108,440,42,34,432,474,21,0.00560298826041,440,0.117395944504,539,0.143810032017,3209,0.856189967983,2562,0.683564567769,07-09,Wake,3718307-09
Wake,5746,4080,0.710059171598,1040,0.180995475113,23,0.00400278454577,316,0.0549947789767,195,0.0339366515837,92,0.0160111381831,1078,53,36,1061,1114,38,0.00661329620606,1078,0.187608771319,451,0.0784893839192,5295,0.921510616081,3859,0.671597633136,07-10,Wake,3718307-10
Wake,1065,998,0.937089201878,36,0.0338028169014,0,0.0,26,0.0244131455399,1,0.00093896713615,4,0.0037558685446,37,2,1,36,38,1,0.00093896713615,37,0.0347417840376,23,0.0215962441315,1042,0.978403755869,977,0.917370892019,07-11,Wake,3718307-11
Wake,2972,2167,0.729138627187,507,0.170592193809,3,0.00100942126514,59,0.0198519515478,176,0.0592193808883,60,0.0201884253028,538,22,16,532,554,31,0.0104306864065,538,0.181022880215,336,0.113055181696,2636,0.886944818304,2033,0.684051144011,07-12,Wake,3718307-12
Wake,2050,1545,0.753658536585,361,0.176097560976,9,0.00439024390244,62,0.030243902439,50,0.0243902439024,23,0.0112195121951,376,12,11,375,387,15,0.00731707317073,376,0.183414634146,111,0.0541463414634,1939,0.945853658537,1497,0.730243902439,07-13,Wake,3718307-13
Wake,4117,3300,0.801554529998,516,0.125333981054,14,0.00340053436969,162,0.0393490405635,60,0.0145737187272,65,0.0157881952878,543,29,24,538,567,27,0.00655817342725,543,0.131892154481,170,0.0412922030605,3947,0.95870779694,3215,0.780908428467,08-02,Wake,3718308-02
Wake,4708,3621,0.769116397621,604,0.128292268479,9,0.00191163976211,332,0.0705182667799,61,0.0129566694987,81,0.017204757859,638,39,24,623,662,34,0.0072217502124,638,0.135514018692,228,0.0484282073067,4480,0.951571792693,3478,0.738742565845,08-03,Wake,3718308-03
Wake,1603,1500,0.93574547723,50,0.0311915159077,1,0.000623830318153,35,0.0218340611354,1,0.000623830318153,16,0.00998128509046,56,7,5,54,61,6,0.00374298190892,56,0.0349344978166,41,0.0255770430443,1562,0.974422956956,1464,0.913287585777,08-04,Wake,3718308-04
Wake,2020,1791,0.886633663366,128,0.0633663366337,5,0.00247524752475,64,0.0316831683168,14,0.00693069306931,18,0.00891089108911,132,17,14,129,146,4,0.0019801980198,132,0.0653465346535,48,0.0237623762376,1972,0.976237623762,1760,0.871287128713,08-05,Wake,3718308-05
Wake,3025,1955,0.646280991736,816,0.269752066116,20,0.00661157024793,61,0.0201652892562,102,0.0337190082645,71,0.0234710743802,848,51,38,835,886,32,0.0105785123967,848,0.280330578512,237,0.078347107438,2788,0.921652892562,1865,0.61652892562,08-06,Wake,3718308-06
Wake,2298,2049,0.891644908616,99,0.0430809399478,2,0.000870322019147,116,0.0504786771105,10,0.00435161009574,22,0.00957354221062,101,7,6,100,107,2,0.000870322019147,101,0.0439512619669,51,0.0221932114883,2247,0.977806788512,2018,0.878154917319,08-07,Wake,3718308-07
Wake,4045,3581,0.885290482077,242,0.059826946848,14,0.00346106304079,144,0.0355995055624,16,0.00395550061805,48,0.0118665018541,252,26,22,248,274,10,0.00247218788628,252,0.0622991347342,142,0.0351050679852,3903,0.964894932015,3460,0.855377008653,08-08,Wake,3718308-08
Wake,2239,1707,0.76239392586,342,0.152746761947,4,0.00178651183564,60,0.0267976775346,86,0.0384100044663,40,0.0178651183564,349,13,9,345,358,7,0.00312639571237,349,0.15587315766,186,0.0830728003573,2053,0.916927199643,1637,0.731129968736,08-09,Wake,3718308-09
Wake,2931,2176,0.74240873422,481,0.164107813033,11,0.00375298532924,175,0.0597065847834,39,0.0133060388946,49,0.0167178437393,496,26,21,491,517,15,0.00511770726714,496,0.1692255203,130,0.0443534629819,2801,0.955646537018,2107,0.718867280792,08-10,Wake,3718308-10
Wake,4338,3096,0.713692946058,481,0.110880590134,15,0.00345781466113,616,0.142000922084,66,0.015214384509,64,0.0147533425542,505,31,22,496,527,24,0.00553250345781,505,0.116413093592,225,0.051867219917,4113,0.948132780083,2948,0.679575841402,08-11,Wake,3718308-11
Wake,2577,1628,0.63174233605,745,0.289095847885,10,0.00388048117967,10,0.00388048117967,163,0.0632518432286,21,0.0081490104773,754,20,14,748,768,9,0.0034924330617,754,0.292588280947,233,0.0904152114862,2344,0.909584788514,1563,0.606519208382,09-01,Wake,3718309-01
Wake,4180,2153,0.515071770335,1508,0.360765550239,20,0.00478468899522,37,0.00885167464115,377,0.0901913875598,85,0.0203349282297,1544,52,41,1533,1585,36,0.00861244019139,1544,0.369377990431,593,0.141866028708,3587,0.858133971292,2006,0.47990430622,09-02,Wake,3718309-02
Wake,2484,1831,0.737117552335,526,0.211755233494,16,0.00644122383253,26,0.0104669887279,61,0.0245571658615,24,0.00966183574879,541,25,18,534,559,15,0.006038647343,541,0.217793880837,119,0.0479066022544,2365,0.952093397746,1785,0.718599033816,09-03,Wake,3718309-03
Wake,1580,1206,0.763291139241,205,0.129746835443,11,0.00696202531646,23,0.0145569620253,100,0.0632911392405,35,0.0221518987342,223,24,17,216,240,18,0.0113924050633,223,0.141139240506,151,0.0955696202532,1429,0.904430379747,1169,0.739873417722,10-01,Wake,3718310-01
Wake,4526,2719,0.600751215201,1209,0.267123287671,32,0.00707026071586,36,0.00795404330535,435,0.0961113566063,95,0.0209898365002,1236,79,68,1225,1304,27,0.00596553247901,1236,0.27308882015,745,0.164604507291,3781,0.835395492709,2488,0.549712770658,10-02,Wake,3718310-02
Wake,3047,1863,0.611421069905,884,0.290121430916,16,0.00525106662291,24,0.00787659993436,207,0.0679356744339,53,0.0173941581884,906,42,30,894,936,22,0.0072202166065,906,0.297341647522,345,0.113226124056,2702,0.886773875944,1762,0.578273711848,10-03,Wake,3718310-03
Wake,6439,3543,0.550240720609,2196,0.341046746389,53,0.00823109178444,97,0.0150644510017,419,0.0650722161826,131,0.0203447740332,2266,119,89,2236,2355,70,0.0108712533002,2266,0.351917999689,773,0.120049697158,5666,0.879950302842,3294,0.511570119584,10-04,Wake,3718310-04
Wake,4524,3442,0.7608311229,710,0.156940760389,13,0.00287356321839,198,0.0437665782493,69,0.0152519893899,92,0.0203359858532,751,48,27,730,778,41,0.00906277630416,751,0.166003536693,201,0.0444297082228,4323,0.955570291777,3340,0.738284703802,11-01,Wake,3718311-01
Wake,4193,3588,0.855711900787,352,0.0839494395421,10,0.00238492725972,134,0.0319580252802,54,0.0128786072025,55,0.0131170999285,373,21,17,369,390,21,0.00500834724541,373,0.0889577867875,152,0.0362508943477,4041,0.963749105652,3502,0.835201526353,11-02,Wake,3718311-02
Wake,4855,4097,0.843872296601,486,0.100102986612,17,0.00350154479918,80,0.0164778578785,127,0.0261585993821,48,0.00988671472709,501,30,24,495,525,15,0.00308959835221,501,0.103192584964,324,0.0667353244078,4531,0.933264675592,3927,0.80885684861,12-01,Wake,3718312-01
Wake,3947,2882,0.730174816316,783,0.198378515328,31,0.00785406637953,64,0.016214846719,124,0.0314162655181,63,0.015961489739,811,56,42,797,853,28,0.00709399543957,811,0.205472510768,354,0.0896883709146,3593,0.910311629085,2692,0.682036990119,12-02,Wake,3718312-02
Wake,4129,3522,0.852991038992,322,0.0779849842577,24,0.00581254541051,26,0.00629692419472,166,0.0402034390894,69,0.0167110680552,341,62,50,329,391,19,0.00460159844999,341,0.0825865827077,363,0.087914749334,3766,0.912085250666,3356,0.812787599903,12-04,Wake,3718312-04
Wake,6146,5130,0.834689228767,623,0.101366742597,27,0.00439310120404,114,0.0185486495281,194,0.0315652456883,58,0.00943703221608,647,48,40,639,687,24,0.00390497884803,647,0.105271721445,475,0.0772860397006,5671,0.922713960299,4875,0.793198828506,12-05,Wake,3718312-05
Wake,3096,2491,0.804586563307,416,0.134366925065,24,0.0077519379845,44,0.0142118863049,83,0.0268087855297,38,0.0122739018088,427,45,41,423,468,11,0.00355297157623,427,0.137919896641,244,0.078811369509,2852,0.921188630491,2367,0.764534883721,12-06,Wake,3718312-06
Wake,2799,2233,0.797784923187,370,0.132190067881,15,0.005359056806,14,0.00500178635227,139,0.049660593069,28,0.0100035727045,378,27,26,377,404,8,0.00285816362987,378,0.135048231511,233,0.0832440157199,2566,0.91675598428,2136,0.763129689175,12-07,Wake,3718312-07
Wake,4374,3084,0.705075445816,1043,0.238454503887,21,0.00480109739369,88,0.0201188843164,84,0.0192043895748,54,0.0123456790123,1058,42,36,1052,1094,15,0.00342935528121,1058,0.241883859168,305,0.0697302240512,4069,0.930269775949,2893,0.661408321902,12-08,Wake,3718312-08
Wake,3148,2553,0.810991105464,396,0.125794155019,36,0.0114358322745,54,0.0171537484117,66,0.0209656925032,43,0.0136594663278,410,58,49,401,459,14,0.00444726810673,410,0.130241423126,251,0.0797331639136,2897,0.920266836086,2391,0.759529860229,12-09,Wake,3718312-09
Wake,6342,2184,0.344370860927,2817,0.444181646168,56,0.00883002207506,276,0.0435193945128,835,0.131661936298,174,0.0274361400189,2914,117,83,2880,2997,97,0.0152948596657,2914,0.459476505834,1533,0.241721854305,4809,0.758278145695,1617,0.254966887417,13-01,Wake,3718313-01
Wake,2130,1788,0.839436619718,204,0.0957746478873,5,0.00234741784038,84,0.0394366197183,19,0.00892018779343,30,0.0140845070423,210,8,8,210,218,6,0.00281690140845,210,0.0985915492958,84,0.0394366197183,2046,0.960563380282,1738,0.815962441315,13-02,Wake,3718313-02
Wake,2375,1214,0.511157894737,856,0.360421052632,13,0.00547368421053,79,0.0332631578947,151,0.0635789473684,62,0.0261052631579,885,37,25,873,910,29,0.0122105263158,885,0.372631578947,390,0.164210526316,1985,0.835789473684,1017,0.428210526316,13-05,Wake,3718313-05
Wake,3139,2368,0.754380375916,528,0.16820643517,9,0.00286715514495,151,0.0481044918764,34,0.010831474992,49,0.0156100669003,547,25,15,537,562,19,0.00605288308378,547,0.174259318254,137,0.043644472762,3002,0.956355527238,2267,0.722204523734,13-06,Wake,3718313-06
Wake,2166,1151,0.531394275162,669,0.308864265928,8,0.00369344413666,177,0.0817174515235,114,0.0526315789474,47,0.0216989843029,694,19,13,688,707,25,0.0115420129271,694,0.320406278855,253,0.116805170822,1913,0.883194829178,1055,0.487072945522,13-07,Wake,3718313-07
Wake,3258,1272,0.390423572744,1430,0.438919582566,26,0.00798035604665,123,0.0377532228361,318,0.097605893186,89,0.0273173726212,1476,56,35,1455,1511,46,0.0141190914672,1476,0.453038674033,714,0.219152854512,2544,0.780847145488,969,0.297421731123,13-08,Wake,3718313-08
Wake,4596,2016,0.43864229765,1871,0.407093124456,22,0.00478677110531,437,0.0950826805918,144,0.0313315926893,106,0.0230635335074,1948,60,29,1917,1977,77,0.0167536988686,1948,0.423846823325,400,0.0870322019147,4196,0.912967798085,1817,0.395343777198,13-09,Wake,3718313-09
Wake,5316,4507,0.847817908202,506,0.0951843491347,10,0.00188111361926,187,0.0351768246802,35,0.00658389766742,71,0.0133559066968,532,29,18,521,550,26,0.00489089541008,532,0.100075244545,216,0.0406320541761,5100,0.959367945824,4361,0.82035364936,13-10,Wake,3718313-10
Wake,3004,2602,0.866178428762,260,0.08655126498,3,0.000998668442077,94,0.0312916111851,16,0.00532623169108,29,0.00965379494008,275,11,7,271,282,15,0.00499334221039,275,0.0915446071904,102,0.0339547270306,2902,0.966045272969,2520,0.838881491345,13-11,Wake,3718313-11
Wake,782,703,0.898976982097,49,0.0626598465473,2,0.00255754475703,15,0.0191815856777,13,0.0166240409207,0,0.0,49,2,2,49,51,0,0.0,49,0.0626598465473,19,0.0242966751918,763,0.975703324808,697,0.891304347826,14-01,Wake,3718314-01
Wake,4493,4119,0.916759403517,179,0.0398397507233,15,0.00333852659693,81,0.0180280436234,69,0.0153572223459,30,0.00667705319386,189,24,22,187,211,10,0.00222568439795,189,0.0420654351213,161,0.035833518807,4332,0.964166481193,4038,0.898731359893,14-02,Wake,3718314-02
Wake,4593,3860,0.840409318528,483,0.105160026127,20,0.00435445242761,45,0.00979751796212,124,0.0269976050512,61,0.0132810799042,498,48,40,490,538,15,0.00326583932071,498,0.108425865447,279,0.0607446113651,4314,0.939255388635,3721,0.810145874156,15-01,Wake,3718315-01
Wake,5947,4468,0.751303178073,758,0.127459223138,130,0.0218597612241,135,0.0227005212712,387,0.0650748276442,69,0.0116024886497,787,148,142,781,929,29,0.00487640827308,787,0.132335631411,912,0.153354632588,5035,0.846645367412,4090,0.687741718514,15-02,Wake,3718315-02
Wake,4664,3965,0.85012864494,482,0.103344768439,29,0.00621783876501,23,0.00493138936535,88,0.0188679245283,77,0.0165094339623,510,67,57,500,567,28,0.00600343053173,510,0.109348198971,258,0.0553173241852,4406,0.944682675815,3816,0.818181818182,15-03,Wake,3718315-03
Wake,2136,1730,0.809925093633,313,0.146535580524,10,0.00468164794007,19,0.00889513108614,46,0.0215355805243,18,0.00842696629213,318,16,14,316,332,5,0.00234082397004,318,0.148876404494,96,0.0449438202247,2040,0.955056179775,1696,0.794007490637,15-04,Wake,3718315-04
Wake,3235,2447,0.756414219474,531,0.164142194745,19,0.00587326120556,39,0.0120556414219,149,0.0460587326121,50,0.015455950541,554,36,30,548,584,23,0.00710973724884,554,0.171251931994,251,0.0775888717156,2984,0.922411128284,2360,0.729520865533,16-01,Wake,3718316-01
Wake,5972,2104,0.352310783657,3075,0.514902880107,30,0.00502344273275,74,0.0123911587408,567,0.094943067649,122,0.0204286671132,3151,78,47,3120,3198,76,0.012726054923,3151,0.52762893503,1034,0.173141326189,4938,0.826858673811,1727,0.289182853315,16-02,Wake,3718316-02
Wake,2079,1233,0.593073593074,602,0.289562289562,11,0.00529100529101,19,0.00913900913901,180,0.0865800865801,34,0.016354016354,612,21,20,611,632,10,0.00481000481,612,0.294372294372,364,0.175084175084,1715,0.824915824916,1072,0.515632515633,16-03,Wake,3718316-03
Wake,2657,1824,0.686488520888,755,0.2841550621,6,0.00225818592397,16,0.0060218291306,39,0.0146782085058,17,0.00639819345126,760,8,8,760,768,5,0.00188182160331,760,0.286036883703,113,0.0425291682349,2544,0.957470831765,1773,0.667293940534,16-04,Wake,3718316-04
Wake,3147,2353,0.747696218621,557,0.176993962504,26,0.00826183666984,40,0.0127105179536,118,0.0374960279631,53,0.0168414362885,578,55,44,567,622,21,0.00667302192564,578,0.18366698443,266,0.0845249443915,2881,0.915475055609,2235,0.710200190658,16-05,Wake,3718316-05
Wake,1906,1050,0.550891920252,723,0.379328436516,3,0.00157397691501,12,0.00629590766002,80,0.0419727177335,38,0.0199370409234,738,22,15,731,753,15,0.00786988457503,738,0.387198321091,142,0.0745015739769,1764,0.925498426023,1007,0.52833158447,16-06,Wake,3718316-06
Wake,3454,2570,0.744064852345,710,0.205558772438,10,0.002895193978,65,0.018818760857,55,0.015923566879,44,0.0127388535032,733,31,15,717,748,23,0.00665894614939,733,0.212217718587,152,0.0440069484655,3302,0.955993051534,2482,0.718587145339,16-07,Wake,3718316-07
Wake,7287,1988,0.272814601345,4540,0.623027308906,41,0.00562645807603,109,0.0149581446411,472,0.0647728832167,137,0.018800603815,4631,86,53,4598,4684,91,0.0124879923151,4631,0.635515301221,944,0.129545766433,6343,0.870454233567,1653,0.226842321943,16-08,Wake,3718316-08
Wake,3562,2168,0.608646827625,1085,0.304604154969,38,0.0106681639528,88,0.0247052217855,135,0.0379000561482,48,0.0134755755194,1104,51,45,1098,1149,19,0.00533408197642,1104,0.309938236946,347,0.0974171813588,3215,0.902582818641,1996,0.560359348681,16-09,Wake,3718316-09
Wake,3791,1664,0.438934318122,1391,0.366921656555,27,0.00712213136376,202,0.0532840939066,439,0.115800580322,68,0.0179372197309,1424,53,40,1411,1464,33,0.00870482722237,1424,0.375626483777,631,0.166446847797,3160,0.833553152203,1521,0.401213400158,17-01,Wake,3718317-01
Wake,1335,865,0.647940074906,231,0.173033707865,10,0.00749063670412,11,0.00823970037453,182,0.136329588015,36,0.0269662921348,244,21,16,239,260,13,0.00973782771536,244,0.182771535581,264,0.197752808989,1071,0.802247191011,800,0.59925093633,17-02,Wake,3718317-02
Wake,6829,4025,0.589398154928,2139,0.313223019476,16,0.00234294918729,395,0.0578415580612,127,0.0185971591741,127,0.0185971591741,2198,52,35,2181,2233,59,0.00863962512813,2198,0.321862644604,385,0.0563772148192,6444,0.943622785181,3832,0.561136330356,17-03,Wake,3718317-03
Wake,5441,3181,0.584635177357,1596,0.293328432273,38,0.00698401029223,89,0.0163572872634,421,0.0773754824481,116,0.0213196103657,1639,82,56,1613,1695,43,0.00790295901489,1639,0.301231391288,760,0.139680205845,4681,0.860319794155,2923,0.537217423268,17-04,Wake,3718317-04
Wake,4411,2116,0.479709816368,1689,0.382906370438,18,0.0040807073226,250,0.0566764905917,227,0.0514622534573,111,0.0251643618227,1740,50,29,1719,1769,51,0.0115620040807,1740,0.394468374518,508,0.115166628882,3903,0.884833371118,1933,0.438222625255,17-05,Wake,3718317-05
Wake,2524,1693,0.670760697306,455,0.180269413629,22,0.00871632329635,12,0.00475435816165,269,0.106576862124,73,0.0289223454834,470,41,35,464,505,15,0.00594294770206,470,0.186212361331,510,0.20206022187,2014,0.79793977813,1522,0.603011093502,17-06,Wake,3718317-06
Wake,4330,1272,0.29376443418,2312,0.533949191686,37,0.00854503464203,174,0.0401847575058,443,0.102309468822,92,0.021247113164,2354,62,47,2339,2401,42,0.00969976905312,2354,0.543648960739,716,0.165357967667,3614,0.834642032333,1074,0.248036951501,17-07,Wake,3718317-07
Wake,7157,4067,0.568254855386,2372,0.331423780914,48,0.00670672069303,153,0.021377672209,375,0.0523962554143,142,0.0198407153835,2445,106,77,2416,2522,73,0.0101998043873,2445,0.341623585301,755,0.105491127567,6402,0.894508872433,3762,0.525639234316,17-08,Wake,3718317-08
Wake,3666,615,0.167757774141,2486,0.678123295145,21,0.00572831423895,87,0.0237315875614,368,0.100381887616,89,0.0242771412984,2549,49,24,2524,2573,63,0.0171849427169,2549,0.695308237861,595,0.16230223677,3071,0.83769776323,458,0.124931805783,17-09,Wake,3718317-09
Wake,1735,936,0.539481268012,565,0.325648414986,11,0.00634005763689,87,0.050144092219,112,0.064553314121,24,0.0138328530259,578,21,14,571,592,13,0.00749279538905,578,0.333141210375,207,0.119308357349,1528,0.880691642651,861,0.496253602305,17-10,Wake,3718317-10
Wake,5204,2063,0.396425826287,1854,0.356264411991,40,0.00768639508071,423,0.0812836279785,705,0.135472713297,119,0.0228670253651,1900,70,54,1884,1954,46,0.00883935434281,1900,0.365103766334,1272,0.244427363566,3932,0.755572636434,1612,0.309761721752,17-11,Wake,3718317-11
Wake,7951,6023,0.757514778015,1284,0.161489120865,39,0.00490504339077,359,0.0451515532637,98,0.0123254936486,148,0.0186140108162,1337,74,62,1325,1399,53,0.00666582819771,1337,0.168154949063,297,0.0373537919759,7654,0.962646208024,5870,0.738271915482,18-01,Wake,3718318-01
Wake,4144,3811,0.919642857143,139,0.0335424710425,11,0.00265444015444,116,0.0279922779923,22,0.00530888030888,45,0.0108590733591,153,35,31,149,184,14,0.00337837837838,153,0.0369208494208,131,0.031611969112,4013,0.968388030888,3715,0.896476833977,18-02,Wake,3718318-02
Wake,2073,1748,0.84322238302,67,0.0323203087313,0,0.0,201,0.0969609261939,26,0.0125422093584,31,0.0149541726966,72,11,8,69,80,5,0.00241196333816,72,0.0347322720695,43,0.0207428847082,2030,0.979257115292,1719,0.829232995658,18-03,Wake,3718318-03
Wake,4347,3480,0.8005521049,433,0.0996089256959,32,0.00736139866575,112,0.0257648953301,224,0.0515297906602,66,0.0151828847481,446,49,44,441,490,13,0.00299056820796,446,0.102599493904,405,0.0931677018634,3942,0.906832298137,3334,0.766965723487,18-04,Wake,3718318-04
Wake,4200,3852,0.917142857143,92,0.0219047619048,2,0.00047619047619,210,0.05,11,0.00261904761905,33,0.00785714285714,95,18,18,95,113,3,0.000714285714286,95,0.022619047619,86,0.0204761904762,4114,0.979523809524,3785,0.90119047619,18-05,Wake,3718318-05
Wake,4740,3410,0.7194092827,731,0.154219409283,17,0.0035864978903,420,0.0886075949367,62,0.0130801687764,100,0.0210970464135,770,41,33,762,803,39,0.00822784810127,770,0.162447257384,202,0.0426160337553,4538,0.957383966245,3292,0.694514767932,18-06,Wake,3718318-06
Wake,3335,2860,0.857571214393,255,0.0764617691154,21,0.00629685157421,51,0.0152923538231,117,0.0350824587706,31,0.00929535232384,267,38,32,261,299,12,0.00359820089955,267,0.080059970015,198,0.0593703148426,3137,0.940629685157,2794,0.837781109445,18-07,Wake,3718318-07
Wake,4581,3639,0.794368041912,394,0.0860074219603,16,0.0034926871862,392,0.085570836062,68,0.0148439205414,72,0.0157170923379,414,37,32,409,446,20,0.00436585898275,414,0.090373280943,222,0.0484610347086,4359,0.951538965291,3495,0.762933857236,18-08,Wake,3718318-08
Wake,3135,2638,0.841467304625,301,0.0960127591707,19,0.00606060606061,53,0.0169059011164,55,0.0175438596491,69,0.022009569378,325,55,44,314,369,24,0.00765550239234,325,0.103668261563,143,0.0456140350877,2992,0.954385964912,2569,0.819457735247,19-03,Wake,3718319-03
Wake,5528,4180,0.756150506512,933,0.168777134588,24,0.00434153400868,250,0.0452243125904,71,0.0128437047757,70,0.0126628075253,959,50,39,948,998,26,0.00470332850941,959,0.173480463097,283,0.0511939218524,5245,0.948806078148,3995,0.722684515195,19-04,Wake,3718319-04
Wake,2979,2696,0.905001678416,142,0.0476670023498,5,0.0016784155757,62,0.0208123531386,40,0.0134273246056,34,0.0114132259147,146,17,15,144,161,4,0.00134273246056,146,0.0490097348103,122,0.040953340047,2857,0.959046659953,2630,0.882846592816,19-05,Wake,3718319-05
Wake,7269,5533,0.761177603522,1002,0.137845645894,18,0.00247626908791,491,0.0675471178979,114,0.0156830375567,111,0.0152703260421,1051,56,35,1030,1086,49,0.0067409547393,1051,0.144586600633,378,0.0520016508461,6891,0.947998349154,5298,0.728848534874,19-06,Wake,3718319-06
Wake,2357,1446,0.613491726771,798,0.338565973695,9,0.00381841323717,43,0.0182435299109,38,0.0161221892236,23,0.00975816716165,802,28,24,798,826,4,0.00169707254985,802,0.340263046245,120,0.0509121764955,2237,0.949087823504,1374,0.582944420874,19-07,Wake,3718319-07
Wake,3851,3168,0.822643469229,517,0.134250843937,9,0.00233705531031,72,0.0186964424825,59,0.0153206959231,26,0.00675149311867,527,22,19,524,546,10,0.00259672812257,527,0.136847572059,163,0.0423266683978,3688,0.957673331602,3070,0.797195533628,19-09,Wake,3718319-09
Wake,5410,4514,0.83438077634,632,0.116820702403,18,0.00332717190388,113,0.020887245841,81,0.0149722735675,52,0.00961182994455,655,44,32,643,687,23,0.00425138632163,655,0.121072088725,246,0.045471349353,5164,0.954528650647,4367,0.807208872458,19-10,Wake,3718319-10
Wake,2613,2172,0.83122847302,296,0.113279755071,8,0.00306161500191,56,0.0214313050134,40,0.0153080750096,41,0.0156907768848,314,21,16,309,330,18,0.00688863375431,314,0.120168388825,130,0.0497512437811,2483,0.950248756219,2091,0.800229621125,19-11,Wake,3718319-11
Wake,4442,3672,0.826654660063,495,0.111436289959,18,0.0040522287258,102,0.0229626294462,98,0.0220621341738,57,0.0128320576317,522,42,31,511,553,27,0.0060783430887,522,0.117514633048,261,0.0587573165241,4181,0.941242683476,3526,0.79378658262,19-12,Wake,3718319-12
Wake,3054,2068,0.677144728225,747,0.244597249509,24,0.00785854616896,73,0.0239030779306,96,0.0314341846758,46,0.0150622134905,769,39,33,763,802,22,0.00720366732155,769,0.25180091683,251,0.0821872953504,2803,0.91781270465,1933,0.632940406025,19-16,Wake,3718319-16
Wake,4393,2594,0.590484862281,1422,0.323696790348,24,0.0054632369679,143,0.0325517869338,127,0.0289096289552,83,0.018893694514,1462,46,34,1450,1496,40,0.00910539494651,1462,0.332802185295,351,0.0798998406556,4042,0.920100159344,2406,0.547689506032,19-17,Wake,3718319-17
Wake,3760,2414,0.642021276596,733,0.194946808511,21,0.00558510638298,209,0.055585106383,334,0.088829787234,49,0.0130319148936,745,36,32,741,777,12,0.0031914893617,745,0.198138297872,557,0.148138297872,3203,0.851861702128,2230,0.593085106383,20-01,Wake,3718320-01
Wake,12034,7850,0.652318431112,1094,0.0909090909091,29,0.00240983879009,2703,0.224613594815,161,0.0133787601795,197,0.0163702841948,1173,89,61,1145,1234,79,0.00656473325578,1173,0.0974738241649,539,0.04478976234,11495,0.95521023766,7485,0.621987701512,20-02,Wake,3718320-02
Wake,2714,2437,0.897936624908,130,0.0478997789241,8,0.00294767870302,55,0.0202652910833,36,0.0132645541636,48,0.0176860722181,140,23,20,137,160,10,0.00368459837878,140,0.0515843773029,100,0.0368459837878,2614,0.963154016212,2381,0.877302873987,20-03,Wake,3718320-03
Wake,3568,2583,0.723934977578,135,0.03783632287,4,0.00112107623318,772,0.216367713004,26,0.0072869955157,48,0.0134529147982,147,15,11,143,158,12,0.00336322869955,147,0.0411995515695,144,0.0403587443946,3424,0.959641255605,2463,0.690302690583,20-04,Wake,3718320-04
Wake,3287,2835,0.862488591421,168,0.0511104350472,9,0.00273805902038,224,0.0681472467295,14,0.0042592029206,37,0.0112564648616,183,18,13,178,196,15,0.00456343170064,183,0.0556738667478,66,0.0200790994828,3221,0.979920900517,2790,0.848798296319,20-05,Wake,3718320-05
Wake,7301,5842,0.800164361046,741,0.101492946172,24,0.00328722092864,349,0.047801671004,243,0.0332831119025,102,0.0139706889467,775,61,46,760,821,34,0.00465689631557,775,0.106149842487,511,0.0699904122723,6790,0.930009587728,5606,0.767840021915,20-06,Wake,3718320-06
Wake,4572,3580,0.78302712161,315,0.0688976377953,6,0.00131233595801,526,0.115048118985,68,0.0148731408574,77,0.0168416447944,342,26,16,332,358,27,0.00590551181102,342,0.0748031496063,255,0.0557742782152,4317,0.944225721785,3425,0.749125109361,20-08,Wake,3718320-08
Wake,2294,2068,0.901482127289,95,0.0414123801221,6,0.00261551874455,97,0.0422842197036,12,0.0052310374891,16,0.00697471665214,103,12,8,99,111,8,0.00348735832607,103,0.0448997384481,67,0.0292066259808,2227,0.970793374019,2015,0.878378378378,20-09,Wake,3718320-09
Wake,3211,2410,0.750545001557,95,0.0295857988166,4,0.00124571784491,649,0.202117720336,11,0.0034257240735,42,0.0130800373715,103,19,14,98,117,8,0.00249143568982,103,0.0320772345064,99,0.0308315166615,3112,0.969168483339,2320,0.722516350047,20-10,Wake,3718320-10
Wake,3531,2974,0.84225431889,210,0.0594732370433,11,0.00311526479751,222,0.0628717077315,47,0.0133106768621,67,0.0189747946757,232,29,21,224,253,22,0.00623052959502,232,0.0657037666383,148,0.041914471821,3383,0.958085528179,2885,0.817048994619,20-11,Wake,3718320-11
Wake,2530,2068,0.817391304348,113,0.0446640316206,5,0.00197628458498,279,0.110276679842,35,0.0138339920949,30,0.0118577075099,121,18,14,117,135,8,0.00316205533597,121,0.0478260869565,121,0.0478260869565,2409,0.952173913043,1988,0.785770750988,20-12,Wake,3718320-12
Warren,1161,801,0.68992248062,327,0.28165374677,11,0.00947459086994,6,0.00516795865633,5,0.00430663221361,11,0.00947459086994,333,22,16,327,349,6,0.00516795865633,333,0.286821705426,10,0.00861326442722,1151,0.991386735573,797,0.686477174849,1,Warren,371851
Warren,2008,596,0.296812749004,1337,0.665836653386,15,0.00747011952191,7,0.00348605577689,23,0.0114541832669,30,0.0149402390438,1359,38,21,1342,1380,22,0.0109561752988,1359,0.676792828685,41,0.0204183266932,1967,0.979581673307,592,0.294820717131,10,Warren,3718510
Warren,413,116,0.280871670702,277,0.670702179177,14,0.0338983050847,2,0.00484261501211,2,0.00484261501211,2,0.00484261501211,279,16,14,277,293,2,0.00484261501211,279,0.675544794189,4,0.00968523002421,409,0.990314769976,113,0.273607748184,11,Warren,3718511
Warren,1066,945,0.886491557223,98,0.0919324577861,6,0.00562851782364,5,0.0046904315197,2,0.00187617260788,10,0.0093808630394,99,14,13,98,112,1,0.00093808630394,99,0.0928705440901,6,0.00562851782364,1060,0.994371482176,943,0.884615384615,12,Warren,3718512
Warren,819,430,0.525030525031,347,0.423687423687,1,0.001221001221,1,0.001221001221,25,0.030525030525,15,0.018315018315,355,6,5,354,360,8,0.00976800976801,355,0.433455433455,40,0.04884004884,779,0.95115995116,417,0.509157509158,13,Warren,3718513
Warren,1740,570,0.327586206897,1061,0.609770114943,31,0.017816091954,2,0.00114942528736,62,0.035632183908,14,0.00804597701149,1072,42,33,1063,1105,11,0.00632183908046,1072,0.616091954023,89,0.0511494252874,1651,0.948850574713,551,0.316666666667,14,Warren,3718514
Warren,912,649,0.711622807018,244,0.267543859649,3,0.00328947368421,2,0.00219298245614,7,0.00767543859649,7,0.00767543859649,246,9,7,244,253,2,0.00219298245614,246,0.269736842105,9,0.00986842105263,903,0.990131578947,646,0.708333333333,2,Warren,371852
Warren,1164,571,0.490549828179,562,0.482817869416,7,0.00601374570447,5,0.00429553264605,13,0.0111683848797,6,0.00515463917526,567,13,8,562,575,5,0.00429553264605,567,0.487113402062,23,0.0197594501718,1141,0.980240549828,562,0.482817869416,3,Warren,371853
Warren,924,410,0.443722943723,484,0.52380952381,5,0.00541125541126,3,0.00324675324675,8,0.00865800865801,14,0.0151515151515,492,17,11,486,503,8,0.00865800865801,492,0.532467532468,15,0.0162337662338,909,0.983766233766,405,0.438311688312,4,Warren,371854
Warren,2195,609,0.277448747153,1515,0.69020501139,19,0.00865603644647,6,0.00273348519362,31,0.0141230068337,15,0.00683371298405,1521,26,23,1518,1544,6,0.00273348519362,1521,0.692938496583,64,0.0291571753986,2131,0.970842824601,588,0.267881548975,5,Warren,371855
Warren,1410,542,0.384397163121,819,0.58085106383,7,0.00496453900709,0,0.0,26,0.0184397163121,16,0.0113475177305,834,17,8,825,842,15,0.0106382978723,834,0.591489361702,40,0.0283687943262,1370,0.971631205674,534,0.378723404255,6,Warren,371856
Warren,1005,323,0.321393034826,602,0.599004975124,14,0.0139303482587,3,0.00298507462687,48,0.0477611940299,15,0.0149253731343,613,25,17,605,630,11,0.0109452736318,613,0.609950248756,58,0.0577114427861,947,0.942288557214,319,0.317412935323,7,Warren,371857
Warren,1311,115,0.0877192982456,516,0.393592677346,633,0.482837528604,2,0.00152555301297,15,0.0114416475973,30,0.0228832951945,538,662,641,517,1179,22,0.0167810831426,538,0.410373760488,20,0.0152555301297,1291,0.98474446987,114,0.0869565217391,8,Warren,371858
Warren,586,261,0.445392491468,298,0.508532423208,12,0.0204778156997,2,0.00341296928328,3,0.00511945392491,10,0.0170648464164,306,19,13,300,319,8,0.0136518771331,306,0.522184300341,7,0.0119453924915,579,0.988054607509,261,0.445392491468,9,Warren,371859
Washington,2235,937,0.419239373602,1238,0.553914988814,4,0.00178970917226,2,0.00089485458613,44,0.0196868008949,10,0.00447427293065,1241,10,10,1241,1251,3,0.00134228187919,1241,0.555257270694,61,0.027293064877,2174,0.972706935123,925,0.413870246085,LM,Washington,37187LM
Washington,1521,657,0.431952662722,837,0.550295857988,1,0.000657462195924,12,0.00788954635108,5,0.00328731097962,9,0.00591715976331,844,6,2,840,846,7,0.00460223537147,844,0.55489809336,11,0.00723208415516,1510,0.992767915845,652,0.428665351742,P1,Washington,37187P1
Washington,1261,352,0.279143536875,840,0.666137985726,4,0.00317208564631,3,0.00237906423473,50,0.0396510705789,12,0.00951625693894,844,12,12,844,856,4,0.00317208564631,844,0.669310071372,54,0.0428231562252,1207,0.957176843775,351,0.278350515464,P2,Washington,37187P2
Washington,2726,1569,0.575568598679,1115,0.409024211299,5,0.00183418928833,7,0.00256786500367,16,0.00586940572267,14,0.00513573000734,1123,15,10,1118,1133,8,0.00293470286134,1123,0.41195891416,25,0.00917094644167,2701,0.990829053558,1563,0.573367571533,P3,Washington,37187P3
Washington,1407,914,0.64960909737,419,0.297796730633,1,0.000710732054016,4,0.00284292821606,52,0.0369580668088,17,0.0120824449183,429,6,3,426,432,10,0.00710732054016,429,0.304904051173,75,0.0533049040512,1332,0.946695095949,899,0.63894811656,SC,Washington,37187SC
Washington,1035,652,0.629951690821,337,0.325603864734,1,0.000966183574879,0,0.0,28,0.0270531400966,17,0.0164251207729,344,12,11,343,355,7,0.00676328502415,344,0.332367149758,33,0.031884057971,1002,0.968115942029,651,0.628985507246,SK,Washington,37187SK
Watauga,476,458,0.96218487395,4,0.00840336134454,1,0.00210084033613,1,0.00210084033613,4,0.00840336134454,8,0.0168067226891,5,2,2,5,7,1,0.00210084033613,5,0.0105042016807,16,0.0336134453782,460,0.966386554622,449,0.943277310924,01,Watauga,3718901
Watauga,1084,1065,0.982472324723,4,0.00369003690037,2,0.00184501845018,0,0.0,9,0.00830258302583,4,0.00369003690037,4,6,6,4,10,0,0.0,4,0.00369003690037,12,0.0110701107011,1072,0.988929889299,1063,0.980627306273,02,Watauga,3718902
Watauga,2348,2280,0.971039182283,7,0.00298126064736,6,0.00255536626917,10,0.00425894378194,12,0.00511073253833,33,0.0140545144804,10,31,31,10,41,3,0.00127768313458,10,0.00425894378194,41,0.017461669506,2307,0.982538330494,2256,0.960817717206,03,Watauga,3718903
Watauga,3611,3501,0.969537524232,36,0.00996953752423,10,0.00276931597895,25,0.00692328994738,14,0.00387704237053,25,0.00692328994738,38,23,23,38,61,2,0.000553863195791,38,0.01052340072,58,0.0160620326779,3553,0.983937967322,3458,0.957629465522,04,Watauga,3718904
Watauga,1870,1707,0.912834224599,90,0.048128342246,8,0.00427807486631,20,0.0106951871658,13,0.00695187165775,32,0.0171122994652,96,24,22,94,118,6,0.00320855614973,96,0.0513368983957,33,0.0176470588235,1837,0.982352941176,1684,0.900534759358,05,Watauga,3718905
Watauga,3350,3117,0.930447761194,112,0.0334328358209,5,0.00149253731343,39,0.0116417910448,27,0.00805970149254,50,0.0149253731343,130,17,12,125,142,18,0.00537313432836,130,0.0388059701493,107,0.0319402985075,3243,0.968059701493,3050,0.910447761194,06,Watauga,3718906
Watauga,4391,4185,0.953085857436,81,0.0184468230471,10,0.00227738556138,29,0.00660441812799,46,0.0104759735823,40,0.0091095422455,93,25,25,93,118,12,0.00273286267365,93,0.0211796857208,119,0.0271008881804,4272,0.97289911182,4117,0.937599635618,07,Watauga,3718907
Watauga,2483,2438,0.981876761981,7,0.00281917035844,4,0.00161095449054,8,0.00322190898107,12,0.00483286347161,14,0.00563834071687,9,13,11,7,20,2,0.000805477245268,9,0.00362464760371,41,0.016512283528,2442,0.983487716472,2411,0.97100281917,08,Watauga,3718908
Watauga,520,510,0.980769230769,4,0.00769230769231,0,0.0,2,0.00384615384615,1,0.00192307692308,3,0.00576923076923,4,1,1,4,5,0,0.0,4,0.00769230769231,5,0.00961538461538,515,0.990384615385,506,0.973076923077,09,Watauga,3718909
Watauga,1313,1275,0.971058644326,4,0.003046458492,2,0.001523229246,3,0.002284843869,7,0.00533130236101,22,0.016755521706,6,17,16,5,22,2,0.001523229246,6,0.004569687738,23,0.017517136329,1290,0.982482863671,1263,0.96191926885,10,Watauga,3718910
Watauga,2505,2439,0.973652694611,18,0.00718562874251,6,0.00239520958084,13,0.00518962075848,9,0.00359281437126,20,0.00798403193613,19,23,22,18,41,1,0.000399201596806,19,0.00758483033932,40,0.0159680638723,2465,0.984031936128,2407,0.960878243513,11,Watauga,3718911
Watauga,3848,3496,0.908523908524,162,0.0420997920998,5,0.00129937629938,70,0.0181912681913,22,0.00571725571726,93,0.0241683991684,198,38,33,193,231,36,0.00935550935551,198,0.0514553014553,116,0.0301455301455,3732,0.969854469854,3414,0.887214137214,12,Watauga,3718912
Watauga,2947,2740,0.929759077027,74,0.0251102816423,10,0.00339328130302,48,0.0162877502545,41,0.0139124533424,34,0.0115371564303,84,24,23,83,107,10,0.00339328130302,84,0.0285035629454,106,0.035968781812,2841,0.964031218188,2682,0.91007804547,13,Watauga,3718913
Watauga,3238,3065,0.946571957999,54,0.0166769610871,11,0.00339715873996,47,0.014515132798,31,0.00957381099444,30,0.00926497838172,57,23,23,57,80,3,0.000926497838172,57,0.0176034589253,106,0.0327362569487,3132,0.967263743051,2999,0.926189005559,14,Watauga,3718914
Watauga,3968,3674,0.925907258065,69,0.0173891129032,11,0.00277217741935,65,0.0163810483871,103,0.0259576612903,46,0.0115927419355,82,25,23,80,105,13,0.00327620967742,82,0.0206653225806,236,0.0594758064516,3732,0.940524193548,3552,0.895161290323,15,Watauga,3718915
Watauga,181,176,0.972375690608,2,0.0110497237569,0,0.0,0,0.0,0,0.0,3,0.0165745856354,2,3,3,2,5,0,0.0,2,0.0110497237569,0,0.0,181,1.0,176,0.972375690608,16,Watauga,3718916
Watauga,632,623,0.985759493671,2,0.00316455696203,1,0.00158227848101,2,0.00316455696203,0,0.0,4,0.00632911392405,2,3,3,2,5,0,0.0,2,0.00316455696203,6,0.00949367088608,626,0.990506329114,618,0.977848101266,17,Watauga,3718917
Watauga,2014,1910,0.948361469712,20,0.00993048659384,6,0.00297914597815,7,0.00347567030785,53,0.0263157894737,18,0.00893743793446,26,16,16,26,42,6,0.00297914597815,26,0.012909632572,78,0.038728897716,1936,0.961271102284,1889,0.937934458788,18,Watauga,3718918
Watauga,2949,2866,0.971854866056,14,0.00474737199051,6,0.00203458799593,10,0.00339097999322,19,0.00644286198711,34,0.0115293319769,17,28,28,17,45,3,0.00101729399797,17,0.00576466598847,98,0.0332316039335,2851,0.966768396066,2788,0.945405222109,19,Watauga,3718919
Watauga,277,270,0.974729241877,3,0.0108303249097,3,0.0108303249097,0,0.0,1,0.00361010830325,0,0.0,3,3,3,3,6,0,0.0,3,0.0108303249097,7,0.0252707581227,270,0.974729241877,264,0.953068592058,20,Watauga,3718920
Wayne,3045,2246,0.737602627258,660,0.216748768473,10,0.00328407224959,3,0.000985221674877,77,0.0252873563218,49,0.016091954023,679,35,26,670,705,19,0.00623973727422,679,0.222988505747,125,0.0410509031199,2920,0.95894909688,2212,0.726436781609,01,Wayne,3719101
Wayne,3914,3086,0.788451711804,664,0.16964741952,23,0.00587634133878,25,0.00638732754216,80,0.0204394481349,36,0.00919775166071,680,35,30,675,710,16,0.00408788962698,680,0.173735309147,217,0.0554420030659,3697,0.944557996934,2965,0.7575370465,02,Wayne,3719102
Wayne,3688,3061,0.829989154013,346,0.0938177874187,8,0.00216919739696,28,0.00759219088937,189,0.0512472885033,56,0.0151843817787,365,27,22,360,387,19,0.00515184381779,365,0.0989696312364,260,0.0704989154013,3428,0.929501084599,2999,0.813177874187,03,Wayne,3719103
Wayne,4506,3678,0.816245006658,615,0.136484687084,16,0.00355082112739,57,0.0126498002663,85,0.0188637372392,55,0.0122059476254,630,32,26,624,656,15,0.00332889480692,630,0.139813581891,165,0.0366178428762,4341,0.963382157124,3614,0.802041722148,04,Wayne,3719104
Wayne,3576,2929,0.819071588367,488,0.136465324385,7,0.00195749440716,83,0.0232102908277,33,0.00922818791946,36,0.010067114094,495,20,19,494,514,7,0.00195749440716,495,0.138422818792,63,0.0176174496644,3513,0.982382550336,2905,0.812360178971,05,Wayne,3719105
Wayne,2886,1903,0.65939015939,813,0.281704781705,5,0.0017325017325,60,0.02079002079,65,0.0225225225225,40,0.01386001386,832,17,12,827,844,19,0.00658350658351,832,0.288288288288,105,0.0363825363825,2781,0.963617463617,1869,0.647609147609,06,Wayne,3719106
Wayne,4825,3495,0.724352331606,1058,0.219274611399,23,0.00476683937824,71,0.0147150259067,113,0.0234196891192,65,0.0134715025907,1088,50,35,1073,1123,30,0.00621761658031,1088,0.225492227979,203,0.0420725388601,4622,0.95792746114,3420,0.708808290155,07,Wayne,3719107
Wayne,3549,2924,0.823894054663,432,0.121724429417,18,0.0050718512257,29,0.00817131586362,108,0.0304311073542,38,0.0107072414765,439,35,32,436,471,7,0.00197238658777,439,0.123696816005,165,0.0464919695689,3384,0.953508030431,2878,0.810932657087,08,Wayne,3719108
Wayne,4337,2964,0.683421720083,1122,0.258704173392,36,0.00830066866498,59,0.0136038736454,114,0.0262854507724,42,0.00968411344247,1140,51,39,1128,1179,18,0.00415033433249,1140,0.262854507724,161,0.0371224348628,4176,0.962877565137,2925,0.674429329029,09,Wayne,3719109
Wayne,2055,525,0.255474452555,1461,0.710948905109,9,0.0043795620438,7,0.00340632603406,25,0.0121654501217,28,0.0136253041363,1485,22,11,1474,1496,24,0.0116788321168,1485,0.722627737226,55,0.0267639902676,2000,0.973236009732,506,0.246228710462,10,Wayne,3719110
Wayne,2880,1503,0.521875,1207,0.419097222222,16,0.00555555555556,70,0.0243055555556,38,0.0131944444444,46,0.0159722222222,1234,37,22,1219,1256,27,0.009375,1234,0.428472222222,97,0.0336805555556,2783,0.966319444444,1466,0.509027777778,11,Wayne,3719111
Wayne,4033,2344,0.581205058269,1359,0.33696999752,6,0.00148772625837,163,0.0404165633523,68,0.0168608975948,93,0.0230597570047,1406,30,17,1393,1423,47,0.0116538556906,1406,0.348623853211,181,0.0448797421274,3852,0.955120257873,2255,0.55913711877,12,Wayne,3719112
Wayne,2224,1004,0.451438848921,1064,0.478417266187,6,0.00269784172662,47,0.0211330935252,72,0.0323741007194,31,0.0139388489209,1078,12,11,1077,1089,14,0.00629496402878,1078,0.484712230216,131,0.0589028776978,2093,0.941097122302,951,0.427607913669,13,Wayne,3719113
Wayne,2958,2383,0.805611899932,414,0.139959432049,8,0.0027045300879,43,0.0145368492224,94,0.0317782285328,16,0.00540906017579,416,10,9,415,425,2,0.000676132521974,416,0.140635564571,209,0.0706558485463,2749,0.929344151454,2268,0.766734279919,14,Wayne,3719114
Wayne,4565,2933,0.642497261774,722,0.158159912377,18,0.0039430449069,39,0.00854326396495,762,0.166922234392,91,0.0199342825849,742,38,30,734,772,20,0.00438116100767,742,0.162541073384,1181,0.258707557503,3384,0.741292442497,2588,0.566922234392,15,Wayne,3719115
Wayne,3200,2053,0.6415625,819,0.2559375,7,0.0021875,40,0.0125,235,0.0734375,46,0.014375,836,23,17,830,853,17,0.0053125,836,0.26125,326,0.101875,2874,0.898125,1987,0.6209375,16,Wayne,3719116
Wayne,2191,571,0.26061159288,1496,0.682793245094,10,0.00456412596988,24,0.0109539023277,44,0.0200821542675,46,0.0209949794614,1524,25,15,1514,1539,28,0.0127795527157,1524,0.695572797809,121,0.0552259242355,2070,0.944774075764,518,0.23642172524,17,Wayne,3719117
Wayne,1845,491,0.266124661247,1278,0.692682926829,10,0.00542005420054,15,0.00813008130081,23,0.0124661246612,28,0.0151761517615,1293,23,15,1285,1308,15,0.00813008130081,1293,0.70081300813,55,0.029810298103,1790,0.970189701897,470,0.254742547425,18,Wayne,3719118
Wayne,1845,433,0.234688346883,1334,0.723035230352,7,0.00379403794038,13,0.0070460704607,20,0.0108401084011,38,0.0205962059621,1354,17,7,1344,1361,20,0.0108401084011,1354,0.733875338753,69,0.0373983739837,1776,0.962601626016,394,0.213550135501,19,Wayne,3719119
Wayne,1844,235,0.127440347072,1540,0.835140997831,4,0.00216919739696,5,0.0027114967462,27,0.0146420824295,33,0.0178958785249,1560,12,5,1553,1565,20,0.0108459869848,1560,0.845986984816,47,0.0254880694143,1797,0.974511930586,229,0.124186550976,20,Wayne,3719120
Wayne,1914,819,0.42789968652,1009,0.527168234065,8,0.00417972831766,34,0.0177638453501,18,0.00940438871473,26,0.0135841170324,1025,20,12,1017,1037,16,0.00835945663532,1025,0.5355276907,39,0.0203761755486,1875,0.979623824451,804,0.420062695925,21,Wayne,3719121
Wayne,2291,1395,0.608904408555,704,0.307289393278,9,0.00392841553907,98,0.0427760803143,38,0.0165866433872,47,0.0205150589262,729,25,14,718,743,25,0.0109122653863,729,0.318201658664,109,0.0475774770842,2182,0.952422522916,1340,0.584897424705,22,Wayne,3719122
Wayne,2679,1786,0.666666666667,620,0.231429637925,10,0.00373273609556,71,0.0265024262785,132,0.0492721164614,60,0.0223964165733,640,26,19,633,659,20,0.00746547219112,640,0.238895110116,250,0.093318402389,2429,0.906681597611,1692,0.631578947368,23,Wayne,3719123
Wayne,3295,3002,0.911077389985,157,0.0476479514416,7,0.00212443095599,3,0.000910470409712,101,0.0306525037936,25,0.00758725341426,161,24,21,158,182,4,0.00121396054628,161,0.0488619119879,181,0.0549317147193,3114,0.945068285281,2928,0.888619119879,24,Wayne,3719124
Wayne,2816,2052,0.728693181818,629,0.223366477273,14,0.00497159090909,14,0.00497159090909,71,0.0252130681818,36,0.0127840909091,651,20,16,647,667,22,0.0078125,651,0.231178977273,154,0.0546875,2662,0.9453125,1990,0.706676136364,25,Wayne,3719125
Wayne,3264,1545,0.473345588235,1260,0.386029411765,14,0.00428921568627,29,0.00888480392157,363,0.111213235294,53,0.016237745098,1281,42,27,1266,1308,21,0.00643382352941,1281,0.392463235294,562,0.172181372549,2702,0.827818627451,1386,0.424632352941,26,Wayne,3719126
Wayne,2284,743,0.32530647986,1259,0.55122591944,9,0.00394045534151,15,0.00656742556918,241,0.105516637478,17,0.00744308231173,1263,12,11,1262,1274,4,0.00175131348511,1263,0.552977232925,301,0.131786339755,1983,0.868213660245,690,0.302101576182,27,Wayne,3719127
Wayne,5325,2956,0.555117370892,1222,0.229483568075,30,0.0056338028169,35,0.00657276995305,958,0.179906103286,124,0.0232863849765,1246,61,56,1241,1302,24,0.00450704225352,1246,0.233990610329,1519,0.285258215962,3806,0.714741784038,2515,0.472300469484,28,Wayne,3719128
Wayne,2228,1027,0.460951526032,1136,0.50987432675,2,0.000897666068223,20,0.00897666068223,20,0.00897666068223,23,0.0103231597846,1150,7,3,1146,1153,14,0.00628366247756,1150,0.516157989228,51,0.0228904847397,2177,0.97710951526,1004,0.450628366248,29,Wayne,3719129
Wayne,2077,527,0.253731343284,1362,0.655753490611,18,0.0086663456909,8,0.00385170919596,142,0.0683678382282,20,0.00962927298989,1372,28,23,1367,1395,10,0.00481463649494,1372,0.660568127106,205,0.0987000481464,1872,0.901299951854,491,0.236398651902,30,Wayne,3719130
Wilkes,836,758,0.906698564593,56,0.066985645933,2,0.00239234449761,2,0.00239234449761,15,0.0179425837321,3,0.00358851674641,56,4,4,56,60,0,0.0,56,0.066985645933,20,0.0239234449761,816,0.976076555024,753,0.900717703349,101,Wilkes,37193101
Wilkes,1792,1553,0.866629464286,200,0.111607142857,2,0.00111607142857,2,0.00111607142857,21,0.01171875,14,0.0078125,203,14,12,201,215,3,0.00167410714286,203,0.11328125,31,0.0172991071429,1761,0.982700892857,1543,0.861049107143,102,Wilkes,37193102
Wilkes,448,440,0.982142857143,2,0.00446428571429,0,0.0,0,0.0,1,0.00223214285714,5,0.0111607142857,5,1,1,5,6,3,0.00669642857143,5,0.0111607142857,4,0.00892857142857,444,0.991071428571,438,0.977678571429,103,Wilkes,37193103
Wilkes,2067,1895,0.916787614901,42,0.0203193033382,4,0.00193517174649,17,0.00822447992259,99,0.0478955007257,10,0.00483792936623,45,9,8,44,53,3,0.00145137880987,45,0.021770682148,145,0.0701499758104,1922,0.92985002419,1855,0.897435897436,104,Wilkes,37193104
Wilkes,1408,1317,0.935369318182,42,0.0298295454545,2,0.00142045454545,4,0.00284090909091,24,0.0170454545455,19,0.0134943181818,51,8,5,48,56,9,0.00639204545455,51,0.0362215909091,44,0.03125,1364,0.96875,1304,0.926136363636,105,Wilkes,37193105
Wilkes,1191,1095,0.919395465995,73,0.0612930310663,0,0.0,3,0.00251889168766,12,0.0100755667506,8,0.00671704450042,75,4,4,75,79,2,0.0016792611251,75,0.0629722921914,22,0.0184718723762,1169,0.981528127624,1086,0.911838790932,106,Wilkes,37193106
Wilkes,3126,3043,0.973448496481,23,0.00735764555342,6,0.00191938579655,6,0.00191938579655,38,0.0121561100448,10,0.00319897632758,26,10,9,25,35,3,0.000959692898273,26,0.0083173384517,61,0.0195137555982,3065,0.980486244402,3024,0.967370441459,107,Wilkes,37193107
Wilkes,2096,1717,0.819179389313,234,0.111641221374,7,0.00333969465649,3,0.00143129770992,102,0.0486641221374,33,0.0157442748092,246,19,14,241,260,12,0.00572519083969,246,0.117366412214,177,0.0844465648855,1919,0.915553435115,1658,0.791030534351,108,Wilkes,37193108
Wilkes,978,908,0.928425357873,59,0.060327198364,3,0.00306748466258,2,0.00204498977505,3,0.00306748466258,3,0.00306748466258,60,6,5,59,65,1,0.00102249488753,60,0.0613496932515,6,0.00613496932515,972,0.993865030675,905,0.925357873211,109,Wilkes,37193109
Wilkes,459,448,0.976034858388,4,0.00871459694989,0,0.0,1,0.00217864923747,0,0.0,6,0.0130718954248,4,6,6,4,10,0,0.0,4,0.00871459694989,2,0.00435729847495,457,0.995642701525,446,0.971677559913,110,Wilkes,37193110
Wilkes,2205,2121,0.961904761905,13,0.00589569160998,3,0.00136054421769,10,0.00453514739229,33,0.0149659863946,25,0.0113378684807,21,7,7,21,28,8,0.00362811791383,21,0.00952380952381,68,0.0308390022676,2137,0.969160997732,2094,0.949659863946,111,Wilkes,37193111
Wilkes,2318,2054,0.886108714409,99,0.0427092320966,9,0.00388265746333,19,0.00819672131148,112,0.0483175150992,25,0.0107851596204,106,26,23,103,129,7,0.0030198446937,106,0.0457290767903,185,0.0798101811907,2133,0.920189818809,1983,0.855478861087,112,Wilkes,37193112
Wilkes,1966,1924,0.978636826043,14,0.00712105798576,5,0.00254323499491,3,0.00152594099695,6,0.0030518819939,14,0.00712105798576,17,14,14,17,31,3,0.00152594099695,17,0.00864699898271,13,0.00661241098678,1953,0.993387589013,1920,0.976602238047,113,Wilkes,37193113
Wilkes,807,799,0.990086741016,2,0.00247831474597,2,0.00247831474597,0,0.0,0,0.0,4,0.00495662949195,4,5,4,3,8,2,0.00247831474597,4,0.00495662949195,4,0.00495662949195,803,0.995043370508,796,0.986369268897,114,Wilkes,37193114
Wilkes,4386,4278,0.97537619699,34,0.0077519379845,2,0.000455996352029,7,0.0015959872321,52,0.0118559051528,13,0.00296397628819,39,6,6,39,45,5,0.00113999088007,39,0.00889192886457,108,0.0246238030096,4278,0.97537619699,4225,0.963292293662,115A,Wilkes,37193115A
Wilkes,1369,1268,0.926223520818,61,0.0445580715851,1,0.00073046018992,6,0.00438276113952,25,0.018261504748,8,0.00584368151936,61,3,3,61,64,0,0.0,61,0.0445580715851,44,0.0321402483565,1325,0.967859751644,1253,0.915266617969,117,Wilkes,37193117
Wilkes,3177,2442,0.7686496695,453,0.142587346553,12,0.00377714825307,18,0.0056657223796,215,0.0676739062008,37,0.0116462071136,468,31,27,464,495,15,0.00472143531634,468,0.14730878187,292,0.0919106074913,2885,0.908089392509,2373,0.746931067044,118,Wilkes,37193118
Wilkes,4877,4704,0.964527373385,31,0.00635636661882,6,0.00123026450687,15,0.00307566126717,96,0.0196842321099,25,0.00512610211195,38,23,23,38,61,7,0.00143530859135,38,0.00779167521017,137,0.0280910395735,4740,0.971908960426,4664,0.956325610006,119,Wilkes,37193119
Wilkes,2198,2123,0.965878070974,20,0.0090991810737,0,0.0,6,0.00272975432211,37,0.0168334849864,12,0.00545950864422,24,10,7,21,31,4,0.00181983621474,24,0.0109190172884,50,0.0227479526843,2148,0.977252047316,2113,0.961328480437,120,Wilkes,37193120
Wilkes,2476,2349,0.948707592892,49,0.0197899838449,13,0.00525040387722,3,0.00121163166397,46,0.0185783521809,16,0.0064620355412,54,20,20,54,74,5,0.00201938610662,54,0.0218093699515,79,0.0319063004847,2397,0.968093699515,2318,0.936187399031,121,Wilkes,37193121
Wilkes,855,831,0.971929824561,8,0.0093567251462,3,0.00350877192982,0,0.0,3,0.00350877192982,10,0.0116959064327,10,6,6,10,16,2,0.00233918128655,10,0.0116959064327,12,0.0140350877193,843,0.985964912281,825,0.964912280702,122,Wilkes,37193122
Wilkes,1030,991,0.96213592233,19,0.0184466019417,2,0.00194174757282,6,0.00582524271845,5,0.00485436893204,7,0.00679611650485,20,7,7,20,27,1,0.000970873786408,20,0.0194174757282,15,0.0145631067961,1015,0.985436893204,983,0.954368932039,123,Wilkes,37193123
Wilkes,1561,1525,0.976937860346,10,0.00640614990391,4,0.00256245996156,2,0.00128122998078,10,0.00640614990391,10,0.00640614990391,11,13,12,10,23,1,0.000640614990391,11,0.0070467648943,34,0.0217809096733,1527,0.978219090327,1502,0.962203715567,124,Wilkes,37193124
Wilkes,1025,1012,0.987317073171,2,0.0019512195122,0,0.0,1,0.000975609756098,4,0.00390243902439,6,0.00585365853659,2,1,1,2,3,0,0.0,2,0.0019512195122,13,0.0126829268293,1012,0.987317073171,1003,0.978536585366,125,Wilkes,37193125
Wilkes,971,950,0.978372811535,0,0.0,7,0.00720906282183,0,0.0,6,0.00617919670443,8,0.00823892893924,0,14,14,0,14,0,0.0,0,0.0,13,0.0133882595263,958,0.986611740474,947,0.975283213182,126,Wilkes,37193126
Wilkes,2735,2307,0.843510054845,242,0.0884826325411,6,0.00219378427788,72,0.0263254113346,84,0.0307129798903,24,0.00877513711152,253,15,13,251,266,11,0.00402193784278,253,0.0925045703839,158,0.0577696526508,2577,0.942230347349,2240,0.819012797075,127,Wilkes,37193127
Wilkes,3168,2688,0.848484848485,330,0.104166666667,4,0.00126262626263,17,0.00536616161616,107,0.0337752525253,22,0.00694444444444,337,16,12,333,349,7,0.0022095959596,337,0.106376262626,140,0.0441919191919,3028,0.955808080808,2661,0.839962121212,128,Wilkes,37193128
Wilkes,2279,1964,0.861781483107,108,0.047389205792,7,0.00307152259763,8,0.00351031154015,166,0.0728389644581,26,0.0114085125055,113,16,16,113,129,5,0.00219394471259,113,0.0495831505046,274,0.12022817025,2005,0.87977182975,1871,0.820974111452,129,Wilkes,37193129
Wilson,3133,2582,0.82413022662,398,0.127034790935,6,0.00191509735078,7,0.00223428024258,120,0.0383019470156,20,0.00638365783594,404,12,11,403,415,6,0.00191509735078,404,0.128949888286,179,0.0571337376317,2954,0.942866262368,2534,0.808809447814,PRBL,Wilson,37195PRBL
Wilson,2966,2131,0.718476062036,536,0.180714767363,13,0.0043830074174,3,0.00101146325017,234,0.0788941335131,49,0.0165205664194,541,36,34,539,575,5,0.00168577208361,541,0.182400539447,299,0.1008091706,2667,0.8991908294,2087,0.703641267701,PRCR,Wilson,37195PRCR
Wilson,2838,1576,0.555320648344,1043,0.367512332629,5,0.00176180408739,8,0.00281888653982,175,0.0616631430585,31,0.0109231853418,1057,21,14,1050,1071,14,0.00493305144468,1057,0.372445384073,302,0.106412966878,2536,0.893587033122,1460,0.514446793517,PRGA,Wilson,37195PRGA
Wilson,3955,2991,0.756257901391,579,0.146396965866,2,0.000505689001264,20,0.00505689001264,328,0.0829329962073,35,0.00884955752212,587,10,10,587,597,8,0.00202275600506,587,0.148419721871,449,0.113527180784,3506,0.886472819216,2887,0.729962073325,PROL,Wilson,37195PROL
Wilson,1316,696,0.528875379939,555,0.421732522796,8,0.00607902735562,0,0.0,54,0.0410334346505,3,0.00227963525836,555,8,8,555,563,0,0.0,555,0.421732522796,86,0.0653495440729,1230,0.934650455927,677,0.51443768997,PRSA,Wilson,37195PRSA
Wilson,2360,1686,0.714406779661,508,0.215254237288,10,0.00423728813559,11,0.00466101694915,118,0.05,27,0.0114406779661,516,22,19,513,535,8,0.00338983050847,516,0.218644067797,164,0.0694915254237,2196,0.930508474576,1651,0.699576271186,PRSP,Wilson,37195PRSP
Wilson,1523,906,0.594878529219,553,0.363099146422,8,0.00525279054498,5,0.00328299409061,46,0.0302035456336,5,0.00328299409061,553,12,12,553,565,0,0.0,553,0.363099146422,96,0.0630334865397,1427,0.93696651346,862,0.565988181221,PRST,Wilson,37195PRST
Wilson,6492,4366,0.672520024646,1688,0.260012322859,18,0.00277264325323,135,0.0207948243993,227,0.034966112138,58,0.00893407270487,1707,21,19,1705,1726,19,0.00292667898953,1707,0.262939001848,351,0.0540665434381,6141,0.945933456562,4264,0.656808379544,PRTA,Wilson,37195PRTA
Wilson,4291,2564,0.597529713354,1607,0.374504777441,13,0.00302959683058,1,0.000233045910044,68,0.015847121883,38,0.00885574458168,1629,32,23,1620,1652,22,0.00512701002097,1629,0.379631787462,122,0.0284316010254,4169,0.971568398975,2518,0.586809601491,PRTO,Wilson,37195PRTO
Wilson,1857,722,0.388799138395,941,0.506731287022,9,0.0048465266559,6,0.0032310177706,154,0.082929456112,25,0.0134625740442,958,19,12,951,970,17,0.00915455035003,958,0.515885837372,236,0.127086698977,1621,0.872913301023,648,0.348949919225,PRWA,Wilson,37195PRWA
Wilson,1743,205,0.117613310384,1288,0.738955823293,5,0.00286861732645,3,0.00172117039587,209,0.119908204246,33,0.0189328743546,1303,17,9,1295,1312,15,0.00860585197935,1303,0.747561675273,317,0.181870338497,1426,0.818129661503,131,0.075157773953,PRWB,Wilson,37195PRWB
Wilson,1852,344,0.185745140389,1341,0.724082073434,3,0.00161987041037,8,0.00431965442765,126,0.0680345572354,30,0.0161987041037,1365,17,7,1355,1372,24,0.0129589632829,1365,0.737041036717,202,0.109071274298,1650,0.890928725702,285,0.153887688985,PRWC,Wilson,37195PRWC
Wilson,1574,1339,0.850698856417,181,0.11499364676,1,0.000635324015248,9,0.00571791613723,25,0.0158831003812,19,0.0120711562897,189,5,4,188,193,8,0.00508259212198,189,0.120076238882,38,0.0241423125794,1536,0.975857687421,1328,0.843710292249,PRWD,Wilson,37195PRWD
Wilson,1793,669,0.373117679866,1014,0.565532626882,5,0.00278862242052,13,0.00725041829336,82,0.0457334076966,10,0.00557724484105,1018,8,8,1018,1026,4,0.00223089793642,1018,0.567763524819,156,0.0870050195204,1637,0.91299498048,609,0.33965421082,PRWE,Wilson,37195PRWE
Wilson,1239,73,0.0589184826473,990,0.799031476998,4,0.00322841000807,7,0.00564971751412,153,0.123486682809,12,0.00968523002421,996,9,5,992,1001,6,0.00484261501211,996,0.80387409201,201,0.162227602906,1038,0.837772397094,38,0.0306698950767,PRWH,Wilson,37195PRWH
Wilson,2376,962,0.404882154882,1223,0.514730639731,2,0.000841750841751,17,0.00715488215488,152,0.0639730639731,20,0.00841750841751,1237,10,2,1229,1239,14,0.00589225589226,1237,0.520622895623,242,0.101851851852,2134,0.898148148148,888,0.373737373737,PRWI,Wilson,37195PRWI
Wilson,3861,2384,0.617456617457,1279,0.331261331261,7,0.001813001813,80,0.02072002072,79,0.020461020461,32,0.00828800828801,1294,17,14,1291,1308,15,0.003885003885,1294,0.335146335146,134,0.034706034706,3727,0.965293965294,2344,0.607096607097,PRWJ,Wilson,37195PRWJ
Wilson,1569,1286,0.819630337795,246,0.156787762906,1,0.0006373486297,14,0.00892288081581,13,0.00828553218611,9,0.0057361376673,249,4,3,248,252,3,0.0019120458891,249,0.158699808795,35,0.0223072020395,1534,0.97769279796,1267,0.80752071383,PRWK,Wilson,37195PRWK
Wilson,2517,1683,0.668653158522,732,0.290822407628,8,0.00317838696861,40,0.0158919348431,34,0.0135081446166,20,0.00794596742153,743,14,9,738,752,11,0.00437028208184,743,0.29519268971,62,0.0246324990068,2455,0.975367500993,1662,0.660309892729,PRWL,Wilson,37195PRWL
Wilson,4171,2598,0.622872212899,1380,0.330855909854,14,0.0033565092304,86,0.020618556701,53,0.0127067849437,40,0.00959002637257,1400,31,20,1389,1420,20,0.00479501318629,1400,0.33565092304,120,0.0287700791177,4051,0.971229920882,2541,0.609206425318,PRWM,Wilson,37195PRWM
Wilson,2611,180,0.0689391037917,2224,0.851780926848,6,0.00229797012639,1,0.000382995021065,174,0.0666411336653,26,0.00995787054768,2237,16,7,2228,2244,13,0.00497893527384,2237,0.856759862122,221,0.0846418996553,2390,0.915358100345,152,0.0582152432018,PRWN,Wilson,37195PRWN
Wilson,1656,1308,0.789855072464,289,0.174516908213,6,0.0036231884058,20,0.012077294686,15,0.00905797101449,18,0.0108695652174,299,11,7,295,306,10,0.006038647343,299,0.180555555556,38,0.0229468599034,1618,0.977053140097,1291,0.779589371981,PRWP,Wilson,37195PRWP
Wilson,768,6,0.0078125,652,0.848958333333,2,0.00260416666667,1,0.00130208333333,101,0.131510416667,6,0.0078125,657,7,2,652,659,5,0.00651041666667,657,0.85546875,104,0.135416666667,664,0.864583333333,4,0.00520833333333,PRWQ,Wilson,37195PRWQ
Wilson,2721,527,0.193678794561,1804,0.662991547225,14,0.00514516721793,5,0.00183755972069,338,0.124219037119,33,0.0121278941566,1824,30,20,1814,1844,20,0.00735023888276,1824,0.670341786108,498,0.183020948181,2223,0.816979051819,395,0.145167217935,PRWR,Wilson,37195PRWR
Yadkin,3251,2949,0.907105505998,153,0.0470624423254,10,0.00307597662258,4,0.00123039064903,115,0.0353737311596,20,0.00615195324516,158,14,14,158,172,5,0.00153798831129,158,0.0486004306367,167,0.051368809597,3084,0.948631190403,2905,0.893571208859,BNVL,Yadkin,37197BNVL
Yadkin,2424,2095,0.864273927393,31,0.0127887788779,7,0.00288778877888,1,0.000412541254125,266,0.109735973597,24,0.00990099009901,41,24,18,35,59,10,0.00412541254125,41,0.0169141914191,346,0.142739273927,2078,0.857260726073,2025,0.835396039604,DCRK,Yadkin,37197DCRK
Yadkin,2655,2483,0.935216572505,38,0.0143126177024,10,0.00376647834275,9,0.00338983050847,99,0.0372881355932,16,0.0060263653484,40,18,18,40,58,2,0.00075329566855,40,0.015065913371,146,0.0549905838041,2509,0.945009416196,2440,0.919020715631,EBND,Yadkin,37197EBND
Yadkin,3145,3006,0.955802861685,57,0.0181240063593,3,0.000953895071542,6,0.00190779014308,57,0.0181240063593,16,0.00508744038156,58,14,13,57,71,1,0.000317965023847,58,0.0184419713831,95,0.0302066772655,3050,0.969793322734,2974,0.945627980922,FBSH,Yadkin,37197FBSH
Yadkin,1746,1570,0.899198167239,18,0.0103092783505,2,0.00114547537228,6,0.00343642611684,141,0.0807560137457,9,0.00515463917526,19,4,4,19,23,1,0.00057273768614,19,0.0108820160367,189,0.10824742268,1557,0.89175257732,1530,0.876288659794,NBCK,Yadkin,37197NBCK
Yadkin,1166,1139,0.976843910806,5,0.00428816466552,0,0.0,2,0.00171526586621,13,0.0111492281304,7,0.00600343053173,5,5,5,5,10,0,0.0,5,0.00428816466552,28,0.0240137221269,1138,0.975986277873,1126,0.965694682676,NFAL,Yadkin,37197NFAL
Yadkin,3605,3168,0.878779472954,268,0.0743411927878,6,0.00166435506241,3,0.000832177531207,119,0.0330097087379,41,0.0113730929265,287,26,21,282,308,19,0.00527045769764,287,0.0796116504854,193,0.0535367545076,3412,0.946463245492,3102,0.860471567268,NKNB,Yadkin,37197NKNB
Yadkin,4640,3950,0.851293103448,206,0.0443965517241,8,0.00172413793103,14,0.00301724137931,431,0.0928879310345,31,0.00668103448276,219,19,13,213,232,13,0.00280172413793,219,0.0471982758621,600,0.129310344828,4040,0.870689655172,3804,0.819827586207,NLIB,Yadkin,37197NLIB
Yadkin,1007,939,0.932472691162,13,0.012909632572,3,0.00297914597815,3,0.00297914597815,44,0.0436941410129,5,0.00496524329692,13,5,5,13,18,0,0.0,13,0.012909632572,52,0.051638530288,955,0.948361469712,932,0.925521350546,SBCK,Yadkin,37197SBCK
Yadkin,1952,1856,0.950819672131,36,0.0184426229508,3,0.0015368852459,1,0.000512295081967,47,0.0240778688525,9,0.0046106557377,36,6,6,36,42,0,0.0,36,0.0184426229508,87,0.0445696721311,1865,0.955430327869,1820,0.93237704918,SFAL,Yadkin,37197SFAL
Yadkin,1429,1381,0.966410076977,6,0.00419874037789,0,0.0,1,0.000699790062981,33,0.0230930720784,8,0.00559832050385,7,5,5,7,12,1,0.000699790062981,7,0.00489853044087,54,0.037788663401,1375,0.962211336599,1362,0.95311406578,SKNB,Yadkin,37197SKNB
Yadkin,2448,2243,0.916258169935,51,0.0208333333333,10,0.00408496732026,14,0.00571895424837,102,0.0416666666667,28,0.0114379084967,56,26,26,56,82,5,0.00204248366013,56,0.0228758169935,152,0.062091503268,2296,0.937908496732,2207,0.901552287582,SLIB,Yadkin,37197SLIB
Yancey,3586,3322,0.926380368098,69,0.0192414947016,24,0.00669269380926,8,0.00223089793642,134,0.037367540435,29,0.00808700501952,76,43,41,74,117,7,0.00195203569437,76,0.021193530396,241,0.0672058003346,3345,0.932794199665,3245,0.90490797546,01-BUR,Yancey,3719901-BUR
Yancey,1464,1429,0.976092896175,2,0.00136612021858,5,0.00341530054645,4,0.00273224043716,13,0.00887978142077,11,0.00751366120219,4,12,12,4,16,2,0.00136612021858,4,0.00273224043716,20,0.0136612021858,1444,0.986338797814,1424,0.972677595628,02-CAN,Yancey,3719902-CAN
Yancey,499,486,0.973947895792,0,0.0,6,0.0120240480962,1,0.00200400801603,1,0.00200400801603,5,0.0100200400802,0,10,10,0,10,0,0.0,0,0.0,2,0.00400801603206,497,0.995991983968,484,0.96993987976,03-EGY,Yancey,3719903-EGY
Yancey,364,358,0.983516483516,1,0.00274725274725,2,0.00549450549451,0,0.0,0,0.0,3,0.00824175824176,2,5,4,1,6,1,0.00274725274725,2,0.00549450549451,1,0.00274725274725,363,0.997252747253,357,0.980769230769,04-RAM,Yancey,3719904-RAM
Yancey,489,477,0.975460122699,1,0.00204498977505,1,0.00204498977505,2,0.0040899795501,4,0.0081799591002,4,0.0081799591002,2,5,4,1,6,1,0.00204498977505,2,0.0040899795501,6,0.0122699386503,483,0.98773006135,475,0.971370143149,05-GRE,Yancey,3719905-GRE
Yancey,1283,1252,0.975837879969,6,0.00467653936087,4,0.00311769290725,2,0.00155884645362,15,0.0116913484022,4,0.00311769290725,6,6,6,6,12,0,0.0,6,0.00467653936087,30,0.0233826968044,1253,0.976617303196,1243,0.968823070928,06-JAC,Yancey,3719906-JAC
Yancey,414,407,0.98309178744,1,0.0024154589372,0,0.0,0,0.0,4,0.00966183574879,2,0.0048309178744,1,1,1,1,2,0,0.0,1,0.0024154589372,8,0.0193236714976,406,0.980676328502,404,0.975845410628,07-BRU,Yancey,3719907-BRU
Yancey,2653,2587,0.975122502827,8,0.00301545420279,5,0.00188465887674,8,0.00301545420279,36,0.0135695439126,9,0.00339238597814,9,12,12,9,21,1,0.000376931775349,9,0.00339238597814,68,0.0256313607237,2585,0.974368639276,2559,0.964568413117,08-CRA,Yancey,3719908-CRA
Yancey,1894,1836,0.969376979937,11,0.00580781414995,4,0.00211193241816,2,0.00105596620908,27,0.0142555438226,14,0.00739176346357,12,14,13,11,25,1,0.000527983104541,12,0.00633579725449,46,0.0242872228089,1848,0.975712777191,1817,0.95934530095,09-SOU,Yancey,3719909-SOU
Yancey,528,519,0.982954545455,3,0.00568181818182,0,0.0,0,0.0,2,0.00378787878788,4,0.00757575757576,3,3,3,3,6,0,0.0,3,0.00568181818182,11,0.0208333333333,517,0.979166666667,513,0.971590909091,10-PEN,Yancey,3719910-PEN
Yancey,1082,1064,0.983364140481,3,0.00277264325323,2,0.00184842883549,3,0.00277264325323,4,0.00369685767098,6,0.00554528650647,4,8,7,3,11,1,0.000924214417745,4,0.00369685767098,26,0.0240295748614,1056,0.975970425139,1045,0.965804066543,11-PRI,Yancey,3719911-PRI
